종목코드,종목명,자기주식 제외 시가총액(A*B),종가,자기주식 제외 발행주식수(B=C-D),총발행주식수(C),자기주식수(D),자기주식수 반영시점
"060310","3S","107788594620","2110","51084642","51084642","0","2024-09"
"095570","AJ네트웍스","219280145000","4900","44751050","45252759","501709","2024-09"
"006840","AK홀딩스","160198678600","12280","13045495","13247561","202066","2024-09"
"054620","APS","115012580520","6330","18169444","19894221","1724777","2024-09"
"265520","AP시스템","263753553040","17560","15020134","15281421","261287","2024-09"
"211270","AP위성","145889900250","10250","14233161","15082304","849143","2024-09"
"109960","AP헬스케어","61167204584","536","114117919","114153169","35250","2024-09"
"139050","BF랩스","24234697905","2805","8639821","8644551","4730","2024-09"
"027410","BGF","337373400150","3525","95708766","95716791","8025","2024-09"
"282330","BGF리테일","1934801680000","112000","17275015","17283906","8891","2024-09"
"126600","BGF에코머티리얼즈","208684554000","3370","61924200","62766899","842699","2024-09"
"138930","BNK금융지주","3113790815820","9780","318383519","320436727","2053208","2024-09"
"001460","BYC","201026854000","32200","6243070","6246150","3080","2024-09"
"013720","CBI","48850499904","1096","44571624","44628136","56512","2024-09"
"083790","CG인바이츠","196464635010","2555","76894182","76894182","0","2024-09"
"001040","CJ","2822196856500","104300","27058455","29176998","2118543","2024-09"
"079160","CJ CGV","909034216470","5490","165580003","165580003","0","2024-09"
"035760","CJ ENM","1285236378000","62000","20729619","21929154","1199535","2024-09"
"311690","CJ 바이오사이언스","100602022080","11040","9112502","9112502","0","2024-09"
"000120","CJ대한통운","1779105506800","89200","19945129","22812344","2867215","2024-09"
"011150","CJ씨푸드","113720896545","3165","35930773","35930773","0","2024-09"
"097950","CJ제일제당","4026944846000","274000","14696879","15054186","357307","2024-09"
"051500","CJ프레시웨이","214638274880","18080","11871586","11871586","0","2024-09"
"058820","CMG제약","290979251180","2095","138892244","138892244","0","2024-09"
"023460","CNH","6789438434","206","32958439","37200000","4241561","2024-09"
"056730","CNT85","55701358400","800","69626698","74111186","4484488","2024-09"
"000480","CR홀딩스","233512084320","5660","41256552","46890490","5633938","2024-09"
"065770","CS","18731740450","965","19411130","19411130","0","2024-09"
"083660","CSA 코스믹","49526724984","836","59242494","61247181","2004687","2024-09"
"000590","CS홀딩스","71427280400","68600","1041214","1154482","113268","2024-09"
"012030","DB","295142173485","1545","191030533","201173933","10143400","2024-09"
"456440","DB금융스팩11호","12091625000","2275","5315000","5315000","0","2024-09"
"477760","DB금융스팩12호","12234800000","2095","5840000","5840000","0","2024-09"
"016610","DB금융투자","215463757810","5290","40730389","42446389","1716000","2024-09"
"005830","DB손해보험","6640807671400","110600","60043469","70800000","10756531","2024-09"
"000990","DB하이텍","1540980598950","37050","41591919","44398588","2806669","2024-09"
"139130","DGB금융지주","1371076935680","8240","166392832","169145833","2753001","2024-09"
"099520","DGI","58000622016","1284","45171824","45281824","110000","2024-09"
"060900","DGP","29597205136","1172","25253588","25258229","4641","2024-09"
"290120","DH오토리드","39796328970","2565","15515138","15515138","0","2024-09"
"025440","DH오토웨어","37553092060","244","153906115","153906120","5","2024-09"
"001530","DI동일","723500089650","37350","19370819","25215672","5844853","2024-09"
"000210","DL","855020197950","40850","20930727","20955884","25157","2024-09"
"375500","DL이앤씨","1180751717600","30700","38460968","38693623","232655","2024-09"
"068790","DMS","127764077280","5430","23529296","24573061","1043765","2024-09"
"007340","DN오토모티브","911775264300","18140","50263245","59065865","8802620","2024-09"
"004840","DRB동일","88267427120","4580","19272364","19930000","657636","2024-09"
"241520","DSC인베스트먼트","74916312000","2865","26148800","27496125","1347325","2024-09"
"155660","DSR","61120000000","3820","16000000","16000000","0","2024-09"
"069730","DSR제강","50904000000","3535","14400000","14400000","0","2024-09"
"017860","DS단석","502908463200","85800","5861404","5861404","0","2024-09"
"180400","DXVX","114433468200","2325","49218696","49219432","736","2024-09"
"017940","E1","434787675200","75200","5781751","6860000","1078249","2024-09"
"245620","EDGC","57441040175","415","138412145","138493951","81806","2024-09"
"037370","EG","61064801760","7080","8624972","8624972","0","2024-09"
"050120","ES큐브","23707569390","1770","13394107","13564086","169979","2024-09"
"383220","F&F","2186018715400","57800","37820393","38307075","486682","2024-09"
"007700","F&F홀딩스","512987695090","13130","39069893","39114367","44474","2024-09"
"214270","FSN","75804331920","2280","33247514","33250463","2949","2024-09"
"130500","GH신소재","44144175155","3035","14545033","14545052","19","2024-09"
"114090","GKL","679175256600","10980","61855670","61855670","0","2024-09"
"078930","GS","3943413762750","42450","92895495","92915378","19883","2024-09"
"083450","GST","283851717800","15260","18601030","18618260","17230","2024-09"
"006360","GS건설","1550920111650","18270","84888895","85581490","692595","2024-09"
"001250","GS글로벌","282546066850","3425","82495202","82533764","38562","2024-09"
"007070","GS리테일","2146343812000","20750","103438256","104717922","1279666","2024-09"
"297890","HB솔루션","280495405190","3835","73140914","73140914","0","2024-09"
"440290","HB인베스트먼트","50500359630","1863","27107010","27107010","0","2024-09"
"078150","HB테크놀러지","205698440670","2315","88854618","92715916","3861298","2024-09"
"012630","HDC","545337747400","10900","50030986","59741721","9710735","2024-09"
"039570","HDC랩스","185403028710","8070","22974353","25957601","2983248","2024-09"
"089470","HDC현대EP","100050671180","3860","25919863","31900000","5980137","2024-09"
"294870","HDC현대산업개발","1325096664500","20650","64169330","65907330","1738000","2024-09"
"009540","HD한국조선해양","13471137015000","190500","70714630","70773116","58486","2024-09"
"267250","HD현대","5724142830000","81000","70668430","78993085","8324655","2024-09"
"267270","HD현대건설기계","890154165600","50400","17661789","18305586","643797","2024-09"
"443060","HD현대마린솔루션","5978525000000","134500","44450000","44450000","0","2024-09"
"071970","HD현대마린엔진","680125533650","20050","33921473","33921495","22","2024-09"
"010620","HD현대미포","4183862860200","104900","39884298","39942149","57851","2024-09"
"322000","HD현대에너지솔루션","255920000000","22850","11200000","11200000","0","2024-09"
"042670","HD현대인프라코어","1311544927920","6810","192591032","192655867","64835","2024-09"
"267260","HD현대일렉트릭","12111544896000","336500","35992704","36047135","54431","2024-09"
"329180","HD현대중공업","16618327315200","187200","88773116","88773116","0","2024-09"
"097230","HJ중공업","187770106700","2255","83268340","83274281","5941","2024-09"
"195940","HK이노엔","1310257458750","46250","28329891","28329891","0","2024-09"
"014790","HL D&I","91239228410","2410","37858601","37858601","0","2024-09"
"028300","HLB","8925416931200","68200","130871216","131127236","256020","2024-09"
"003580","HLB글로벌","195395553065","4115","47483731","47489591","5860","2024-09"
"278650","HLB바이오스텝","183125260350","2175","84195522","86730589","2535067","2024-09"
"067630","HLB생명과학","1069856346020","9020","118609351","118679271","69920","2024-09"
"024850","HLB이노베이션","337511202800","3700","91219244","91226268","7024","2024-09"
"047920","HLB제약","640758171950","20150","31799413","31799994","581","2024-09"
"115450","HLB테라퓨틱스","723015515220","9060","79803037","80139933","336896","2024-09"
"046210","HLB파나진","125424313840","2960","42373079","42373079","0","2024-09"
"204320","HL만도","1800805552000","38350","46957120","46957120","0","2024-09"
"060980","HL홀딩스","334340899200","35200","9498321","10169410","671089","2024-09"
"011200","HMM","12950892885840","17290","749039496","749039496","0","2024-09"
"403870","HPSP","2458523447900","30700","80082197","82934144","2851947","2024-09"
"036640","HRS","82146272100","5140","15981765","16354800","373035","2024-09"
"035000","HS애드","103728921600","6400","16207644","16567409","359765","2024-09"
"002460","HS화성","84330735390","8910","9464729","10150000","685271","2024-09"
"487570","HS효성","148434391350","40050","3706227","3725927","19700","2024-09"
"298050","HS효성첨단소재","1197429896000","268000","4468022","4479948","11926","2024-09"
"439730","IBKS제20호스팩","9482000000","2200","4310000","4310000","0","2024-09"
"442770","IBKS제21호스팩","9219900000","2190","4210000","4210000","0","2024-09"
"448760","IBKS제22호스팩","9746000000","2200","4430000","4430000","0","2024-09"
"467930","IBKS제23호스팩","9179100000","2170","4230000","4230000","0","2024-09"
"469480","IBKS제24호스팩","9306000000","2200","4230000","4230000","0","2024-09"
"003560","IHQ","63618682920","10760","5912517","5994566","82049","2024-09"
"095340","ISC","1326079641600","64800","20464192","21197058","732866","2024-09"
"175330","JB금융지주","3503575014660","18270","191766558","195083198","3316640","2024-09"
"234080","JW생명과학","168471947520","10880","15484554","15834554","350000","2024-09"
"067290","JW신약","71577800116","1412","50692493","50841502","149009","2024-09"
"001060","JW중외제약","604561229700","26300","22987119","23285930","298811","2024-09"
"096760","JW홀딩스","214410939400","2975","72070904","73924942","1854038","2024-09"
"035900","JYP Ent.","1683159397200","50800","33133059","35532492","2399433","2024-09"
"318000","KBG","49499364090","5690","8699361","8740223","40862","2024-09"
"024840","KBI메탈","97720817205","2805","34838081","34909199","71118","2024-09"
"105560","KB금융","36288149378000","96200","377215690","393528423","16312733","2024-09"
"024120","KB오토시스","41457500000","3605","11500000","11500000","0","2024-09"
"455250","KB제25호스팩","11365200000","2640","4305000","4305000","0","2024-09"
"458320","KB제26호스팩","12496350000","2270","5505000","5505000","0","2024-09"
"464680","KB제27호스팩","25758380000","1996","12905000","12905000","0","2024-09"
"476470","KB제28호스팩","11450400000","2080","5505000","5505000","0","2024-09"
"478390","KB제29호스팩","12688800000","2040","6220000","6220000","0","2024-09"
"486630","KB제30호스팩","10726200000","2020","5310000","5310000","0","2024-09"
"002380","KCC","1937824058500","263500","7354171","8886471","1532300","2024-09"
"021320","KCC건설","84867830180","4255","19945436","21400000","1454564","2024-09"
"344820","KCC글라스","617804153750","38750","15943333","15970512","27179","2024-09"
"036670","KCI","80593898000","7490","10760200","11270000","509800","2024-09"
"009070","KCTC","135772105000","4540","29905750","30000000","94250","2024-09"
"009440","KC그린홀딩스","20620481360","932","22124980","22434980","310000","2024-09"
"119650","KC코트렐","27419518483","427","64214329","64214329","0","2024-09"
"044180","KD","12233725478","458","26711191","26717799","6608","2024-09"
"092220","KEC","178076906067","887","200763141","200763141","0","2024-09"
"046440","KG모빌리언스","163809842130","4415","37103022","38825568","1722546","2024-09"
"003620","KG모빌리티","965326908410","4915","196404254","196404254","0","2024-09"
"016380","KG스틸","666812383380","6690","99673002","100008897","335895","2024-09"
"151860","KG에코솔루션","223231126160","5320","41960738","49603002","7642264","2024-09"
"035600","KG이니시스","244890089600","9200","26618488","27904434","1285946","2024-09"
"001390","KG케미칼","273876160000","4000","68469040","68469040","0","2024-09"
"226360","KH 건설","60474013950","2555","23668890","23756732","87842","2024-09"
"111870","KH 미래물산","43747975260","8910","4909986","4930249","20263","2024-09"
"033180","KH 필룩스","125157155370","6630","18877399","18903579","26180","2024-09"
"060720","KH바텍","197675854740","8970","22037442","23677442","1640000","2024-09"
"015590","KIB플러그에너지","96688468728","408","236981541","236981544","3","2024-09"
"001940","KISCO홀딩스","250063268400","19800","12629458","16176380","3546922","2024-09"
"058400","KNN","105943776000","800","132429720","132429720","0","2024-09"
"025000","KPX케미칼","223970909100","47100","4755221","4840000","84779","2024-09"
"092230","KPX홀딩스","219361462200","55800","3931209","4224646","293437","2024-09"
"000040","KR모터스","30782085120","512","60121260","60132868","11608","2024-09"
"044450","KSS해운","206358578500","9140","22577525","23085880","508355","2024-09"
"101000","KS인더스트리","66593134400","2210","30132640","30149619","16979","2024-09"
"030200","KT","10754877656250","43750","245825775","252021685","6195910","2024-09"
"033780","KT&G","12145565960100","110700","109716043","130322497","20606454","2024-09"
"058850","KTcs","109832620455","2895","37938729","42685000","4746271","2024-09"
"058860","KTis","81601719030","2665","30619782","34802000","4182218","2024-09"
"122450","KX","149052657140","3590","41518846","45335964","3817118","2024-09"
"052900","KX하이텍","52388310080","964","54344720","55107517","762797","2024-09"
"376190","LB루셈","114021000000","4635","24600000","24600000","0","2024-09"
"061970","LB세미콘","195717126240","4470","43784592","43784592","0","2024-09"
"309960","LB인베스트먼트","88992364410","3870","22995443","23217239","221796","2024-09"
"093050","LF","416654674800","15050","27684696","29240000","1555304","2024-09"
"003550","LG","11762737911200","77800","151192004","157300993","6108989","2024-09"
"034220","LG디스플레이","5180000000000","10360","500000000","500000000","0","2024-09"
"051900","LG생활건강","5152914427500","351500","14659785","15618197","958412","2024-09"
"373220","LG에너지솔루션","97461000000000","416500","234000000","234000000","0","2024-09"
"032640","LG유플러스","4272493818880","9940","429828352","436611361","6783009","2024-09"
"011070","LG이노텍","4179151936200","176600","23664507","23667107","2600","2024-09"
"066570","LG전자","15050540551200","92400","162884638","163647814","763176","2024-09"
"037560","LG헬로비전","202136317650","2610","77446865","77446865","0","2024-09"
"051910","LG화학","23930804277000","339000","70592343","70592343","0","2024-09"
"079550","LIG넥스원","5415898460000","248500","21794360","22000000","205640","2024-09"
"225190","LK삼양","137020788000","2700","50748440","50748440","0","2024-09"
"006260","LS","2967207873000","108500","27347538","32200000","4852462","2024-09"
"010120","LS ELECTRIC","4371153780400","147400","29655046","30000000","344954","2024-09"
"000680","LS네트웍스","251775629730","3195","78803014","78803016","2","2024-09"
"060370","LS마린솔루션","418348252740","15290","27360906","28706781","1345875","2024-09"
"417200","LS머트리얼즈","1048616214500","15500","67652659","67652659","0","2024-09"
"229640","LS에코에너지","870401431200","28700","30327576","30624879","297303","2024-09"
"078020","LS증권","222289101720","4410","50405692","55481190","5075498","2024-09"
"108320","LX세미콘","1005133740000","61800","16264300","16264300","0","2024-09"
"001120","LX인터내셔널","1059254713900","29450","35967902","38760000","2792098","2024-09"
"108670","LX하우시스","360676738500","40300","8949795","8967670","17875","2024-09"
"383800","LX홀딩스","538980948030","7070","76234929","76280690","45761","2024-09"
"476080","M83","101049300000","12980","7785000","7785000","0","2024-09"
"086960","MDS테크","98019808128","1056","92821788","92821788","0","2024-09"
"023150","MH에탄올","37270621290","5810","6414909","7378526","963617","2024-09"
"038340","MIT","39924432729","1233","32379913","32424892","44979","2024-09"
"035420","NAVER","25772138457600","170400","151244944","160784508","9539564","2024-09"
"160550","NEW","64463104860","2310","27906106","27906106","0","2024-09"
"053290","NE능률","56602601475","3425","16526307","16526307","0","2024-09"
"181710","NHN","540518157600","16420","32918280","33766123","847843","2024-09"
"060250","NHN KCP","279944135080","7240","38666317","40160611","1494294","2024-09"
"104200","NHN벅스","47862831960","3540","13520574","14827550","1306976","2024-09"
"005940","NH투자증권","4451133513360","13620","326808628","327492299","683671","2024-09"
"034310","NICE","395752813170","11310","34991407","37503477","2512070","2024-09"
"030190","NICE평가정보","652121102220","11130","58591294","60107670","1516376","2024-09"
"008260","NI스틸","108537444015","3795","28600117","28600117","0","2024-09"
"004250","NPC","170214972300","5020","33907365","36720000","2812635","2024-09"
"222160","NPX","79551289560","8040","9894439","9894439","0","2024-09"
"456040","OCI","658008382500","73500","8952495","8952495","0","2024-09"
"010060","OCI홀딩스","1315566471700","68900","19093853","19563983","470130","2024-09"
"178920","PI첨단소재","583802481360","19880","29366322","29366322","0","2024-09"
"024940","PN풍년","62783182400","6680","9398680","10000000","601320","2024-09"
"005490","POSCO홀딩스","26429462260500","349500","75620779","82624377","7003598","2024-09"
"218410","RFHIC","370209270770","14390","25726843","26484442","757599","2024-09"
"327260","RF머트리얼즈","55646512320","6720","8280731","8433231","152500","2024-09"
"091340","S&K폴리텍","27469310895","2565","10709283","11703721","994438","2024-09"
"010950","S-Oil","6574835052800","58400","112582792","112582792","0","2024-09"
"419530","SAMG엔터","102958776000","12960","7944350","8590930","646580","2024-09"
"019550","SBI인베스트먼트","106031701174","658","161142403","162066575","924172","2024-09"
"034120","SBS","281750104860","15190","18548394","18551238","2844","2024-09"
"036120","SCI평가정보","76573712250","2250","34032761","35500000","1467239","2024-09"
"246960","SCL사이언스","62855750630","8630","7283401","7283401","0","2024-09"
"099220","SDN","69339918080","1280","54171811","56171811","2000000","2024-09"
"036540","SFA반도체","588634346410","3590","163964999","164460303","495304","2024-09"
"255220","SG","249591999150","2990","83475585","94073791","10598206","2024-09"
"040610","SG&G","52913862848","1568","33746086","34087196","341110","2024-09"
"049470","SGA","17955329405","307","58486415","58862249","375834","2024-09"
"184230","SGA솔루션즈","31679518556","508","62361257","62599161","237904","2024-09"
"016250","SGC E&C","49362773320","15260","3234782","3243585","8803","2024-09"
"005090","SGC에너지","400521327600","27800","14407242","14409333","2091","2024-09"
"001380","SG글로벌","138939201870","3090","44964143","44964143","0","2024-09"
"004060","SG세계물산","67186705768","338","198777236","202424960","3647724","2024-09"
"001770","SHD","21053835740","17330","1214878","1214878","0","2024-09"
"002360","SH에너지화학","55426209204","509","108892356","111133730","2241374","2024-09"
"009160","SIMPAC","212193807560","3910","54269516","65429516","11160000","2024-09"
"033530","SJG세종","121059038025","4475","27052299","27820961","768662","2024-09"
"123700","SJM","51028016460","3270","15604898","15604898","0","2024-09"
"025530","SJM홀딩스","48109568050","3550","13551991","14934008","1382017","2024-09"
"034730","SK","8194408454700","150300","54520349","72502703","17982354","2024-09"
"011790","SKC","5239544588000","153800","34067260","37868298","3801038","2024-09"
"018670","SK가스","1703463730800","189800","8975046","9230244","255198","2024-09"
"001740","SK네트웍스","994853666700","5130","193928590","221277902","27349312","2024-09"
"006120","SK디스커버리","591504581200","33400","17709718","18785855","1076137","2024-09"
"210980","SK디앤디","149592971640","8040","18606091","18617382","11291","2024-09"
"302440","SK바이오사이언스","4175910716900","53300","78347293","78347293","0","2024-09"
"326030","SK바이오팜","9374096025000","119700","78313250","78313250","0","2024-09"
"402340","SK스퀘어","12359610721800","92700","133329134","134749960","1420826","2024-09"
"361610","SK아이이테크놀로지","2388346990000","33500","71293940","71297592","3652","2024-09"
"100090","SK오션플랜트","752967624960","12720","59195568","59195568","0","2024-09"
"096770","SK이노베이션","11559634431600","121400","95219394","95735590","516196","2024-09"
"475150","SK이터닉스","555539688000","16500","33669072","33691895","22823","2024-09"
"001510","SK증권","208608726312","504","413906203","472590171","58683968","2024-09"
"285130","SK케미칼","848229105500","49250","17222926","17253783","30857","2024-09"
"017670","SK텔레콤","12198387396600","57300","212886342","214790053","1903711","2024-09"
"000660","SK하이닉스","135051591276000","196000","689038731","728002365","38963634","2024-09"
"048550","SM C&C","161907002649","1687","95973327","96714620","741293","2024-09"
"063440","SM Life Design","62921853518","1367","46029154","46029154","0","2024-09"
"003570","SNT다이내믹스","582240126000","26000","22393851","33252697","10858846","2024-09"
"064960","SNT모티브","544116310200","45450","11971756","14623136","2651380","2024-09"
"100840","SNT에너지","252942182400","12800","19761108","20680783","919675","2024-09"
"036530","SNT홀딩스","321004496400","22200","14459662","16303886","1844224","2024-09"
"067160","SOOP","964400580000","90500","10656360","11494767","838407","2024-09"
"005610","SPC삼립","398776971600","49200","8105223","8629009","523786","2024-09"
"011810","STX","153970848500","4970","30980050","31017927","37877","2024-09"
"465770","STX그린로지스","74446627800","10420","7144590","7171032","26442","2024-09"
"077970","STX엔진","435382560510","18930","22999607","23008904","9297","2024-09"
"002820","SUN&L","38360988720","3180","12063204","12607989","544785","2024-09"
"289080","SV인베스트먼트","84003252000","1578","53234000","53234000","0","2024-09"
"084870","TBH글로벌","28740696582","1378","20856819","20856819","0","2024-09"
"002710","TCC스틸","1233354443850","47050","26213697","26213697","0","2024-09"
"089230","THE E&M","28852123879","1319","21874241","21882953","8712","2024-09"
"032540","TJ미디어","72444366800","5200","13931609","13931609","0","2024-09"
"022220","TKG애강","52830470580","1020","51794579","51794579","0","2024-09"
"069260","TKG휴켐스","758975947060","19780","38370877","40878588","2507711","2024-09"
"007980","TP","64710237620","1330","48654314","51175130","2520816","2024-09"
"048770","TPC","37047258760","2360","15697991","15697991","0","2024-09"
"246690","TS인베스트먼트","40510745760","993","40796320","41477862","681542","2024-09"
"317240","TS트릴리온","29786621715","279","106762085","107240922","478837","2024-09"
"002900","TYM","131571031255","3065","42926927","45050956","2124029","2024-09"
"024070","WISCOM","32108887610","2095","15326438","15326438","0","2024-09"
"057030","YBM넷","56240605825","3475","16184347","16312697","128350","2024-09"
"037270","YG PLUS","438297223100","6910","63429410","63429410","0","2024-09"
"040300","YTN","129780000000","3090","42000000","42000000","0","2024-09"
"051390","YW","29874584400","3700","8074212","11355368","3281156","2024-09"
"052220","iMBC","57270000000","2490","23000000","23000000","0","2024-09"
"079940","가비아","174998529000","13500","12962854","13535684","572830","2024-09"
"078890","가온그룹","57684163080","3590","16068012","17410157","1342145","2024-09"
"000500","가온전선","273383650800","38350","7128648","7357946","229298","2024-09"
"399720","가온칩스","440577072000","38350","11488320","11488320","0","2024-09"
"036620","감성코퍼레이션","338932171620","3735","90744892","90744892","0","2024-09"
"000860","강남제비스코","163475000000","25150","6500000","6500000","0","2024-09"
"198440","강동씨앤엘","87759289408","1442","60859424","60931896","72472","2024-09"
"217730","강스템바이오텍","120516420350","2150","56054149","56054149","0","2024-09"
"035250","강원랜드","3406015166400","16800","202738998","213940500","11201502","2024-09"
"114190","강원에너지","340644415520","13040","26123038","26123038","0","2024-09"
"094480","갤럭시아머니트리","312661808860","7970","39229838","39229838","0","2024-09"
"011420","갤럭시아에스엠","60195972140","2185","27549644","27549644","0","2024-09"
"039240","경남스틸","74328809020","2755","26979604","26979604","0","2024-09"
"053950","경남제약","23455862785","659","35593115","35593402","287","2024-09"
"002100","경농","164354780000","9200","17864650","19522575","1657925","2024-09"
"009450","경동나비엔","1251623911200","86600","14452932","14568592","115660","2024-09"
"267290","경동도시가스","110209889170","18710","5890427","5895406","4979","2024-09"
"012320","경동인베스트","164616576000","75500","2180352","2365023","184671","2024-09"
"011040","경동제약","169463733300","6290","26941770","30768766","3826996","2024-09"
"000050","경방","157215353700","6310","24915270","27415270","2500000","2024-09"
"214390","경보제약","177867038400","7440","23906860","23906860","0","2024-09"
"012610","경인양행","123270209160","2980","41365842","41616365","250523","2024-09"
"009140","경인전자","27157896450","20850","1302537","1570797","268260","2024-09"
"024910","경창산업","79885810600","2245","35583880","35819005","235125","2024-09"
"013580","계룡건설","118340167920","13360","8857797","8930907","73110","2024-09"
"012200","계양전기","41364589734","1521","27195654","27222829","27175","2024-09"
"002140","고려산업","75987973600","3080","24671420","24939425","268005","2024-09"
"049720","고려신용정보","137724342240","9890","13925616","14300000","374384","2024-09"
"010130","고려아연","26739946079000","1301000","20553379","20703283","149904","2024-09"
"002240","고려제강","489264315540","19580","24987963","25000000","12037","2024-09"
"014570","고려제약","52652706320","4880","10789489","11000000","210511","2024-09"
"348150","고바이오랩","132904611000","6860","19373850","19373850","0","2024-09"
"098460","고영","665827872160","10120","65793268","68654755","2861487","2024-09"
"035290","골드앤에스","21454416000","450","47676480","47676480","0","2024-09"
"215000","골프존","401140680000","66800","6005100","6275415","270315","2024-09"
"121440","골프존뉴딘홀딩스","157650417540","3870","40736542","42836818","2100276","2024-09"
"366030","공구우먼","97298285750","4295","22653850","22653850","0","2024-09"
"009290","광동제약","223649814960","5580","40080612","52420851","12340239","2024-09"
"014200","광림","87868591200","30200","2909556","3023556","114000","2024-09"
"017040","광명전기","57769040795","1333","43337615","43337615","0","2024-09"
"029480","광무","206417239010","3755","54971302","55009083","37781","2024-09"
"017900","광전자","90402954585","1795","50363763","57943763","7580000","2024-09"
"037710","광주신세계","223094781000","29250","7627172","7957190","330018","2024-09"
"026910","광진실업","13995809925","2185","6405405","6405405","0","2024-09"
"421800","교보12호스팩","16205800000","2710","5980000","5980000","0","2024-06"
"440790","교보13호스팩","8910000000","2200","4050000","4050000","0","2024-09"
"456490","교보14호스팩","9030000000","2150","4200000","4200000","0","2024-09"
"465320","교보15호스팩","8267700000","2170","3810000","3810000","0","2024-09"
"482520","교보16호스팩","12535500000","2055","6100000","6100000","0","2024-09"
"030610","교보증권","609494560200","5400","112869363","113962961","1093598","2024-09"
"339770","교촌에프앤비","254821908000","10200","24982540","24982540","0","2024-09"
"053270","구영테크","58036045600","2225","26083616","27410405","1326789","2024-09"
"007690","국도화학","280658969100","33650","8340534","9010616","670082","2024-09"
"005320","국동","28803539790","435","66215034","67327897","1112863","2024-09"
"001140","국보","33448047050","2110","15852155","15856388","4233","2024-09"
"066620","국보디자인","107273223720","16230","6609564","7500000","890436","2024-09"
"043650","국순당","80748590580","5130","15740466","17858304","2117838","2024-09"
"006050","국영지앤엠","66265200065","1955","33895243","34895243","1000000","2024-09"
"060480","국일신동","21791850000","1965","11090000","11090000","0","2024-09"
"078130","국일제지","901924696800","800","1127405871","1127405871","0","2024-09"
"307750","국전약품","203882326560","4155","49069152","49069269","117","2024-09"
"002720","국제약품","107921260600","5300","20362502","21159832","797330","2024-09"
"035080","그래디언트","151996198860","11110","13681026","14527584","846558","2024-09"
"453450","그리드위즈","156948740000","19760","7942750","7942750","0","2024-09"
"204020","그리티","56260856170","2810","20021657","20147430","125773","2024-09"
"402490","그린리소스","135396162720","16380","8265944","8265944","0","2024-09"
"114450","그린생명과학","38136765060","1998","19087470","20000000","912530","2024-09"
"083420","그린케미칼","136925521880","5870","23326324","24000000","673676","2024-09"
"186230","그린플러스","97628308920","9090","10740188","10820188","80000","2024-09"
"014530","극동유화","124913548200","3710","33669420","34869420","1200000","2024-09"
"204620","글로벌텍스프리","241405446850","3950","61115303","61116035","732","2024-09"
"019660","글로본","17534535984","504","34790746","34790746","0","2024-09"
"014280","금강공업","107757189170","4010","26872117","29329357","2457240","2024-09"
"053260","금강철강","74873890320","4710","15896792","18720000","2823208","2024-09"
"008870","금비","44608250000","54500","818500","1000000","181500","2024-09"
"001570","금양","2554510625100","44100","57925411","58050037","124626","2024-09"
"282720","금양그린파워","126581781000","10490","12066900","12119500","52600","2024-09"
"002990","금호건설","103917078780","2895","35895364","36953595","1058231","2024-09"
"011780","금호석유","3356862088600","146200","22960753","27334587","4373834","2024-09"
"214330","금호에이치티","121637068251","597","203747183","213914131","10166948","2024-09"
"001210","금호전기","36696060680","860","42669838","43535722","865884","2024-09"
"073240","금호타이어","1232346631230","4290","287260287","287260287","0","2024-09"
"036190","금화피에스시","161228067000","27300","5905790","6000000","94210","2024-09"
"049080","기가레인","57378878648","676","84879998","84883347","3349","2024-09"
"420770","기가비스","474073349200","37400","12675758","12675758","0","2024-09"
"035460","기산텔레콤","25933087860","1779","14577340","14577340","0","2024-09"
"092440","기신정기","75920000000","2600","29200000","29200000","0","2024-09"
"000270","기아","37420266279500","95500","391835249","399858417","8023168","2024-09"
"024110","기업은행","11562675071500","14500","797425867","797425869","2","2024-09"
"013700","까뮤이앤씨","78811344770","1319","59750830","59750830","0","2024-09"
"308100","까스텔바작","19672082150","3050","6449863","6624733","174870","2024-09"
"004540","깨끗한나라","77457633760","2080","37239247","37240693","1446","2024-09"
"407400","꿈비","71711320000","6080","11794625","12259474","464849","2024-09"
"187790","나노","31435070025","1025","30668361","30840830","172469","2024-09"
"286750","나노브릭","51320311520","2480","20693674","20694559","885","2024-09"
"121600","나노신소재","1038524849600","86800","11964572","12196078","231506","2024-09"
"247660","나노씨엠에스","33358087620","7810","4271202","4343920","72718","2024-09"
"039860","나노엔텍","137110050140","4270","32110082","32110082","0","2024-09"
"091970","나노캠텍","21828355244","604","36139661","37417493","1277832","2024-09"
"417010","나노팀","187381116000","9500","19724328","19724328","0","2024-09"
"405920","나라셀라","46372825890","3730","12432393","12878076","445683","2024-09"
"051490","나라엠앤디","65112260150","4930","13207355","14200000","992645","2024-09"
"137080","나래나노텍","35998418610","3255","11059422","11059422","0","2024-09"
"190510","나무가","188242647480","11910","15805428","16264384","458956","2024-09"
"242040","나무기술","56498769140","1705","33137108","34606264","1469156","2024-09"
"089600","나스미디어","174454187670","15430","11306169","11568163","261994","2024-09"
"293580","나우IB","91603861650","967","94729950","94929950","200000","2024-09"
"138610","나이벡","194714958500","17950","10847630","10847630","0","2024-09"
"130580","나이스디앤비","77924000000","5060","15400000","15400000","0","2024-09"
"036800","나이스정보통신","164104474500","18710","8770950","10000000","1229050","2024-09"
"267320","나인테크","97438084925","2245","43402265","43664104","261839","2024-09"
"001260","남광토건","60907026800","6200","9823714","9832572","8858","2024-09"
"008350","남선알미늄","175934799670","1363","129079090","129079090","0","2024-09"
"004270","남성","40687910613","1299","31322487","36212160","4889673","2024-09"
"003920","남양유업","422526231000","643000","657117","679731","22614","2024-09"
"025860","남해화학","307351134950","6410","47948695","49678843","1730148","2024-09"
"111710","남화산업","109939920000","5340","20588000","20588000","0","2024-09"
"091590","남화토건","46725200000","3980","11740000","11740000","0","2024-09"
"168330","내츄럴엔도텍","48370358412","1532","31573341","31754900","181559","2024-09"
"094860","네오리진","28847115826","1349","21384074","21399569","15495","2024-09"
"253590","네오셈","501063940980","11790","42499062","43869164","1370102","2024-09"
"212560","네오오토","66854988930","8490","7874557","7874963","406","2024-09"
"095660","네오위즈","400170960300","20100","19909003","22033719","2124716","2024-09"
"042420","네오위즈홀딩스","129324561210","19890","6501989","8856866","2354877","2024-09"
"311390","네오크레마","77647988730","7130","10890321","10979147","88826","2024-09"
"085910","네오티스","46486027150","3475","13377274","13934818","557544","2024-09"
"092730","네오팜","209592830400","26800","7820628","8207361","386733","2024-09"
"290660","네오펙트","39138317577","929","42129513","42129513","0","2024-09"
"306620","네온테크","96901166160","2370","40886568","42608149","1721581","2024-09"
"153460","네이블","40334716800","6300","6402336","6530014","127678","2024-09"
"007390","네이처셀","1046447356560","16260","64357156","64357156","0","2024-09"
"033640","네패스","175548831920","7720","22739486","23059202","319716","2024-09"
"330860","네패스아크","154493690600","12680","12184045","12184045","0","2024-09"
"005720","넥센","223578336150","4615","48446010","53543977","5097967","2024-09"
"002350","넥센타이어","669297444960","6960","96163426","97667877","1504451","2024-09"
"089140","넥스턴바이오","58748705030","5210","11276143","11282627","6484","2024-09"
"389650","넥스트바이오메디컬","276968995500","34250","8086686","8086686","0","2024-09"
"137940","넥스트아이","32691880914","427","76561782","78320992","1759210","2024-09"
"396270","넥스트칩","254149607000","14050","18088940","18088940","0","2024-09"
"348210","넥스틴","694621267200","67200","10336626","10437250","100624","2024-09"
"092790","넥스틸","239218400000","9200","26002000","26002000","0","2024-09"
"225570","넥슨게임즈","948664229610","14830","63969267","65860174","1890907","2024-09"
"217270","넵튠","230168997630","5130","44867251","46676150","1808899","2024-09"
"251270","넷마블","4711237832500","57500","81934571","85953502","4018931","2024-09"
"104620","노랑풍선","71289567000","4500","15842126","15842126","0","2024-09"
"090350","노루페인트","167200000000","8360","20000000","20000000","0","2024-09"
"000320","노루홀딩스","135795182250","13250","10248693","13291151","3042458","2024-09"
"194700","노바렉스","171003406560","9660","17702216","18754848","1052632","2024-09"
"285490","노바텍","118924417740","11980","9926913","10575831","648918","2024-09"
"145170","노브랜드","106890376560","12890","8292504","9079834","787330","2024-09"
"106520","노블엠앤비","15902299386","411","38691726","38695952","4226","2024-09"
"376930","노을","96616561900","2615","36947060","36947060","0","2024-09"
"006280","녹십자","1860348014000","163000","11413178","11686538","273360","2024-09"
"142280","녹십자엠에스","87261842520","4020","21706926","21741926","35000","2024-09"
"234690","녹십자웰빙","197326245920","11120","17745166","17752276","7110","2024-09"
"005250","녹십자홀딩스","706814808700","15730","44934190","47028210","2094020","2024-09"
"004370","농심","2093309526000","362000","5782623","6082642","300019","2024-09"
"072710","농심홀딩스","311659488000","67200","4637790","4637790","0","2024-09"
"054050","농우바이오","115580344810","7210","16030561","16030561","0","2024-09"
"069140","누리플랜","17795536379","1361","13075339","13102743","27404","2024-09"
"040160","누리플렉스","28075492725","2485","11297985","12055535","757550","2024-09"
"332290","누보","37545051131","1141","32905391","33384803","479412","2024-09"
"348340","뉴로메카","221532570000","21000","10549170","10549170","0","2024-09"
"060260","뉴보텍","14209609140","1065","13342356","13512009","169653","2024-09"
"123840","뉴온","61081507145","235","259921307","292370108","32448801","2024-09"
"012340","뉴인텍","26469868360","520","50903593","50907162","3569","2024-09"
"214870","뉴지랩파마","64715071880","6920","9351889","9359221","7332","2024-09"
"270870","뉴트리","78165211740","8690","8994846","9200224","205378","2024-09"
"144960","뉴파워프라즈마","195854389720","4840","40465783","43692624","3226841","2024-09"
"085670","뉴프렉스","134721064840","5510","24450284","24450761","477","2024-09"
"064260","다날","205054494650","3070","66792995","68949040","2156045","2024-09"
"340360","다보링크","120619229360","2780","43388212","43388212","0","2024-09"
"039560","다산네트웍스","132103360220","3415","38683268","39505981","822713","2024-09"
"154040","다산솔루에타","31789616474","1771","17950094","17950094","0","2024-09"
"058730","다스코","58543592800","3220","18181240","18796941","615701","2024-09"
"030210","다올투자증권","167648948130","2830","59239911","60911106","1671195","2024-09"
"023590","다우기술","787502994250","18250","43150849","44866617","1715768","2024-09"
"032190","다우데이타","429343000000","11210","38300000","38300000","0","2024-09"
"323350","다원넥스뷰","48510579600","6390","7591640","7596111","4471","2024-09"
"068240","다원시스","407967141530","10690","38163437","38163437","0","2024-09"
"145210","다이나믹디자인","96425714520","2790","34561188","34581687","20499","2024-09"
"019680","대교","154307248620","2290","67383078","84702850","17319772","2024-09"
"006370","대구백화점","60248463640","7240","8321611","10821611","2500000","2024-09"
"008060","대덕","209102225500","6170","33890150","33890150","0","2024-09"
"353200","대덕전자","819332616500","16580","49416925","49416925","0","2024-09"
"000490","대동","193263233400","8200","23568687","25640788","2072101","2024-09"
"020400","대동금속","20506337380","6430","3189166","3189166","0","2024-09"
"008830","대동기어","66867148800","7440","8987520","8987520","0","2024-09"
"048470","대동스틸","35079631710","3730","9404727","10000000","595273","2024-09"
"008110","대동전자","105136322880","15040","6990447","10490447","3500000","2024-09"
"004780","대륙제관","64726019930","4070","15903199","15903199","0","2024-09"
"005750","대림B&Co","58102756400","3485","16672240","16672240","0","2024-09"
"017650","대림제지","58345000000","7000","8335000","9000000","665000","2024-09"
"006570","대림통상","41126008560","2730","15064472","15225000","160528","2024-09"
"007720","대명소노시즌","116928522000","1160","100800450","100800450","0","2024-09"
"389260","대명에너지","207839500000","12190","17050000","17050000","0","2024-09"
"317850","대모","80330653000","9650","8324420","8324420","0","2024-09"
"290670","대보마그네틱","124250579360","16630","7471472","7857660","386188","2024-09"
"078140","대봉엘에스","192030884260","17540","10948169","11086579","138410","2024-09"
"065150","대산F&B","18113400725","145","124920005","125282405","362400","2024-09"
"001680","대상","692960500000","20000","34648025","34648025","0","2024-09"
"084690","대상홀딩스","316497582120","8740","36212538","36212538","0","2024-09"
"036480","대성미생물","38342000000","10090","3800000","3800000","0","2024-09"
"128820","대성산업","129051815230","3445","37460614","45235478","7774864","2024-09"
"117580","대성에너지","252093441420","9270","27194546","27500000","305454","2024-09"
"027830","대성창투","77220000000","1430","54000000","54000000","0","2024-09"
"104040","대성파인텍","45240287269","971","46591439","47224987","633548","2024-09"
"129920","대성하이텍","57534647335","4195","13715053","13715053","0","2024-09"
"016710","대성홀딩스","125327966060","7790","16088314","16089459","1145","2024-09"
"438220","대신밸런스제13호스팩","14692200000","2605","5640000","5640000","0","2024-09"
"442310","대신밸런스제14호스팩","15097500000","2250","6710000","6710000","0","2024-09"
"457390","대신밸런스제15호스팩","16778475000","2385","7035000","7035000","0","2024-09"
"457630","대신밸런스제16호스팩","16045450000","2195","7310000","7310000","0","2024-09"
"471050","대신밸런스제17호스팩","12877500000","2125","6060000","6060000","0","2024-09"
"478780","대신밸런스제18호스팩","16294600000","2060","7910000","7910000","0","2024-09"
"020180","대신정보통신","33394727135","869","38428915","38428915","0","2024-09"
"003540","대신증권","640709937690","17070","37534267","50773400","13239133","2024-09"
"045390","대아티아이","184992614625","2625","70473377","70473377","0","2024-09"
"009190","대양금속","72808800237","1719","42355323","42359986","4663","2024-09"
"108380","대양전기공업","103899322880","11240","9243712","9567333","323621","2024-09"
"014160","대영포장","97450052139","1023","95259093","108394549","13135456","2024-09"
"047040","대우건설","1510005021000","3675","410885720","415622638","4736918","2024-09"
"003090","대웅","1050891247000","25700","40890710","58141980","17251270","2024-09"
"069620","대웅제약","1767363072000","153600","11506270","11586575","80305","2024-09"
"007680","대원","57887070570","4305","13446474","13446474","0","2024-09"
"000430","대원강업","243040000000","3920","62000000","62000000","0","2024-09"
"048910","대원미디어","97158688560","8040","12084414","12578946","494532","2024-09"
"005710","대원산업","119023344000","5940","20037600","20037600","0","2024-09"
"006340","대원전선","214065544625","2855","74979175","74979175","0","2024-09"
"003220","대원제약","310141862330","14470","21433439","22427583","994144","2024-09"
"024890","대원화성","41737822208","1024","40759592","41249152","489560","2024-09"
"290380","대유","56838037000","2300","24712190","24713612","1422","2024-09"
"002880","대유에이텍","49442616816","1058","46732152","46744020","11868","2024-09"
"000300","대유플러스","156936737152","1984","79101178","79101178","0","2024-09"
"120240","대정화금","97914057150","13650","7173191","7190391","17200","2024-09"
"003310","대주산업","51177338100","1446","35392350","35392350","0","2024-09"
"078600","대주전자재료","1621751346000","108300","14974620","15480593","505973","2024-09"
"012800","대창","96163358760","1260","76320126","91140499","14820373","2024-09"
"015230","대창단조","130356069800","5170","25213940","28572230","3358290","2024-09"
"096350","대창솔루션","54112794860","340","159155279","163761009","4605730","2024-09"
"140520","대창스틸","46859395920","2220","21107836","21109243","1407","2024-09"
"131220","대한과학","35920553540","4820","7452397","7454490","2093","2024-09"
"010170","대한광통신","76671989814","1029","74511166","74511166","0","2024-09"
"054670","대한뉴팜","108212078190","7710","14035289","14354920","319631","2024-09"
"001070","대한방직","21276535350","5890","3612315","5300000","1687685","2024-09"
"023910","대한약품","148176000000","25200","5880000","6000000","120000","2024-09"
"006650","대한유화","650960940000","105400","6176100","6500000","323900","2024-09"
"001440","대한전선","2288527398080","12320","185757094","186447300","690206","2024-09"
"084010","대한제강","227850989620","13060","17446477","23414397","5967920","2024-09"
"001790","대한제당","256560622000","2900","88469180","89696580","1227400","2024-09"
"001130","대한제분","219633799500","133500","1645197","1690000","44803","2024-09"
"003490","대한항공","8726828528100","23700","368220613","368220661","48","2024-09"
"005880","대한해운","573561895620","1797","319177460","319177460","0","2024-09"
"003830","대한화섬","131342524000","117200","1120670","1328000","207330","2024-09"
"016090","대현","88786031550","2005","44282310","44282310","0","2024-09"
"069460","대호에이엘","75975115960","1126","67473460","67544896","71436","2024-09"
"021040","대호특수강","27676572986","1511","18316726","21704774","3388048","2024-09"
"067080","대화제약","309869538500","17690","17516650","18616650","1100000","2024-09"
"298540","더네이쳐홀딩스","143551294210","9830","14603387","14765856","162469","2024-09"
"032860","더라미","72520677000","1800","40289265","40395863","106598","2024-09"
"192080","더블유게임즈","1001190628500","50500","19825557","21495906","1670349","2024-09"
"393890","더블유씨피","602493741840","17880","33696518","33696518","0","2024-09"
"299170","더블유에스아이","45552397116","1517","30027948","30027963","15","2024-09"
"012510","더존비즈온","1468711897200","52400","28028853","30382784","2353931","2024-09"
"224060","더코디","22047635070","4670","4721121","4748398","27277","2024-09"
"043090","더테크놀로지","29839513151","401","74412751","74412751","0","2024-09"
"213420","덕산네오룩스","643548373000","26200","24562915","24831179","268264","2024-09"
"317330","덕산테코피아","756609778800","36950","20476584","20476584","0","2024-09"
"077360","덕산하이메탈","211736429320","4660","45437002","45437002","0","2024-09"
"004830","덕성","91345155000","6600","13840175","15680000","1839825","2024-09"
"090410","덕신이피씨","65531497770","1422","46084035","46084095","60","2024-09"
"024900","덕양산업","109767358300","3385","32427580","32564980","137400","2024-09"
"263600","덕우전자","91917888700","5770","15930310","15930310","0","2024-09"
"194480","데브시스터즈","382757336800","35450","10797104","12035480","1238376","2024-09"
"263800","데이타솔루션","70311012300","4335","16219380","16219380","0","2024-09"
"206560","덱스터","187908843510","7470","25155133","25411736","256603","2024-09"
"261200","덴티스","106944775000","7000","15277825","15809700","531875","2024-09"
"145720","덴티움","657140494200","76200","8623891","11068830","2444939","2024-09"
"067990","도이치모터스","138452805570","4665","29679058","30181550","502492","2024-09"
"002150","도화엔지니어링","219752445000","6600","33295825","33720000","424175","2024-09"
"006620","동구바이오제약","150227060920","5540","27116798","28464992","1348194","2024-09"
"100130","동국S&C","139334307500","2500","55733723","57143000","1409277","2024-09"
"005160","동국산업","367369050430","7130","51524411","54244482","2720071","2024-09"
"460850","동국씨엠","192522283200","6450","29848416","29898656","50240","2024-09"
"075970","동국알앤에스","46276000000","2515","18400000","18400000","0","2024-09"
"460860","동국제강","428607863300","8650","49550042","49608017","57975","2024-09"
"086450","동국제약","761970985600","17330","43968320","44460000","491680","2024-09"
"001230","동국홀딩스","247879297710","7970","31101543","31800483","698940","2024-09"
"023450","동남합성","115067880000","33200","3465900","3500000","34100","2024-09"
"004140","동방","112795742160","2360","47794806","47971766","176960","2024-09"
"099410","동방선기","42465737475","3045","13946055","14000000","53945","2024-09"
"007590","동방아그로","77535568750","6250","12405691","13617577","1211886","2024-09"
"005960","동부건설","92456477620","4030","22942054","22946345","4291","2024-09"
"026960","동서","2096791113750","21250","98672523","99700000","1027477","2024-09"
"002210","동성제약","101982306480","4460","22865988","26100970","3234982","2024-09"
"102260","동성케미컬","207488999880","4260","48706338","49689728","983390","2024-09"
"033500","동성화인텍","313557793200","10800","29033129","29989494","956365","2024-09"
"025950","동신건설","167916000000","19990","8400000","8400000","0","2024-09"
"000640","동아쏘시오홀딩스","746336326200","119400","6250723","6348913","98190","2024-09"
"170900","동아에스티","676031201400","75300","8977838","9167274","189436","2024-09"
"088130","동아엘텍","81131856960","9280","8742657","8742657","0","2024-09"
"028100","동아지질","174225402000","13150","13249080","14052646","803566","2024-09"
"041930","동아화성","101703744700","6850","14847262","15800000","952738","2024-09"
"001520","동양","143871479754","758","189804063","238684063","48880000","2024-09"
"084670","동양고속","22019960000","8440","2609000","2895569","286569","2024-09"
"082640","동양생명","892006904360","5720","155945263","161358585","5413322","2024-09"
"060380","동양에스텍","27618300000","1431","19300000","19700000","400000","2024-09"
"079960","동양이엔피","146151696270","18930","7720639","7860000","139361","2024-09"
"008970","동양철관","118092259408","752","157037579","157052160","14581","2024-09"
"228340","동양파일","40000000000","2000","20000000","20000000","0","2024-09"
"092780","동양피스톤","70172381920","5560","12620932","13168460","547528","2024-09"
"088910","동우팜투테이블","51443528000","2000","25721764","25831764","110000","2024-09"
"094170","동운아나텍","344334982320","18270","18847016","19067208","220192","2024-09"
"049770","동원F&B","602023344000","31200","19295620","19295620","0","2024-09"
"013120","동원개발","230652574000","2540","90808100","90808100","0","2024-09"
"018500","동원금속","57355875735","1227","46744805","46754933","10128","2024-09"
"006040","동원산업","1219341145750","33850","36021895","36021895","0","2024-09"
"030720","동원수산","26107846050","5610","4653805","4653805","0","2024-09"
"014820","동원시스템즈","1475656253800","50900","28991282","28991282","0","2024-09"
"111380","동인기연","113491520880","19120","5935749","6128000","192251","2024-09"
"163560","동일고무벨트","103138000000","7420","13900000","13900000","0","2024-09"
"109860","동일금속","73256888500","8660","8459225","9100000","640775","2024-09"
"032960","동일기연","42062629560","11130","3779212","3986323","207111","2024-09"
"004890","동일산업","85884715150","39650","2166071","2425215","259144","2024-09"
"002690","동일제강","27587265440","1454","18973360","20300360","1327000","2024-09"
"023790","동일철강","26238301740","1260","20824049","20841335","17286","2024-09"
"005290","동진쎄미켐","1398474236800","27200","51414494","51414494","0","2024-09"
"025900","동화기업","517789002960","11320","45741078","50557285","4816207","2024-09"
"000020","동화약품","207607295700","7490","27717930","27931470","213540","2024-09"
"000150","두산","2833062005500","209500","13522969","16523835","3000866","2024-09"
"454910","두산로보틱스","4427204634000","68300","64819980","64819980","0","2024-09"
"241560","두산밥캣","3788490110650","37850","100092209","100249166","156957","2024-09"
"034020","두산에너빌리티","13705954595200","21400","640465168","640561146","95978","2024-09"
"131970","두산테스나","496539220350","29350","16917861","17006566","88705","2024-09"
"336260","두산퓨얼셀","1145946882500","17500","65482679","65493726","11047","2024-09"
"016740","두올","106692990150","3425","31151238","32066680","915442","2024-09"
"073190","듀오백","27990498140","2530","11063438","11968040","904602","2024-09"
"030350","드래곤플라이","17277854277","249","69388973","69388973","0","2024-09"
"203650","드림시큐리티","160872356700","3300","48749199","50605754","1856555","2024-09"
"223250","드림씨아이에스","104241039120","4380","23799324","23799324","0","2024-09"
"060570","드림어스컴퍼니","187919608905","2485","75621573","75621573","0","2024-09"
"362990","드림인사이트","34925797440","2130","16397088","16800574","403486","2024-09"
"192650","드림텍","565795786860","8380","67517397","68883113","1365716","2024-09"
"217620","디딤이앤에프","21715711458","381","56996618","57747210","750592","2024-09"
"016670","디모아","22702665200","4600","4935362","4941846","6484","2024-09"
"187870","디바이스이엔지","85232246480","12680","6721786","7036609","314823","2024-09"
"024090","디씨엠","104587300200","12050","8679444","11400000","2720556","2024-09"
"003160","디아이","533343764500","20500","26016769","28300000","2283231","2024-09"
"092200","디아이씨","142584820000","3680","38745875","38888569","142694","2024-09"
"110990","디아이티","262531616160","14240","18436209","18900000","463791","2024-09"
"263690","디알젬","76394350440","6970","10960452","11325610","365158","2024-09"
"214680","디알텍","207910094880","2820","73726984","73727108","124","2024-09"
"347850","디앤디파마텍","433141761900","41100","10538729","10538729","0","2024-09"
"263720","디앤씨미디어","214986076120","17320","12412591","12524473","111882","2024-09"
"376300","디어유","707404498800","29800","23738406","23738406","0","2024-09"
"109740","디에스케이","127780376100","5070","25203230","25710390","507160","2024-09"
"196490","디에이테크놀로지","36209568780","203","178372260","178549360","177100","2024-09"
"066900","디에이피","43297212780","2460","17600493","22744503","5144010","2024-09"
"127120","디엔에이링크","80941834800","3600","22483843","22483843","0","2024-09"
"092070","디엔에프","120463041780","10410","11571858","11571858","0","2024-09"
"039840","디오","234122205600","16200","14451988","14981755","529767","2024-09"
"013570","디와이","114095008375","4625","24669191","26319633","1650442","2024-09"
"219550","디와이디","40427907365","515","78500791","78500791","0","2024-09"
"310870","디와이씨","26519819934","1282","20686287","20687271","984","2024-09"
"210540","디와이파워","134637382200","12200","11035851","11041708","5857","2024-09"
"104460","디와이피엔에프","96370239340","9970","9666022","10713625","1047603","2024-09"
"079810","디이엔티","166735788170","7630","21852659","22028094","175435","2024-09"
"113810","디젠스","28321148268","868","32628051","32628051","0","2024-09"
"043360","디지아이","18816914590","2110","8917969","9000000","82031","2024-09"
"197140","디지캡","32863665660","2590","12688674","13013154","324480","2024-09"
"068930","디지털대성","194168676000","7410","26203600","27675342","1471742","2024-09"
"033130","디지틀조선","63764028706","1718","37115267","37115267","0","2024-09"
"105740","디케이락","72704867950","7150","10168513","10168513","0","2024-09"
"263020","디케이앤디","54385782305","3655","14879831","15069831","190000","2024-09"
"290550","디케이티","166810258200","8340","20001230","20001230","0","2024-09"
"066670","디티씨","51017310500","3250","15697634","18691918","2994284","2024-09"
"187220","디티앤씨","40625388825","3525","11524933","11698021","173088","2024-09"
"383930","디티앤씨알오","98971468000","7750","12770512","12770512","0","2024-09"
"131180","딜리","27870221583","1003","27786861","29350000","1563139","2024-09"
"315640","딥노이드","139460286960","6220","22421268","22421268","0","2024-09"
"223310","딥마인드","46124898160","2020","22834108","22839375","5267","2024-09"
"317120","라닉스","33623672100","3490","9634290","9660000","25710","2024-09"
"462510","라메디텍","93427938000","10800","8650735","8650735","0","2024-09"
"042510","라온시큐어","102711226000","1900","54058540","56025871","1967331","2024-09"
"232680","라온테크","85867640320","7040","12197108","12534234","337126","2024-09"
"418420","라온텍","98504317120","3280","30031804","30108433","76629","2024-09"
"300120","라온피플","100858158020","4835","20860012","20860012","0","2024-09"
"171120","라이온켐텍","84709680000","2400","35295700","35901760","606060","2024-09"
"388790","라이콤","91383045495","3065","29815023","29913930","98907","2024-09"
"347700","라이프시맨틱스","71744685760","3520","20382013","20382013","0","2024-09"
"214260","라파스","146048784650","17390","8398435","8912435","514000","2024-09"
"115390","락앤락","374233582080","8640","43314072","43326411","12339","2024-09"
"200350","래몽래인","134746417000","13480","9996025","9996025","0","2024-09"
"171010","램테크놀러지","52905382400","3700","14298752","14298752","0","2024-09"
"084650","랩지노믹스","248332766550","3345","74239990","74239990","0","2024-09"
"217500","러셀","48211086588","1662","29007874","31812000","2804126","2024-09"
"038390","레드캡투어","132261702020","15820","8360411","8589480","229069","2024-09"
"294140","레몬","94474273500","4500","20994283","21000000","5717","2024-09"
"443250","레뷰코퍼레이션","104417114400","9690","10775760","11279386","503626","2024-09"
"228670","레이","131089848840","8460","15495254","15495254","0","2024-09"
"228850","레이언스","108424071600","6890","15736440","16591014","854574","2024-09"
"412350","레이저쎌","43503955420","4985","8726972","8726972","0","2024-09"
"199550","레이저옵텍","77857824840","6680","11655363","11656947","1584","2024-09"
"281740","레이크머티리얼즈","947176649100","14410","65730510","65730548","38","2024-09"
"277810","레인보우로보틱스","2428862221600","125200","19399858","19399858","0","2024-09"
"215100","로보로보","71374147125","3525","20247985","20348454","100469","2024-09"
"090360","로보스타","203775000000","20900","9750000","9750000","0","2024-09"
"108490","로보티즈","232028993350","17990","12897665","13053665","156000","2024-09"
"067730","로지시스","25200566810","2605","9673922","9673922","0","2024-09"
"071280","로체시스템즈","283852793070","19030","14916069","15296603","380534","2024-09"
"032350","롯데관광개발","740626898760","9720","76196183","76196183","0","2024-09"
"089860","롯데렌탈","1040684404950","28650","36324063","36634063","310000","2024-09"
"000400","롯데손해보험","684678716450","2215","309110030","310336320","1226290","2024-09"
"023530","롯데쇼핑","1814975088000","64200","28270640","28288755","18115","2024-09"
"020150","롯데에너지머티리얼즈","1779878231000","38600","46110835","46110835","0","2024-09"
"280360","롯데웰푸드","1156437723600","130800","8841267","9434574","593307","2024-09"
"286940","롯데이노베이트","341167225850","22550","15129367","15129367","0","2024-09"
"004000","롯데정밀화학","1174167000000","46100","25470000","25800000","330000","2024-09"
"004990","롯데지주","1685166140000","23800","70805300","104909237","34103937","2024-09"
"005300","롯데칠성","1097691977200","118300","9278884","9278884","0","2024-09"
"011170","롯데케미칼","4001662250300","94900","42167147","42775419","608272","2024-09"
"071840","롯데하이마트","182772124800","7900","23135712","23607712","472000","2024-09"
"328130","루닛","1095736118400","37950","28873152","28873152","0","2024-09"
"038060","루멘스","59503496353","1237","48103069","48103069","0","2024-09"
"474170","루미르","156450827520","9120","17154696","17154696",,"자료 없음"
"141080","리가켐바이오","4633558665600","127200","36427348","36567348","140000","2024-09"
"058470","리노공업","2736795336000","180300","15179120","15242370","63250","2024-09"
"016100","리더스코스메틱","50056807710","2730","18335827","19100894","765067","2024-09"
"012700","리드코프","111337606200","4350","25594852","26446135","851283","2024-09"
"302550","리메드","115505561600","3770","30638080","30638080","0","2024-09"
"073570","리튬포어스","61587086154","1702","36185127","36189497","4370","2024-09"
"377450","리파인","206941955400","13610","15205140","17330000","2124860","2024-09"
"277070","린드먼아시아","49790938500","3930","12669450","13692000","1022550","2024-09"
"042500","링네트","74551408080","4630","16101816","19070134","2968318","2024-09"
"193250","링크드","27039081979","427","63323377","63323377","0","2024-09"
"219420","링크제니시스","49520930800","4400","11254757","11469507","214750","2024-09"
"439090","마녀공장","303161592600","18510","16378260","16378260","0","2024-09"
"027740","마니커","58484621778","921","63501218","63511228","10010","2024-09"
"195500","마니커에프앤지","46416090000","2905","15978000","15978000","0","2024-09"
"377480","마음AI","66011222680","10580","6239246","6239246","0","2024-09"
"305090","마이크로디지탈","211672192000","12800","16536890","16536890","0","2024-09"
"098120","마이크로컨텍솔","44223915120","5320","8312766","8312766","0","2024-09"
"424980","마이크로투나노","53092443300","8970","5918890","5918890","0","2024-09"
"038290","마크로젠","182217580820","18260","9979057","10841400","862343","2024-09"
"001080","만호제강","91050097600","30800","2956172","4150000","1193828","2024-09"
"267980","매일유업","275316799800","38150","7216692","7843638","626946","2024-09"
"005990","매일홀딩스","104955690000","8400","12494725","13718304","1223579","2024-09"
"093520","매커스","87446143620","8910","9814382","16163092","6348710","2024-09"
"377030","맥스트","44523756550","2275","19570882","19570882","0","2024-09"
"100590","머큐리","53822078200","3400","15830023","15830023","0","2024-09"
"067280","멀티캠퍼스","175728997350","29650","5926779","5926779","0","2024-09"
"072870","메가스터디","126617722200","11100","11407002","11920959","513957","2024-09"
"215200","메가스터디교육","458868236550","42650","10758927","11461955","703028","2024-09"
"133750","메가엠디","44701844625","2025","22074985","23407077","1332092","2024-09"
"446540","메가터치","86095795000","4145","20771000","20771000","0","2024-09"
"235980","메드팩토","183350594700","5460","33580695","33580695","0","2024-09"
"041920","메디아나","84911313750","4575","18559850","18598223","38373","2024-09"
"014100","메디앙스","24466043645","2165","11300713","11800000","499287","2024-09"
"054180","메디콕스","19662990152","334","58871228","58878283","7055","2024-09"
"086900","메디톡스","1148359097600","170600","6731296","7298497","567201","2024-09"
"078160","메디포스트","220960126800","6480","34098785","34217785","119000","2024-09"
"138040","메리츠금융지주","19222645081900","103900","185011021","190720114","5709093","2024-09"
"408920","메쎄이상","95975449140","2230","43038318","43232455","194137","2024-09"
"021880","메이슨캐피탈","47024982072","309","152184408","152184408","0","2024-09"
"140410","메지온","952693592400","31800","29958918","29958918","0","2024-09"
"241770","메카로","74838340000","7600","9847150","10192640","345490","2024-09"
"090370","메타랩스","40390442238","1622","24901629","24904689","3060","2024-09"
"059210","메타바이오메드","89654743360","3920","22871108","23862351","991243","2024-09"
"118000","메타케어","55694020980","338","164775210","164777364","2154","2024-09"
"058110","멕아이씨에스","38976287950","2515","15497530","16050530","553000","2024-09"
"017180","명문제약","76049453025","2275","33428331","33953454","525123","2024-09"
"009900","명신산업","699951574220","13340","52470133","52470133","0","2024-09"
"012690","모나리자","129607947375","3545","36560775","36571255","10480","2024-09"
"005360","모나미","41101642725","2175","18897307","18897307","0","2024-09"
"070960","모나용평","177864856080","3760","47304483","48133333","828850","2024-09"
"434480","모니터랩","46821914000","3980","11764300","12253300","489000","2024-09"
"080420","모다이노칩","151231916934","1897","79721622","79721622","0","2024-09"
"417970","모델솔루션","60128980000","9400","6396700","6396700","0","2024-09"
"080160","모두투어","172949767110","9990","17312289","18900000","1587711","2024-09"
"087260","모바일어플라이언스","70151415455","2155","32552861","32552861","0","2024-09"
"101330","모베이스","71061379030","3070","23147029","23147029","0","2024-09"
"012860","모베이스전자","128716535024","1771","72680144","73233457","553313","2024-09"
"363260","모비데이즈","85978923400","2710","31726540","32163769","437229","2024-09"
"348030","모비릭스","50708064000","5280","9603800","9603800","0","2024-09"
"250060","모비스","101410989855","3165","32041387","32171314","129927","2024-09"
"288980","모아데이타","56327196060","1630","34556562","34556562","0","2024-09"
"142760","모아라이프플러스","51017464472","1352","37734811","37734811","0","2024-09"
"033200","모아텍","29546538090","3210","9204529","14331185","5126656","2024-09"
"333050","모코엠시스","29076055360","1265","22985024","24444326","1459302","2024-09"
"009680","모토닉","187078947600","8650","21627624","33000000","11372376","2024-09"
"118990","모트렉스","251173572860","10130","24795022","24861990","66968","2024-09"
"006920","모헨즈","27736800000","2540","10920000","10920000","0","2024-09"
"009580","무림P&P","171812208390","2755","62363778","62368324","4546","2024-09"
"001810","무림SP","36327637500","1641","22137500","22137500","0","2024-09"
"009200","무림페이퍼","85923225150","2065","41609310","41609310","0","2024-09"
"033920","무학","162099632160","6120","26486868","28500000","2013132","2024-09"
"008420","문배철강","42702504150","2230","19149105","20503505","1354400","2024-09"
"279600","미디어젠","52938025300","11300","4684781","4684781","0","2024-09"
"095500","미래나노텍","295072783200","10400","28372383","31009999","2637616","2024-09"
"254490","미래반도체","231729900000","16050","14438000","14438000","0","2024-09"
"025560","미래산업","33201278890","1066","31145665","31166865","21200","2024-09"
"218150","미래생명자원","86365370670","4430","19495569","20415802","920233","2024-09"
"007120","미래아이앤지","28962500840","1060","27323114","28878608","1555494","2024-09"
"442900","미래에셋드림스팩1호","76646400000","9980","7680000","7680000","0","2024-09"
"100790","미래에셋벤처투자","256572391740","4830","53120578","53124634","4056","2024-09"
"412930","미래에셋비전스팩1호","16984000000","2750","6176000","6176000","0","2024-09"
"446190","미래에셋비전스팩2호","11112750000","2245","4950000","4950000","0","2024-09"
"448830","미래에셋비전스팩3호","10578000000","2150","4920000","4920000","0","2024-09"
"477380","미래에셋비전스팩4호","16321500000","2015","8100000","8100000","0","2024-09"
"477470","미래에셋비전스팩5호","11398400000","2080","5480000","5480000","0","2024-09"
"478440","미래에셋비전스팩6호","13963950000","2015","6930000","6930000","0","2024-09"
"482680","미래에셋비전스팩7호","16298560000","1984","8215000","8215000","0","2024-09"
"085620","미래에셋생명","691544000000","5300","130480000","177016189","46536189","2024-09"
"006800","미래에셋증권","4127709829990","9190","449152321","595316408","146164087","2024-09"
"049950","미래컴퍼니","146087772470","18430","7926629","8817884","891255","2024-09"
"207760","미스터블루","113195224410","1374","82383715","83079783","696068","2024-09"
"002840","미원상사","909333381000","195800","4644195","4750000","105805","2024-09"
"268280","미원에스씨","704144317800","144200","4883109","5000000","116891","2024-09"
"107590","미원홀딩스","185004455000","79900","2315450","2320000","4550","2024-09"
"134380","미원화학","160003105800","79900","2002542","2199268","196726","2024-09"
"003650","미창석유","148574537800","98200","1512979","1739672","226693","2024-09"
"059090","미코","320630267460","10180","31496097","33416778","1920681","2024-09"
"214610","미코바이오메드","75793674420","1740","43559583","43568945","9362","2024-09"
"201490","미투온","65795809300","2150","30602702","31257770","655068","2024-09"
"452200","민테크","145497339000","6630","21945300","21945300","0","2024-09"
"418470","밀리의서재","114315437050","13450","8499289","8499289","0","2024-09"
"206640","바디텍메드","343051541560","15610","21976396","23486560","1510164","2024-09"
"018700","바른손","39006434544","1133","34427568","35119757","692189","2024-09"
"035620","바른손이앤에이","35128400263","473","74267231","74439675","172444","2024-09"
"053030","바이넥스","649692590400","20400","31847676","32684188","836512","2024-09"
"301300","바이브컴퍼니","49922331375","4035","12372325","12394861","22536","2024-09"
"377740","바이오노트","466851011400","4590","101710460","102056048","345588","2024-09"
"064550","바이오니아","598798751200","23200","25810291","25810291","0","2024-09"
"314930","바이오다인","578334031200","19620","29476760","29764103","287343","2024-09"
"208710","바이오로그디바이스","28732689504","436","65900664","65900664","0","2024-09"
"086820","바이오솔루션","136401506000","17000","8023618","8143426","119808","2024-09"
"038460","바이오스마트","81458136200","3535","23043320","23933216","889896","2024-09"
"251120","바이오에프디엔씨","139448316150","16350","8528949","8695700","166751","2024-09"
"199730","바이오인프라","39644591050","8150","4864367","4864367","0","2024-09"
"086040","바이오톡스텍","69171471600","4400","15720789","15958247","237458","2024-09"
"099430","바이오플러스","298963497870","5310","56301977","57930864","1628887","2024-09"
"032980","바이온","29188090520","652","44767010","44777990","10980","2024-09"
"308080","바이젠셀","57791220000","3000","19263740","19263740","0","2024-09"
"043150","바텍","346846877600","23350","14854256","14854256","0","2024-09"
"323990","박셀바이오","290960785150","12670","22964545","22993200","28655","2024-09"
"003610","방림","115385121340","3260","35394209","42314090","6919881","2024-09"
"267790","배럴","36011002500","4565","7888500","7888500","0","2024-09"
"001340","백광산업","424272918270","9610","44149107","44918407","769300","2024-09"
"046310","백금T&A","38998954275","2425","16082043","16418641","336598","2024-09"
"035150","백산","285520000000","13280","21500000","21500000","0","2024-09"
"331520","밸로프","33261638592","678","49058464","50864390","1805926","2024-09"
"199480","뱅크웨어글로벌","71822646180","7110","10101638","10101638","0","2024-09"
"438700","버넥트","39620083950","3555","11144890","11144890","0","2024-09"
"066410","버킷스튜디오","96977294204","1153","84108668","84109926","1258","2024-09"
"002410","범양건영","25326551040","1020","24829952","24831982","2030","2024-09"
"382900","범한퓨얼셀","120755775000","14070","8582500","8761000","178500","2024-09"
"206400","베노티앤알","127894651350","3945","32419430","32420452","1022","2024-09"
"019010","베뉴지","86229000000","2145","40200000","48200000","8000000","2024-09"
"177350","베셀","27385370427","307","89203161","89372043","168882","2024-09"
"424760","벨로크","19994797476","1031","19393596","19665002","271406","2024-09"
"007210","벽산","111459933035","1991","55981885","67560000","11578115","2024-09"
"225530","보광산업","140630192370","3870","36338551","36338727","176","2024-09"
"250000","보라티알","64640663220","9870","6549206","6750733","201527","2024-09"
"002760","보락","78588800000","1312","59900000","59900000","0","2024-09"
"003850","보령","722546838700","10970","65865710","68690000","2824290","2024-09"
"310210","보로노이","1852769311200","103200","17953191","18356592","403401","2024-09"
"006910","보성파워텍","158777278880","3245","48929824","49129824","200000","2024-09"
"000890","보해양조","59385277784","427","139075592","139120129","44537","2024-09"
"226340","본느","68927760340","1643","41952380","41952420","40","2024-09"
"003000","부광약품","335085614545","4895","68454671","68454671","0","2024-09"
"001270","부국증권","164810635500","27750","5939122","10369886","4430764","2024-09"
"026940","부국철강","49700000000","2485","20000000","20000000","0","2024-09"
"014470","부방","94238340636","1756","53666481","60052260","6385779","2024-09"
"011390","부산산업","55756800000","52800","1056000","1056000","0","2024-09"
"005030","부산주공","38288532168","486","78782988","78782988","0","2024-09"
"008470","부스타","31680699120","3920","8081811","8404800","322989","2024-09"
"338220","뷰노","403452703850","29050","13888217","13888217","0","2024-09"
"100120","뷰웍스","224956819500","24500","9181911","10001865","819954","2024-09"
"406820","뷰티스킨","49476560000","14000","3534040","3534040","0","2024-09"
"337930","브랜드엑스코퍼레이션","251199957790","8570","29311547","29311547","0","2024-09"
"099390","브레인즈컴퍼니","51846966560","6560","7903501","8208283","304782","2024-09"
"064480","브리지텍","59690838100","5150","11590454","11952500","362046","2024-09"
"288330","브릿지바이오테라퓨틱스","236858705220","4980","47561989","47561989","0","2024-09"
"365900","브이씨","23831578000","3260","7310300","7310300","0","2024-09"
"089970","브이엠","183070829040","8310","22030184","24075595","2045411","2024-09"
"251630","브이원텍","62347904825","4085","15262645","15942886","680241","2024-09"
"018290","브이티","1098493710650","30950","35492527","35798007","305480","2024-09"
"439580","블루엠텍","243510817800","21800","11170221","11170221","0","2024-09"
"033560","블루콤","56485967570","3310","17065247","17100000","34753","2024-09"
"369370","블리츠웨이스튜디오","77987241491","1637","47640343","49871911","2231568","2024-09"
"126340","비나텍","212525147650","35950","5911687","6085118","173431","2024-09"
"121800","비덴트","256296018720","3320","77197596","77201611","4015","2024-09"
"082800","비보존 제약","261822769440","5510","47517744","48242965","725221","2024-09"
"318410","비비씨","45775202320","8240","5555243","5555243","0","2024-09"
"002070","비비안","24609835740","826","29793990","29793990","0","2024-09"
"100220","비상교육","63095302250","5150","12251515","12996741","745226","2024-09"
"419540","비스토스","41888609010","1822","22990455","22992511","2056","2024-09"
"146320","비씨엔씨","167961517920","13230","12695504","12792923","97419","2024-09"
"200780","비씨월드제약","40884847425","4845","8438565","8892384","453819","2024-09"
"413640","비아이매트릭스","53763772400","7460","7206940","7206940","0","2024-09"
"141000","비아트론","73692550920","6680","11031819","12114710","1082891","2024-09"
"090460","비에이치","510902395080","16280","31382211","34464379","3082168","2024-09"
"083650","비에이치아이","365117181200","11800","30942134","30944375","2241","2024-09"
"445360","비엔케이제1호스팩","9072550000","2105","4310000","4310000","0","2024-09"
"473370","비엔케이제2호스팩","8546300000","2030","4210000","4210000","0","2024-09"
"065170","비엘팜텍","21619406736","243","88968752","88970559","1807","2024-09"
"086670","비엠티","78841503360","8640","9125174","9125174","0","2024-09"
"335890","비올","488505272400","8460","57742940","58419125","676185","2024-09"
"230980","비유테크놀러지","21370405721","229","93320549","93320557","8","2024-09"
"138580","비즈니스온","356042480800","15850","22463248","22556163","92915","2024-09"
"082920","비츠로셀","439082414400","19600","22402164","22872213","470049","2024-09"
"054220","비츠로시스","21679824159","441","49160599","49160599","0","2024-09"
"042370","비츠로테크","184186175750","7030","26200025","26200025","0","2024-09"
"050090","비케이홀딩스","15367368900","780","19701755","19784735","82980","2024-09"
"148780","비큐AI","33332468500","1060","31445725","31445725","0","2024-09"
"307870","비투엔","33792217734","746","45297879","45297879","0","2024-09"
"357880","비트나인","22245626280","2130","10443956","10443956","0","2024-09"
"032850","비트컴퓨터","78426018440","4865","16120456","16623293","502837","2024-09"
"238200","비피도","31370300000","3835","8180000","8180000","0","2024-09"
"093190","빅솔론","67726075500","4500","15050239","19238905","4188666","2024-09"
"065450","빅텍","140685248000","4910","28652800","28652800","0","2024-09"
"210120","빅텐츠","76256792500","24250","3144610","3144610","0","2024-09"
"044480","빌리언스","23584962240","580","40663728","40663728","0","2024-09"
"005180","빙그레","554380922700","62700","8841801","9851241","1009440","2024-09"
"069540","빛과전자","58495162960","1378","42449320","42449320","0","2024-09"
"072950","빛샘전자","31161327360","3890","8010624","8052610","41986","2024-09"
"451250","삐아","96361102380","9740","9893337","10089877","196540","2024-09"
"143240","사람인","175437193920","16160","10856262","11709263","853001","2024-09"
"003960","사조대림","378275883300","45300","8350461","9164467","814006","2024-09"
"008040","사조동아원","147006880342","1043","140946194","141144600","198406","2024-09"
"007160","사조산업","363490400000","72800","4993000","5000000","7000","2024-09"
"014710","사조씨푸드","121907284440","7080","17218543","17218543","0","2024-09"
"006090","사조오양","81600893760","8660","9422736","9422739","3","2024-09"
"452430","사피엔반도체","96253877960","11890","8095364","8096454","1090","2024-09"
"419120","산돌","46605346970","6370","7316381","7774326","457945","2024-09"
"062040","산일전기","1206262545900","39700","30384447","30445200","60753","2024-09"
"122350","삼기","55272043008","1456","37961568","38339428","377860","2024-09"
"419050","삼기이브이","125831728000","2200","57196240","57196240","0","2024-09"
"014970","삼륭물산","59175507000","3975","14886920","15125000","238080","2024-09"
"018310","삼목에스폼","307982118300","21650","14225502","14700000","474498","2024-09"
"053700","삼보모터스","95917945140","4315","22228956","22877190","648234","2024-09"
"009620","삼보산업","19183979620","260","73784537","73785902","1365","2024-09"
"023600","삼보판지","142019142120","9060","15675402","16170000","494598","2024-09"
"001470","삼부토건","106439228224","476","223611824","223611824","0","2024-09"
"028050","삼성E&A","3700480000000","18880","196000000","196000000","0","2024-09"
"006400","삼성SDI","22803448941500","348500","65433139","68764530","3331391","2024-09"
"006660","삼성공조","84739057480","10780","7860766","8126314","265548","2024-09"
"028260","삼성물산","21730455854000","134000","162167581","177784107","15616526","2024-09"
"207940","삼성바이오로직스","75302092000000","1058000","71174000","71174000","0","2024-09"
"032830","삼성생명","18406414847500","102500","179574779","200000000","20425221","2024-09"
"425290","삼성스팩6호","11757600000","2130","5520000","5520000","0","2024-09"
"439250","삼성스팩7호","36280720000","10360","3502000","3502000","0","2024-09"
"448740","삼성스팩8호","46873200000","10050","4664000","4664000","0","2024-09"
"468510","삼성스팩9호","22321000000","2020","11050000","11050000","0","2024-09"
"018260","삼성에스디에스","11331802249000","146500","77350186","77377800","27614","2024-09"
"009150","삼성전기","8810475955200","121200","72693696","74693696","2000000","2024-09"
"005930","삼성전자","346844366155000","58100","5969782550","5969782550","0","2024-09"
"001360","삼성제약","147298263240","1565","94120296","94162079","41783","2024-09"
"010140","삼성중공업","8301225750120","9720","854035571","880000000","25964429","2024-09"
"016360","삼성증권","4192635000000","46950","89300000","89300000","0","2024-09"
"068290","삼성출판사","141500000000","14150","10000000","10000000","0","2024-09"
"029780","삼성카드","4204401383000","39400","106710695","115858891","9148196","2024-09"
"000810","삼성화재","14079302636000","353500","39828296","47374837","7546541","2024-09"
"006110","삼아알미늄","773846781600","52600","14711916","14711916","0","2024-09"
"009300","삼아제약","131221853000","21500","6103342","6370000","266658","2024-09"
"145990","삼양사","479450960000","49600","9666350","10313449","647099","2024-09"
"003230","삼양식품","3893142816000","522000","7458128","7533015","74887","2024-09"
"002170","삼양통상","131977000000","48700","2710000","3000000","290000","2024-09"
"272550","삼양패키징","253725129560","16360","15508871","15788671","279800","2024-09"
"000070","삼양홀딩스","532385022000","71600","7435545","8564271","1128726","2024-09"
"003720","삼영","144760619925","4365","33163945","34000000","836055","2024-09"
"002810","삼영무역","222995515600","12650","17628104","18466948","838844","2024-09"
"361670","삼영에스앤씨","36034900680","6460","5578158","5667658","89500","2024-09"
"054540","삼영엠텍","48277400000","3980","12130000","13000000","870000","2024-09"
"065570","삼영이엔씨","29541036770","2170","13613381","13613381","0","2024-09"
"005680","삼영전자","191780505600","9600","19977136","20000000","22864","2024-09"
"023000","삼원강재","103125185820","2595","39739956","40000000","260044","2024-09"
"004380","삼익THK","184230000000","8900","20700000","21000000","300000","2024-09"
"002450","삼익악기","83481944670","1098","76030915","90530915","14500000","2024-09"
"032280","삼일","22924844160","1478","15510720","16213590","702870","2024-09"
"002290","삼일기업공사","35526000000","2865","12400000","12400000","0","2024-09"
"004440","삼일씨엔에스","56020566800","4400","12731947","12731947","0","2024-09"
"000520","삼일제약","336215588380","15890","21158942","21621100","462158","2024-09"
"009770","삼정펄프","66999222800","26800","2499971","2499971","0","2024-09"
"037460","삼지전자","132026443200","8600","15351912","16318522","966610","2024-09"
"032750","삼진","37769867730","4185","9025058","9031122","6064","2024-09"
"054090","삼진엘앤디","21415944672","864","24786973","24959232","172259","2024-09"
"005500","삼진제약","226495030400","18080","12527380","13900000","1372620","2024-09"
"000250","삼천당제약","3067660556800","131900","23257472","23457472","200000","2024-09"
"004690","삼천리","306107835000","89400","3424025","4055025","631000","2024-09"
"024950","삼천리자전거","48289645320","3990","12102668","13273577","1170909","2024-09"
"038500","삼표시멘트","328501869120","3060","107353552","107916306","562754","2024-09"
"437730","삼현","78846149940","7460","10569189","10569189","0","2024-09"
"017480","삼현철강","72581583000","4700","15442890","15702890","260000","2024-09"
"010960","삼호개발","70434000000","3150","22360000","25000000","2640000","2024-09"
"046390","삼화네트웍스","61403137686","1551","39589386","43172933","3583547","2024-09"
"004450","삼화왕관","56204536850","31150","1804319","2154379","350060","2024-09"
"009470","삼화전기","282740805000","42750","6613820","6613820","0","2024-09"
"011230","삼화전자","49688669520","2940","16900908","16902700","1792","2024-09"
"001820","삼화콘덴서","342717400000","33400","10261000","10395000","134000","2024-09"
"000390","삼화페인트","171975984300","7290","23590670","27203469","3612799","2024-09"
"027580","상보","68443675245","1215","56332243","59181279","2849036","2024-09"
"038540","상상인","87011598840","1590","54724276","55328313","604037","2024-09"
"415580","상상인제3호스팩","11124450000","2095","5310000","5310000","0","2024-09"
"452670","상상인제4호스팩","10492200000","2010","5220000","5220000","0","2024-09"
"001290","상상인증권","50687852157","477","106263841","108337120","2073279","2024-09"
"041650","상신브레이크","66212260200","3420","19360310","21471450","2111140","2024-09"
"091580","상신이디피","137280655700","10300","13328219","13428219","100000","2024-09"
"263810","상신전자","46354738185","3255","14241087","14244718","3631","2024-09"
"089980","상아프론테크","324283294400","20800","15590543","15989037","398494","2024-09"
"042940","상지건설","23516161860","5910","3979046","3981814","2768","2024-09"
"042600","새로닉스","167817126680","13720","12231569","12423574","192005","2024-09"
"075180","새론오토모티브","75456000000","3930","19200000","19200000","0","2024-09"
"107600","새빗켐","116069998500","23300","4981545","4981545","0","2024-09"
"411080","샌즈랩","103004357040","7080","14548638","15248638","700000","2024-09"
"252990","샘씨엔에스","333531162900","5850","57013874","58388063","1374189","2024-09"
"007540","샘표","88680592000","44000","2015468","2875800","860332","2024-09"
"248170","샘표식품","131746294600","28850","4566596","4568286","1690","2024-09"
"378800","샤페론","136397215275","4525","30143031","30143031","0","2024-09"
"294630","서남","86445949695","3605","23979459","23979459","0","2024-09"
"038070","서린바이오","60713754860","7190","8444194","8900676","456482","2024-09"
"006730","서부T&D","393417987200","6100","64494752","66426923","1932171","2024-09"
"079650","서산","24320000000","1216","20000000","20000000","0","2024-09"
"100660","서암기계공업","47502000000","3770","12600000","12600000","0","2024-09"
"007860","서연","149780273400","6900","21707286","23479844","1772558","2024-09"
"200880","서연이화","364807138500","13500","27022751","27028437","5686","2024-09"
"019770","서연탑메탈","42347750000","3635","11650000","11650000","0","2024-09"
"017390","서울가스","203070021600","52300","3882792","5000000","1117208","2024-09"
"043710","서울리거","32578724607","649","50198343","50198880","537","2024-09"
"092190","서울바이오시스","187696004950","4150","45227953","45868383","640430","2024-09"
"046890","서울반도체","523218835200","9280","56381340","58305400","1924060","2024-09"
"004410","서울식품","57712332986","154","374755409","374755559","150","2024-09"
"063170","서울옥션","114154982040","6780","16837018","17774267","937249","2024-09"
"027040","서울전자통신","18162511848","261","69588168","69588847","679","2024-09"
"018680","서울제약","46753869190","4010","11659319","11659319","0","2024-09"
"021050","서원","59723034220","1258","47474590","47474590","0","2024-09"
"093920","서원인텍","108438000000","5830","18600000","18600000","0","2024-09"
"189860","서전기전","51597509600","5320","9698780","9698780","0","2024-09"
"178320","서진시스템","1572130314300","27950","56247954","56247954","0","2024-09"
"122690","서진오토모티브","49305453280","2270","21720464","21844410","123946","2024-09"
"140070","서플러스글로벌","114721743420","3330","34450974","36988000","2537026","2024-09"
"011370","서한","75413656320","768","98194865","100894865","2700000","2024-09"
"065710","서호전기","106747100300","21650","4930582","5150000","219418","2024-09"
"008490","서흥","176682705570","15890","11119113","11569113","450000","2024-09"
"035890","서희건설","273918172840","1417","193308520","229808457","36499937","2024-09"
"357550","석경에이티","248562300000","45700","5439000","5455000","16000","2024-09"
"003100","선광","99256200000","15780","6290000","6600000","310000","2024-09"
"007610","선도전기","50907057000","3000","16969019","18000000","1030981","2024-09"
"067370","선바이오","81461304460","6620","12305333","12313555","8222","2024-09"
"171090","선익시스템","393117504900","44900","8755401","9494405","739004","2024-09"
"136490","선진","159796277760","6720","23779208","23779604","396","2024-09"
"086710","선진뷰티사이언스","120943318200","10070","12010260","12203280","193020","2024-09"
"014620","성광벤드","341891324930","12770","26773009","28600000","1826991","2024-09"
"037350","성도이엔지","65404815000","4605","14203000","15470000","1267000","2024-09"
"014910","성문전자","25863542222","1246","20757257","22460985","1703728","2024-09"
"003080","성보화학","51320615020","2620","19588021","20020000","431979","2024-09"
"004980","성신양회","192679625030","7990","24115097","24516073","400976","2024-09"
"011300","성안머티리얼스","35866893192","438","81887884","81887884","0","2024-09"
"081580","성우전자","67660910550","4450","15204699","15508143","303444","2024-09"
"045300","성우테크론","26969080700","2755","9789140","10151583","362443","2024-09"
"015750","성우하이텍","499947456250","6250","79991593","80000000","8407","2024-09"
"365340","성일하이텍","663912880900","54700","12137347","12137347","0","2024-09"
"000180","성창기업지주","95001679200","1362","69751600","69751600","0","2024-09"
"080470","성창오토텍","29930000000","4100","7300000","7300000","0","2024-09"
"043260","성호전자","94065375438","1542","61002189","61002189","0","2024-09"
"148150","세경하이테크","259123820280","7320","35399429","35860429","461000","2024-09"
"002420","세기상사","32463672320","5840","5558848","5558848","0","2024-09"
"188260","세니젠","20443106880","2880","7098301","7228470","130169","2024-09"
"053060","세동","20782150114","1177","17656882","17657419","537","2024-09"
"340440","세림B&G","39616189164","1396","28378359","28378364","5","2024-09"
"017510","세명전기","79279200000","5200","15246000","15246000","0","2024-09"
"004360","세방","214889141520","11980","17937324","19308690","1371366","2024-09"
"004490","세방전지","933967938000","71000","13154478","14000000","845522","2024-09"
"011560","세보엠이씨","99176220000","10000","9917622","10530000","612378","2024-09"
"396300","세아메카닉스","80532712500","3075","26189500","26489500","300000","2024-09"
"001430","세아베스틸지주","716166516430","19970","35862119","35862119","0","2024-09"
"306200","세아제강","326211650000","116500","2800100","2836300","36200","2024-09"
"003030","세아제강지주","658191096900","162900","4040461","4141657","101196","2024-09"
"019440","세아특수강","114741948750","13750","8344869","8570000","225131","2024-09"
"058650","세아홀딩스","398910361600","102400","3895609","4000000","104391","2024-09"
"013000","세우글로벌","35362072592","1232","28702981","28705031","2050","2024-09"
"100700","세운메디칼","117318881000","2710","43291100","43800000","508900","2024-09"
"024830","세원물산","51603000000","6180","8350000","8350000","0","2024-09"
"091090","세원이앤씨","54828158060","1270","43171778","43180255","8477","2024-09"
"021820","세원정공","70500000000","7050","10000000","10000000","0","2024-09"
"067830","세이브존I&C","80711711420","2140","37715753","41040895","3325142","2024-09"
"258830","세종메디칼","22974088612","412","55762351","55786351","24000","2024-09"
"036630","세종텔레콤","93453315888","492","189945764","200000000","10054236","2024-09"
"039310","세중","31060537238","1714","18121667","18121667","0","2024-09"
"075580","세진중공업","408179094080","7180","56849456","56849456","0","2024-09"
"067770","세진티에스","20034088935","2415","8295689","8396593","100904","2024-09"
"053450","세코닉스","80309350530","5490","14628297","14792803","164506","2024-09"
"222810","세토피아","81189010800","1080","75175010","75659350","484340","2024-09"
"252500","세화피앤씨","38043019630","917","41486390","41486390","0","2024-09"
"321370","센서뷰","56112176850","2130","26343745","26343745","0","2024-09"
"347000","센코","79925178855","2455","32556081","33004976","448895","2024-09"
"331920","셀레믹스","31717714980","3885","8164148","8164148","0","2024-09"
"049180","셀루메드","140356297050","2725","51506898","51515906","9008","2024-09"
"299660","셀리드","103932161725","4925","21102977","21102977","0","2024-09"
"268600","셀리버리","248384003120","6680","37183234","37183234","0","2024-09"
"108860","셀바스AI","282869040760","10510","26914276","26914790","514","2024-09"
"208370","셀바스헬스케어","106985128640","4160","25717579","25740564","22985","2024-09"
"318160","셀바이오휴먼텍","30892628800","3520","8776315","9260901","484586","2024-09"
"308430","셀비온","212868840390","16710","12739009","12739009","0","2024-09"
"068270","셀트리온","38684013293100","187700","206094903","217021190","10926287","2024-09"
"068760","셀트리온제약","2582774750400","62400","41390621","41600387","209766","2024-09"
"068940","셀피글로벌","29334496224","778","37705008","38260597","555589","2024-09"
"060230","소니드","38350823628","838","45764706","46066730","302024","2024-09"
"290690","소룩스","398190973920","8740","45559608","45564340","4732","2024-09"
"032680","소프트센","41816042608","401","104279408","105590764","1311356","2024-09"
"258790","소프트캠프","21652722756","903","23978652","24991284","1012632","2024-09"
"066910","손오공","53254813479","1581","33684259","33784259","100000","2024-09"
"336370","솔루스첨단소재","849568805800","12100","70212298","70217344","5046","2024-09"
"248070","솔루엠","925236014160","19010","48671016","50005551","1334535","2024-09"
"035610","솔본","100357754950","3910","25666945","27345997","1679052","2024-09"
"357780","솔브레인","1547854085800","199900","7743142","7778566","35424","2024-09"
"036830","솔브레인홀딩스","1049608924400","50800","20661593","20964056","302463","2024-09"
"304100","솔트룩스","214468442240","17680","12130568","12130568","0","2024-09"
"328380","솔트웨어","35799807505","1045","34258189","34262778","4589","2024-09"
"004430","송원산업","326400000000","13600","24000000","24000000","0","2024-09"
"086980","쇼박스","270356540000","4330","62438000","62638000","200000","2024-09"
"050960","수산아이앤티","67510000000","10000","6751000","6751000","0","2024-09"
"126720","수산인더스트리","318780063750","22650","14074175","14286000","211825","2024-09"
"017550","수산중공업","106702512300","1710","62399130","62399130","0","2024-09"
"084180","수성웹툰","72009399949","613","117470473","117470473","0","2024-09"
"253840","수젠텍","90209041200","5900","15289668","16743200","1453532","2024-09"
"298830","슈어소프트테크","244787027240","4690","52193396","52619061","425665","2024-09"
"236200","슈프리마","177660734500","25750","6899446","7193273","293827","2024-09"
"094840","슈프리마에이치큐","53182520580","5810","9153618","10471840","1318222","2024-09"
"192440","슈피겐코리아","123008572800","20400","6029832","6216363","186531","2024-09"
"424960","스마트레이더시스템","160702428600","10290","15617340","15617340","0","2024-09"
"099440","스맥","114466460440","3070","37285492","40243394","2957902","2024-09"
"053210","스카이라이프","236468660000","5000","47293732","47522955","229223","2024-09"
"276040","스코넥","38228373330","3045","12554474","12554474","0","2024-09"
"159910","스킨앤스킨","26554292340","734","36177510","36410098","232588","2024-09"
"060240","스타코링크","15939853330","505","31564066","32314179","750113","2024-09"
"115570","스타플렉스","23433353460","2970","7890018","7984508","94490","2024-09"
"330730","스톤브릿지벤처스","67996874400","3900","17435096","18150830","715734","2024-09"
"352090","스톰테크","87068513520","3240","26872998","26872998","0","2024-09"
"253450","스튜디오드래곤","1166269722400","38800","30058498","30058498","0","2024-09"
"408900","스튜디오미르","164511436530","5030","32706051","32706134","83","2024-09"
"204630","스튜디오산타클로스","23613109200","4650","5078088","5089941","11853","2024-09"
"415380","스튜디오삼익","33004688200","8140","4054630","4225498","170868","2024-09"
"026890","스틱인베스트먼트","290926776400","7960","36548590","41678175","5129585","2024-09"
"013810","스페코","69173818400","4720","14655470","14655470","0","2024-09"
"203690","스피어파워","65653651385","4985","13170241","13337850","167609","2024-09"
"049830","승일","41884359340","7090","5907526","6132112","224586","2024-09"
"020710","시공테크","65455529550","3470","18863265","20047970","1184705","2024-09"
"033170","시그네틱스","85385405724","996","85728319","85728319","0","2024-09"
"048870","시너지이노베이션","229102112880","2770","82708344","82708344","0","2024-09"
"025320","시노펙스","596829533300","7150","83472662","83817936","345274","2024-09"
"134790","시디즈","49529261000","29500","1678958","2000000","321042","2024-09"
"269620","시스웍","131663951937","889","148103433","148582691","479258","2024-09"
"429270","시지트로닉스","30146812500","6690","4506250","4506250","0","2024-09"
"418250","시큐레터","52279100100","6550","7981542","7981542","0","2024-09"
"131090","시큐브","34755060650","895","38832470","44000000","5167530","2024-09"
"232830","시큐센","24351541760","2080","11707472","11707472","0","2024-09"
"462870","시프트업","3575918336000","61300","58334720","58334720","0","2024-09"
"016590","신대양제지","179432563050","5850","30672233","40297820","9625587","2024-09"
"290520","신도기연","32495178660","2065","15736164","15929362","193198","2024-09"
"029530","신도리코","345342298950","40050","8622779","10080029","1457250","2024-09"
"004970","신라교역","149010400000","9440","15785000","16000000","215000","2024-09"
"001000","신라섬유","25345751760","1044","24277540","24277540","0","2024-09"
"025870","신라에스지","24520000000","6130","4000000","4000000","0","2024-09"
"215600","신라젠","337738627500","2460","137292125","137367125","75000","2024-09"
"065350","신성델타테크","1221918462600","44950","27183948","27483948","300000","2024-09"
"416180","신성에스티","233224034900","26050","8952938","9039778","86840","2024-09"
"011930","신성이엔지","298631320533","1467","203565999","205848151","2282152","2024-09"
"005390","신성통상","321906793600","2240","143708390","143708390","0","2024-09"
"004170","신세계","1383959850000","150000","9226399","9845181","618782","2024-09"
"035510","신세계 I&C","129486228500","9850","13145810","17200000","4054190","2024-09"
"034300","신세계건설","137363108200","18100","7589122","7760554","171432","2024-09"
"031430","신세계인터내셔날","441173460000","12740","34629000","35700000","1071000","2024-09"
"031440","신세계푸드","134949341350","34850","3872291","3872480","189","2024-09"
"006880","신송홀딩스","73369966800","6800","10789701","11828858","1039157","2024-09"
"162300","신스틸","98857120320","2410","41019552","41471382","451830","2024-09"
"290560","신시웨이","24260216840","6260","3875434","3877972","2538","2024-09"
"002800","신신제약","87078670000","5740","15170500","15170500","0","2024-09"
"472220","신영스팩10호","10060050000","2145","4690000","4690000","0","2024-09"
"430220","신영스팩8호","14804400000","2190","6760000","6760000","0","2024-09"
"445970","신영스팩9호","11658000000","2175","5360000","5360000","0","2024-09"
"005800","신영와코루","82620000000","9180","9000000","9000000","0","2024-09"
"001720","신영증권","618532270400","80300","7702768","16440000","8737232","2024-09"
"009270","신원","94340811492","1257","75052356","102586356","27534000","2024-09"
"017000","신원종합개발","35041958820","3130","11195514","11668027","472513","2024-09"
"002700","신일전자","101220232320","1440","70291828","71047521","755693","2024-09"
"012790","신일제약","84038008470","7270","11559561","11986415","426854","2024-09"
"138070","신진에스엠","41563510040","2470","16827332","17503204","675872","2024-09"
"226330","신테카바이오","68205383250","4470","15258475","15258475","0","2024-09"
"002870","신풍","25766933400","930","27706380","34958700","7252320","2024-09"
"019170","신풍제약","583368983360","11840","49271029","52984990","3713961","2024-09"
"418210","신한제10호스팩","8216700000","2245","3660000","3660000","0","2024-09"
"452980","신한제11호스팩","36921465000","1953","18905000","18905000","0","2024-09"
"474660","신한제12호스팩","11619600000","2105","5520000","5520000","0","2024-09"
"474930","신한제13호스팩","7764900000","2145","3620000","3620000","0","2024-09"
"055550","신한지주","28192938144000","56000","503445324","509393214","5947890","2024-09"
"056700","신화인터텍","48796655062","1682","29011091","29135091","124000","2024-09"
"187270","신화콘텍","29987413180","3260","9198593","10143845","945252","2024-09"
"004080","신흥","135034971500","14300","9443005","9500000","56995","2024-09"
"243840","신흥에스이씨","298198161550","7730","38576735","38919035","342300","2024-09"
"257720","실리콘투","2301008245200","37800","60873234","60873234","0","2024-09"
"222800","심텍","520361630180","16340","31845877","31854143","8266","2024-09"
"036710","심텍홀딩스","72053552950","1555","46336690","48350145","2013455","2024-09"
"160980","싸이맥스","114775406440","11230","10220428","10924243","703815","2024-09"
"356890","싸이버원","34553268000","2900","11914920","11916325","1405","2024-09"
"217330","싸이토젠","169561170450","7350","23069547","23129547","60000","2024-09"
"102280","쌍방울","70634046631","269","262580099","262592129","12030","2024-09"
"010280","쌍용정보통신","39595254592","608","65123774","65123786","12","2024-09"
"004770","써니전자","57956811605","1595","36336559","36702884","366325","2024-09"
"208640","썸에이지","32999940198","237","139240254","139240254","0","2024-09"
"222420","쎄노텍","39004875624","858","45460228","45460231","3","2024-09"
"037760","쎄니트","48219032706","1586","30402921","33832921","3430000","2024-09"
"099320","쎄트렉아이","411220488900","37550","10951278","10951278","0","2024-09"
"049960","쎌바이오텍","92529528000","13520","6843900","9400000","2556100","2024-09"
"088280","쏘닉스","46121795850","2665","17306490","17306490","0","2024-09"
"403550","쏘카","605434941900","18450","32814902","32814902","0","2024-09"
"050890","쏠리드","264218345680","4360","60600538","61095231","494693","2024-09"
"475400","씨메스","214457062500","18750","11437710","11437710",,"자료 없음"
"109670","씨싸이트","54501692660","9340","5835299","5836602","1303","2024-09"
"066790","씨씨에스","97502079532","1612","60485161","65152039","4666878","2024-09"
"222080","씨아이에스","606112813150","8450","71729327","71729327","0","2024-09"
"004920","씨아이테크","65686320416","1312","50065793","50065793","0","2024-09"
"352480","씨앤씨인터내셔널","669805968000","67000","9997104","10013941","16837","2024-09"
"264660","씨앤지하이테크","118367472420","12690","9327618","9627896","300278","2024-09"
"352700","씨앤투스","73693169280","2880","25587906","27276899","1688993","2024-09"
"458870","씨어스테크놀로지","157398067200","12540","12551680","12551680","0","2024-09"
"297090","씨에스베어링","143167500000","5250","27270000","27270000","0","2024-09"
"112610","씨에스윈드","2315907987900","55900","41429481","42171403","741922","2024-09"
"359090","씨엔알리서치","67345351060","1193","56450420","56450891","471","2024-09"
"115530","씨엔플러스","30175572000","444","67963000","67963000","0","2024-09"
"115480","씨유메디칼","36526539522","759","48124558","48224558","100000","2024-09"
"340810","씨유박스","33913161600","3200","10597863","10597863","0","2024-09"
"376290","씨유테크","55709412500","3155","17657500","17657500","0","2024-09"
"189330","씨이랩","41305685520","6780","6092284","6092284","0","2024-09"
"096530","씨젠","1064612839400","23050","46187108","52225994","6038886","2024-09"
"101240","씨큐브","50348280720","4870","10338456","10340947","2491","2024-09"
"060590","씨티씨바이오","187922971500","7860","23908775","24181020","272245","2024-09"
"308170","씨티알모빌리티","47355000000","5500","8610000","8610000","0","2024-09"
"260930","씨티케이","106090532070","5630","18843789","19341591","497802","2024-09"
"052300","씨티프라퍼티","62059298832","368","168639399","168651433","12034","2024-09"
"413630","씨피시스템","96245055400","2600","37017329","38703425","1686096","2024-09"
"013990","아가방컴퍼니","134798634945","4485","30055437","32887536","2832099","2024-09"
"123860","아나패스","218585172450","18030","12123415","12123415","0","2024-09"
"025980","아난티","436057031760","4920","88629478","88629478","0","2024-09"
"008700","아남전자","98561059740","1278","77121330","77124820","3490","2024-09"
"125210","아모그린텍","116962241100","7090","16496790","16496790","0","2024-09"
"002790","아모레G","1742816913750","22850","76272075","82458180","6186105","2024-09"
"090430","아모레퍼시픽","7034007596000","120400","58421990","58492759","70769","2024-09"
"357580","아모센스","82020129840","7310","11220264","11220264","0","2024-09"
"052710","아모텍","57719556700","3950","14612546","14615109","2563","2024-09"
"074430","아미노로직스","105567866488","1202","87826844","87826844","0","2024-09"
"092040","아미코젠","277370063080","5060","54816218","55018347","202129","2024-09"
"083930","아바코","221384112750","15250","14516991","14912798","395807","2024-09"
"149950","아바텍","159229512650","11510","13834015","15607500","1773485","2024-09"
"036010","아비코전자","69123256800","5200","13292934","13292934","0","2024-09"
"002030","아세아","430222848000","256000","1680558","2115648","435090","2024-09"
"183190","아세아시멘트","406011006350","10810","37558835","38501886","943051","2024-09"
"002310","아세아제지","322457428500","8070","39957550","42782510","2824960","2024-09"
"050860","아세아텍","43554557200","2200","19797526","22500000","2702474","2024-09"
"012170","아센디오","46606223700","450","103569386","103569488","102","2024-09"
"136410","아셈스","87156004200","8200","10628781","11019106","390325","2024-09"
"246720","아스타","58746409000","4330","13567300","13567300","0","2024-09"
"067390","아스트","185454050705","539","344070595","344203992","133397","2024-09"
"159010","아스플로","81167681200","6280","12924790","13334739","409949","2024-09"
"127710","아시아경제","46178100486","1323","34904082","34904082","0","2024-09"
"267850","아시아나IDT","201243000000","18130","11100000","11100000","0","2024-09"
"020560","아시아나항공","739652934160","9940","74411764","74411764","0","2024-09"
"154030","아시아종묘","27413547480","2365","11591352","11591352","0","2024-09"
"227610","아우딘퓨쳐스","49060567608","1384","35448387","35583547","135160","2024-09"
"143160","아이디스","150200269500","14900","10080555","10716390","635835","2024-09"
"054800","아이디스홀딩스","80279325810","9090","8831609","10347756","1516147","2024-09"
"332370","아이디피","47237385230","3745","12613454","13273726","660272","2024-09"
"122900","아이마켓코리아","262727239000","8350","31464340","33428840","1964500","2024-09"
"339950","아이비김영","75019322100","1730","43363770","44946655","1582885","2024-09"
"469750","아이비젼웍스","49316493408","1456","33871218","33936481","65263","2024-09"
"460470","아이빔테크놀로지","78287880300","5190","15084370","15084370","0","2024-09"
"099190","아이센스","526427433300","19050","27633986","27637273","3287","2024-09"
"461300","아이스크림미디어","179391690260","14020","12795413","13063433","268020","2024-09"
"289010","아이스크림에듀","29631546175","2365","12529195","12864037","334842","2024-09"
"214430","아이쓰리시스템","258924738600","37300","6941682","7106760","165078","2024-09"
"040910","아이씨디","77968257780","4780","16311351","18574275","2262924","2024-09"
"368600","아이씨에이치","62904650580","3660","17187063","17538346","351283","2024-09"
"456010","아이씨티케이","96519840800","7300","13221896","13221896","0","2024-09"
"052860","아이앤씨","26291318580","1620","16229209","17862854","1633645","2024-09"
"464500","아이언디바이스","60688754035","4445","13653263","13653263","0","2024-09"
"010780","아이에스동서","615814310400","20400","30186976","30186976","0","2024-09"
"038880","아이에이","61543463422","202","304670611","315334702","10664091","2024-09"
"307180","아이엘사이언스","83561297190","3090","27042491","27042828","337","2024-09"
"101390","아이엠","34694975700","3300","10513629","10548085","34456","2024-09"
"461030","아이엠비디엑스","203397552500","14510","14017750","14017750","0","2024-09"
"451220","아이엠티","76541218920","9720","7874611","7874611","0","2024-09"
"090150","아이윈","34076187288","858","39715836","41875293","2159457","2024-09"
"123010","아이윈플러스","21074304550","650","32422007","32658542","236535","2024-09"
"031310","아이즈비전","43314349221","1773","24429977","25334636","904659","2024-09"
"185490","아이진","74196757080","2745","27029784","27029784","0","2024-09"
"059100","아이컴포넌트","30454056460","4610","6606086","7070860","464774","2024-09"
"262840","아이퀘스트","41966700040","2230","18819148","19290000","470852","2024-09"
"175250","아이큐어","88566153450","2370","37369685","37558368","188683","2024-09"
"052460","아이크래프트","28400098000","2375","11957936","14607936","2650000","2024-09"
"119830","아이텍","115398856840","5420","21291302","21434297","142995","2024-09"
"052770","아이톡시","67494365588","1378","48979946","48979946","0","2024-09"
"124500","아이티센","142011705240","6120","23204527","23204527","0","2024-09"
"372800","아이티아이즈","34733241000","5900","5886990","6026990","140000","2024-09"
"084850","아이티엠반도체","380879353610","18410","20688721","22682934","1994213","2024-09"
"114840","아이패밀리에스씨","332383519200","19300","17221944","17221944","0","2024-09"
"027360","아주IB투자","227939842900","1925","118410308","120945406","2535098","2024-09"
"139990","아주스틸","133118321880","5020","26517594","26517744","150","2024-09"
"032080","아즈텍WB","23487842451","1119","20990029","21491029","501000","2024-09"
"013310","아진산업","107486919340","2770","38803942","38806582","2640","2024-09"
"059120","아진엑스텍","71958559380","7860","9155033","9748596","593563","2024-09"
"009320","아진전자부품","54574845390","1107","49299770","49299770","0","2024-09"
"158430","아톤","85380836380","3995","21371924","22602474","1230550","2024-09"
"321820","아티스트유나이티드","220017692600","16460","13366810","13366810","0","2024-09"
"001540","안국약품","81148706100","7140","11365365","13042420","1677055","2024-09"
"053800","안랩","565369641800","57700","9798434","11126506","1328072","2024-09"
"065660","안트로젠","144900143970","14890","9731373","9731373","0","2024-09"
"297570","알로이스","38014097364","1098","34621218","34621218","0","2024-09"
"001780","알루코","226582508880","2340","96830132","96830132","0","2024-09"
"260660","알리코제약","56375283205","3755","15013391","15327021","313630","2024-09"
"354320","알멕","201008932450","31450","6391381","6391381","0","2024-09"
"361570","알비더블유","63713522475","2225","28635291","28635291","0","2024-09"
"131370","알서포트","151575433980","2910","52087778","53267083","1179305","2024-09"
"140670","알에스오토메이션","97466006200","10550","9238484","9303140","64656","2024-09"
"096610","알에프세미","51550708615","2965","17386411","17386411","0","2024-09"
"061040","알에프텍","90229695720","2890","31221348","32089259","867911","2024-09"
"148250","알엔투테크놀로지","29271246000","4080","7174325","7391186","216861","2024-09"
"347860","알체라","49434154660","2245","22019668","22019668","0","2024-09"
"196170","알테오젠","20134306780000","379000","53124820","53148528","23708","2024-09"
"123750","알톤","20522850764","1612","12731297","12746297","15000","2024-09"
"085810","알티캐스트","41089803540","1356","30302215","31081959","779744","2024-09"
"043100","알파녹스","21673221120","2720","7968096","7975920","7824","2024-09"
"117670","알파홀딩스","37743429465","945","39940137","39940137","0","2024-09"
"314140","알피바이오","52158547260","6030","8649842","8666361","16519","2024-09"
"291650","압타머사이언스","42960037560","2530","16980252","16980252","0","2024-09"
"293780","압타바이오","197346996000","7980","24730200","24730200","0","2024-09"
"018250","애경산업","406597223760","15820","25701468","26409935","708467","2024-09"
"161000","애경케미칼","508357083780","10530","48277026","48648709","371683","2024-09"
"196300","애니젠","76122947160","12680","6003387","6003387","0","2024-09"
"310200","애니플러스","120331400230","2705","44484806","45520979","1036173","2024-09"
"299910","애닉","32483121920","6880","4721384","4721384","0","2024-09"
"179530","애드바이오텍","30346274080","3320","9140444","9140444","0","2024-09"
"205500","액션스퀘어","55717333005","1073","51926685","51928120","1435","2024-09"
"052790","액토즈소프트","73194464900","6700","10924547","11330638","406091","2024-09"
"290740","액트로","52634324280","5640","9332327","10065011","732684","2024-09"
"238090","앤디포스","89107537590","3915","22760546","23541303","780757","2024-09"
"092600","앤씨앤","29877070440","1220","24489402","25083517","594115","2024-09"
"129890","앱코","57953588880","1210","47895528","50643410","2747882","2024-09"
"174900","앱클론","275839507130","15830","17425111","17425111","0","2024-09"
"255440","야스","121650167520","10080","12068469","13058000","989531","2024-09"
"030960","양지사","126234483300","9190","13736070","15980000","2243930","2024-09"
"102120","어보브반도체","163667639680","9920","16498754","17780753","1281999","2024-09"
"263540","어스앤에어로스페이스","1786178750","125","14289430","14294091","4661","2023-12"
"238120","얼라인드","42921004560","2985","14378896","14378896","0","2024-09"
"019990","에너토크","60287327100","6300","9569417","9756088","186671","2024-09"
"011090","에넥스","31133844525","525","59302561","59991641","689080","2024-09"
"270660","에브리봇","193866770700","15850","12231342","12231342","0","2024-09"
"038680","에스넷","66805109175","3675","18178261","19549677","1371416","2024-09"
"137310","에스디바이오센서","1091339396720","8920","122347466","124477353","2129887","2024-09"
"217480","에스디생명공학","54756837359","499","109733141","109733141","0","2024-09"
"121890","에스디시스템","18142823790","1365","13291446","13291446","0","2024-09"
"304360","에스바이오메딕스","345326402400","29400","11745796","11745796","0","2024-09"
"389500","에스비비테크","88714768320","14880","5962014","6174904","212890","2024-09"
"042110","에스씨디","70802811260","1465","48329564","48329564","0","2024-09"
"298060","에스씨엠생명과학","39673122790","1939","20460610","20467248","6638","2024-09"
"065420","에스아이리소스","18609430840","260","71574734","71577299","2565","2024-09"
"103230","에스앤더블류","25236000000","3505","7200000","7200000","0","2024-09"
"260970","에스앤디","97485809800","33700","2892754","2892754","0","2024-09"
"101490","에스앤에스텍","484997130000","23150","20950200","21451447","501247","2024-09"
"095910","에스에너지","27947697772","1499","18644228","19504503","860275","2024-09"
"275630","에스에스알","17693342160","3270","5410808","6017989","607181","2024-09"
"031330","에스에이엠티","303852883705","3115","97545067","99995067","2450000","2024-09"
"060540","에스에이티","37082633346","1419","26132934","26133306","372","2024-09"
"351320","에스에이티이엔지","33860109688","1538","22015676","22015886","210","2024-09"
"056190","에스에프에이","664423316100","21150","31414814","35908760","4493946","2024-09"
"080000","에스엔유","59980693578","1753","34216026","34322870","106844","2024-09"
"005850","에스엘","1531344111500","33250","46055462","46448520","393058","2024-09"
"214310","에스엘에너지","22487615640","6120","3674447","3679130","4683","2024-09"
"246250","에스엘에스바이오","42130825470","2745","15348206","15348206","0","2024-09"
"041510","에스엠","1604917769000","70100","22894690","23353627","458937","2024-09"
"010580","에스엠벡셀","135549646960","1220","111106268","111251760","145492","2024-09"
"007820","에스엠코어","94248168840","4820","19553562","20033946","480384","2024-09"
"464080","에스오에스랩","100963249300","5710","17681830","17681830","0","2024-09"
"109610","에스와이","181241647950","3795","47758010","48907400","1149390","2024-09"
"365330","에스와이스틸텍","185190500000","6050","30610000","30610000","0","2024-09"
"012750","에스원","2160474272100","63900","33810239","37999178","4188939","2024-09"
"031860","에스유홀딩스","16959343498","1129","15021562","15026356","4794","2024-09"
"306040","에스제이그룹","54513405840","5790","9415096","9865828","450732","2024-09"
"457940","에스케이증권제10호스팩","7017200000","2120","3310000","3310000","0","2024-09"
"472230","에스케이증권제11호스팩","8663175000","2085","4155000","4155000","0","2024-09"
"473000","에스케이증권제12호스팩","6917900000","2090","3310000","3310000","0","2024-09"
"473950","에스케이증권제13호스팩","9105200000","2060","4420000","4420000","0","2024-09"
"435870","에스케이증권제8호스팩","7812000000","2100","3720000","3720000","0","2024-09"
"455910","에스케이증권제9호스팩","10667500000","2125","5020000","5020000","0","2024-09"
"096630","에스코넥","55771576575","715","78002205","79052205","1050000","2024-09"
"069510","에스텍","91753100000","10910","8410000","10910000","2500000","2024-09"
"234300","에스트래픽","118061722350","4290","27520215","27809848","289633","2024-09"
"039440","에스티아이","289288232610","19630","14737047","15830000","1092953","2024-09"
"098660","에스티오","36168999040","2980","12137248","12500976","363728","2024-09"
"052020","에스티큐브","256543369500","5500","46644249","46694249","50000","2024-09"
"237690","에스티팜","1872025939000","93100","20107690","20107690","0","2024-09"
"050760","에스폴리텍","23828192567","1543","15442769","16334678","891909","2024-09"
"288620","에스퓨얼셀","74050542760","10610","6979316","6979316","0","2024-09"
"443670","에스피소프트","158265370920","6540","24199598","24201392","1794","2024-09"
"317830","에스피시스템스","53599683860","5270","10170718","10773818","603100","2024-09"
"058610","에스피지","469051164000","21150","22177360","22177360","0","2024-09"
"043340","에쎈테크","46360000000","488","95000000","95000000","0","2024-09"
"023960","에쓰씨엔지니어링","60447406374","1779","33978306","33978308","2","2024-09"
"298690","에어부산","272801842560","2340","116581984","116640000","58016","2024-09"
"054630","에이디칩스","12594094838","158","79709461","79709461","0","2024-09"
"200710","에이디테크놀로지","189785490650","14650","12954641","13440822","486181","2024-09"
"096690","에이루트","41873562072","1251","33472072","33477189","5117","2024-09"
"078520","에이블씨엔씨","184440380220","7090","26014158","26014161","3","2024-09"
"298380","에이비엘바이오","1763353856300","36700","48047789","48047789","0","2024-09"
"203400","에이비온","206338634960","8180","25224772","25224772","0","2024-09"
"195990","에이비프로바이오","146898959496","516","284687906","284689721","1815","2024-09"
"003800","에이스침대","285037515000","27000","10556945","11090000","533055","2024-09"
"088800","에이스테크","125222764732","988","126743689","127068928","325239","2024-09"
"241840","에이스토리","63287451700","6820","9279685","9539994","260309","2024-09"
"453860","에이에스텍","131582270250","23350","5635215","5657215","22000","2024-09"
"312610","에이에프더블류","30993038640","1530","20256888","20256888","0","2024-09"
"015260","에이엔피","30676933840","680","45113138","45116894","3756","2024-09"
"172670","에이엘티","78755843250","8890","8858925","8960259","101334","2024-09"
"445090","에이직랜드","427097349900","39650","10771686","10771686","0","2024-09"
"295310","에이치브이엠","176029559490","14790","11901931","11901931","0","2024-09"
"072990","에이치시티","73202629720","10340","7079558","7287341","207783","2024-09"
"044990","에이치엔에스하이텍","134202268800","16700","8036064","8036064",,"자료 없음"
"239610","에이치엘사이언스","77667502750","15250","5092951","5392115","299164","2024-09"
"462020","에이치엠씨제6호스팩","8863800000","2040","4345000","4345000","0","2024-09"
"477340","에이치엠씨제7호스팩","14959920000","1992","7510000","7510000","0","2024-09"
"148930","에이치와이티씨","44040931800","4530","9722060","10175213","453153","2024-09"
"044780","에이치케이","23113204197","1259","18358383","18505787","147404","2024-09"
"357230","에이치피오","119887057955","2905","41269211","42089487","820276","2024-09"
"355690","에이텀","33889224600","6270","5404980","5404980","0","2024-09"
"071670","에이테크솔루션","62800000000","6280","10000000","10000000","0","2024-09"
"045660","에이텍","110437630560","14640","7543554","8260000","716446","2024-09"
"224110","에이텍모빌리티","63878580780","13020","4906189","5340000","433811","2024-09"
"021080","에이티넘인베스트","114986437500","2500","45994575","48000000","2005425","2024-09"
"200470","에이팩트","122211568665","2885","42361029","42362093","1064","2024-09"
"262260","에이프로","102854920140","7140","14405451","14468152","62701","2024-09"
"007460","에이프로젠","296693795350","1115","266093090","286851768","20758678","2024-09"
"003060","에이프로젠바이오로직스","158453390412","802","197572806","198407845","835039","2024-09"
"397030","에이프릴바이오","475599247200","21700","21917016","21917016","0","2024-09"
"244920","에이플러스에셋","95291425995","4215","22607693","22607693","0","2024-09"
"278470","에이피알","1984308631500","266500","7445811","7622678","176867","2024-09"
"230240","에치에프알","129006698420","9830","13123774","13309000","185226","2024-09"
"230360","에코마케팅","330099624210","10490","31468029","31468029","0","2024-09"
"038870","에코바이오","57872711190","4130","14012763","14014949","2186","2024-09"
"097780","에코볼트","59196315412","874","67730338","67730338","0","2024-09"
"448280","에코아이","193491272370","19590","9877043","9877043","0","2024-09"
"101360","에코앤드림","704537986900","40150","17547646","17786114","238468","2024-09"
"128540","에코캡","33087070022","1273","25991414","26690460","699046","2024-09"
"086520","에코프로","10855713428000","82400","131744095","133138340","1394245","2024-09"
"450080","에코프로머티","8129609384600","117700","69070598","69070598","0","2024-09"
"247540","에코프로비엠","16797533932000","172000","97660081","97801344","141263","2024-09"
"383310","에코프로에이치엔","696745673200","45700","15246076","15304932","58856","2024-09"
"038110","에코플라스틱","112902253780","2810","40178738","41169370","990632","2024-09"
"073540","에프알텍","14706000000","1290","11400000","11400000","0","2024-09"
"064850","에프앤가이드","120379002600","10550","11410332","11410332","0","2024-09"
"036810","에프에스티","355416217520","17810","19955992","21756789","1800797","2024-09"
"173940","에프엔씨엔터","55083917790","3690","14927891","15392808","464917","2024-09"
"083500","에프엔에스테크","76336970000","9550","7993400","8575722","582322","2024-09"
"054940","엑사이엔씨","24117169396","727","33173548","33173548","0","2024-09"
"373110","엑셀세라퓨틱스","63873002700","5850","10918462","10918462","0","2024-09"
"205100","엑셈","123406968440","1715","71957416","71963431","6015","2024-09"
"356680","엑스게이트","156933601000","5500","28533382","28543492","10110","2024-09"
"070300","엑스큐어","37665797180","4510","8351618","8351618","0","2024-09"
"317770","엑스페릭스","70422441420","3070","22938906","22938906","0","2024-09"
"373200","엑스플러스","51176496176","676","75704876","75705657","781","2024-09"
"069920","엑시온그룹","44456116320","1270","35004816","35194116","189300","2024-09"
"092870","엑시콘","148153546650","11850","12502409","13050797","548388","2024-09"
"317870","엔바이오니아","156949537500","18450","8506750","8506750","0","2024-09"
"067570","엔브이에이치코리아","103650461680","2480","41794541","42170000","375459","2024-09"
"236810","엔비티","59672675000","3700","16127750","16975426","847676","2024-09"
"333620","엔시스","99602494760","9640","10332209","10556344","224135","2024-09"
"101400","엔시트론","26542852042","427","62161246","62162413","1167","2024-09"
"036570","엔씨소프트","4205943665000","210500","19980730","21954022","1973292","2024-09"
"078860","엔에스이엔엠","95333940600","9060","10522510","10531054","8544","2024-09"
"422040","엔에이치스팩23호","15036000000","2100","7160000","7160000","0","2024-09"
"437780","엔에이치스팩24호","10613300000","2110","5030000","5030000","0","2024-09"
"438580","엔에이치스팩25호","6538300000","2165","3020000","3020000","0","2024-09"
"439410","엔에이치스팩26호","18348000000","2085","8800000","8800000","0","2024-09"
"440820","엔에이치스팩27호","16263000000","2085","7800000","7800000","0","2024-09"
"451700","엔에이치스팩29호","28771750000","2005","14350000","14350000","0","2024-09"
"466910","엔에이치스팩30호","18200000000","2000","9100000","9100000","0","2024-09"
"481890","엔에이치스팩31호","12785175000","2015","6345000","6345000","0","2024-09"
"265740","엔에프씨","50107398000","5610","8931800","8931800","0","2024-09"
"354200","엔젠바이오","41764991360","3040","13738484","13738484","0","2024-09"
"455900","엔젤로보틱스","367656372600","24600","14945381","14945381","0","2024-09"
"419080","엔젯","95424370650","9450","10097817","10517817","420000","2024-09"
"208860","엔지스테크널러지","41831348265","2205","18971133","18971133","0","2024-09"
"183490","엔지켐생명과학","117680096182","1474","79837243","85065562","5228319","2024-09"
"085310","엔케이","61053369228","774","78880322","79983352","1103030","2024-09"
"182400","엔케이맥스","172744574320","2020","85517116","85518831","1715","2024-09"
"348370","엔켐","3816479062800","183600","20786923","20786923","0","2024-09"
"069410","엔텔스","34309062440","3460","9915914","10244824","328910","2024-09"
"227950","엔투텍","42673118360","412","103575530","103575530","0","2024-09"
"291230","엔피","93703496375","2125","44095763","44095775","12","2024-09"
"198080","엔피디","54807045825","2545","21535185","21535185","0","2024-09"
"048830","엔피케이","21836223696","1168","18695397","18723923","28526","2024-09"
"096870","엘디티","15093184000","2260","6678400","6678400","0","2024-09"
"290650","엘앤씨바이오","418309390040","18440","22684891","22684891","0","2024-09"
"066970","엘앤에프","3738330787800","111400","33557727","36296338","2738611","2024-09"
"156100","엘앤케이바이오","149724864830","7510","19936733","19936743","10","2024-09"
"073110","엘엠에스","36790234080","6360","5784628","8895755","3111127","2024-09"
"083310","엘오티베큠","155166382210","9590","16180019","17810033","1630014","2024-09"
"037950","엘컴텍","105423602343","1249","84406407","84447519","41112","2024-09"
"170920","엘티씨","99080132880","10680","9277166","9805620","528454","2024-09"
"058630","엠게임","117940319160","6340","18602574","19543877","941303","2024-09"
"058970","엠로","564829662700","47650","11853718","11853718","0","2024-09"
"019590","엠벤처투자","104963185182","921","113966542","113966542","0","2024-09"
"169330","엠브레인","39065219600","2200","17756918","18256918","500000","2024-09"
"097520","엠씨넥스","300976568760","17430","17267732","17977732","710000","2024-09"
"373170","엠아이큐브솔루션","38741681700","7690","5037930","5037930","0","2024-09"
"179290","엠아이텍","278992144360","8620","32365678","32365678","0","2024-09"
"009780","엠에스씨","90640000000","5150","17600000","17600000","0","2024-09"
"123040","엠에스오토텍","174645437475","3175","55006437","69172213","14165776","2024-09"
"323230","엠에프엠코리아","6967193212","161","43274492","43274492","0","2024-06"
"032790","엠젠솔루션","58848394000","1375","42798832","42798832","0","2024-09"
"033160","엠케이전자","172452472500","8250","20903330","22066331","1163001","2024-09"
"347890","엠투아이","91117613660","5570","16358638","16913204","554566","2024-09"
"033310","엠투엔","79006582176","1996","39582456","40342231","759775","2024-09"
"259630","엠플러스","117220100710","9710","12072101","12282402","210301","2024-09"
"105550","엣지파운드리","138339917100","2420","57165255","57165255","0","2024-09"
"060850","영림원소프트랩","55453420000","6820","8131000","8131000","0","2024-09"
"014440","영보화학","66105000000","3390","19500000","20000000","500000","2024-09"
"143540","영우디에스피","31454496000","720","43686800","44599895","913095","2024-09"
"111770","영원무역","1749211077300","40900","42767997","44311468","1543471","2024-09"
"009970","영원무역홀딩스","1067650616000","92000","11604898","13635592","2030694","2024-09"
"003520","영진약품","438941889600","2400","182892454","182892731","277","2024-09"
"000670","영풍","682033131000","396500","1720134","1842040","121906","2024-09"
"036560","영풍정밀","359100000000","22800","15750000","15750000","0","2024-09"
"006740","영풍제지","54546918075","1235","44167545","46482148","2314603","2024-09"
"012280","영화금속","38579682810","762","50629505","51664505","1035000","2024-09"
"265560","영화테크","93466875800","8810","10609180","10690180","81000","2024-09"
"012160","영흥","32040042410","470","68170303","101310372","33140069","2024-09"
"036000","예림당","48832667240","2120","23034277","23034277","0","2024-09"
"250930","예선테크","16961110473","519","32680367","33000440","320073","2024-09"
"053280","예스24","149164342440","5970","24985652","25000000","14348","2024-09"
"015360","예스코홀딩스","223896300000","52300","4281000","6000000","1719000","2024-09"
"122640","예스티","396475896250","19670","20156375","20930108","773733","2024-09"
"045060","오공","45828039670","2705","16941974","16941974","0","2024-09"
"080520","오디텍","35395248960","3420","10349488","11746609","1397121","2024-09"
"007310","오뚜기","1422161714500","413500","3439327","4007830","568503","2024-09"
"039830","오로라","55644048700","5630","9883490","10762890","879400","2024-09"
"322310","오로스테크놀로지","153546403140","16670","9210942","9366542","155600","2024-09"
"046120","오르비텍","65360511040","2410","27120544","27449486","328942","2024-09"
"014940","오리엔탈정공","154633046155","3395","45547289","45573661","26372","2024-09"
"002630","오리엔트바이오","53237088574","449","118568126","118583005","14879","2024-09"
"065500","오리엔트정공","38579489664","1216","31726554","31742912","16358","2024-09"
"271560","오리온","3869868345200","97900","39528788","39536132","7344","2024-09"
"001800","오리온홀딩스","991381641440","16480","60156653","62645422","2488769","2024-09"
"010470","오리콤","84482470800","7280","11604735","11975050","370315","2024-09"
"417860","오브젠","43331404920","9780","4430614","4430614","0","2024-09"
"352910","오비고","84926029440","6720","12637802","12637802","0","2024-09"
"053980","오상자이엘","69923346090","3705","18872698","18982783","110085","2024-09"
"036220","오상헬스케어","176468510790","12870","13711617","14489416","777799","2024-09"
"052420","오성첨단소재","142836034026","1714","83334909","86315192","2980283","2024-09"
"039200","오스코텍","1116729939200","29200","38244176","38244176","0","2024-09"
"226400","오스테오닉","113861034250","5750","19801919","20661601","859682","2024-09"
"031510","오스템","34602172283","1321","26193923","28000000","1806077","2024-09"
"368970","오에스피","30608674000","3275","9346160","9346160","0","2024-09"
"138080","오이솔루션","104890909200","10290","10193480","10624095","430615","2024-09"
"080580","오킨스전자","103216710000","6000","17202785","17679298","476513","2024-09"
"067170","오텍","48299342600","3400","14205689","15391605","1185916","2024-09"
"353590","오토앤","60901446100","4730","12875570","12875570","0","2024-09"
"173130","오파스넷","115953016760","8890","13043084","13046473","3389","2024-09"
"440320","오픈놀","46181550000","4710","9805000","9805000","0","2024-09"
"049480","오픈베이스","68094406720","2270","29997536","31422383","1424847","2024-09"
"394280","오픈엣지테크놀로지","259150808220","11860","21850827","21850827","0","2024-09"
"309930","오하임앤컴퍼니","41070054000","2000","20535027","21290990","755963","2024-09"
"244460","올리패스","18290883206","454","40288289","40290730","2441","2024-09"
"226950","올릭스","434403219600","25200","17238223","17238223","0","2024-09"
"057540","옴니시스템","45042167346","759","59344094","61449355","2105261","2024-09"
"131030","옵투스제약","100351907910","6570","15274263","16153162","878899","2024-09"
"082210","옵트론텍","58728024395","2105","27899299","28566538","667239","2024-09"
"109080","옵티시스","33437541210","7030","4756407","5636000","879593","2024-09"
"380540","옵티코어","32986068798","1149","28708502","29779596","1071094","2024-09"
"153710","옵티팜","74523386640","5080","14669958","14669958","0","2024-09"
"432430","와이랩","82604269600","5030","16422320","16422320","0","2024-09"
"338840","와이바이오로직스","164532408240","11140","14769516","14769516","0","2024-09"
"122990","와이솔","170456643280","6160","27671533","28186941","515408","2024-09"
"232140","와이씨","946646669200","11800","80224294","82045350","1821056","2024-09"
"112290","와이씨켐","172587003150","17070","10110545","10110545","0","2024-09"
"065530","와이어블","68313747852","1428","47838759","52860000","5021241","2024-09"
"067900","와이엔텍","117647783500","6500","18099659","18199659","100000","2024-09"
"007530","와이엠","51269450925","2695","19023915","19174452","150537","2024-09"
"155650","와이엠씨","74078320680","4095","18089944","19474358","1384414","2024-09"
"273640","와이엠텍","125636220050","11890","10566545","10966000","399455","2024-09"
"251370","와이엠티","131168290560","8040","16314464","16314464","0","2024-09"
"066430","와이오엠","21921268320","560","39145122","39153476","8354","2024-09"
"209640","와이제이링크","239633505050","16850","14221573","14221573",,"자료 없음"
"273060","와이즈버즈","46725566450","926","50459575","50459582","7","2024-09"
"019210","와이지-원","170219262330","5070","33573819","33573819","0","2024-09"
"122870","와이지엔터테인먼트","749293871200","40400","18546878","18691049","144171","2024-09"
"011690","와이투솔루션","94530249770","2585","36568762","36574394","5632","2024-09"
"332570","와이팜","105206084400","2550","41257288","42233850","976562","2024-09"
"079000","와토스코리아","40295323530","5670","7106759","7200000","93241","2024-09"
"403490","우듬지팜","83911216960","1856","45210785","45212464","1679","2024-09"
"316140","우리금융지주","11925153149360","16060","742537556","742591501","53945","2024-09"
"032820","우리기술","373315031000","2350","158857460","158859048","1588","2024-09"
"041190","우리기술투자","644773171680","8280","77871156","84000000","6128844","2024-09"
"115440","우리넷","84212973950","8050","10461239","10754239","293000","2024-09"
"046970","우리로","50473219591","1163","43399157","43824999","425842","2024-09"
"082850","우리바이오","173487114150","3675","47207378","48456578","1249200","2024-09"
"215360","우리산업","109129347850","11950","9132163","9132163","0","2024-09"
"072470","우리산업홀딩스","56934442935","3015","18883729","18887341","3612","2024-09"
"073560","우리손에프앤지","97278888415","1405","69237643","69237643","0","2024-09"
"037400","우리엔터프라이즈","31501835964","1299","24250836","26223346","1972510","2024-09"
"153490","우리이앤엘","43852079700","867","50579100","51480000","900900","2024-09"
"101170","우림피티에스","68199214320","5160","13216902","13500000","283098","2024-09"
"006980","우성","40708750160","15860","2566756","3090000","523244","2024-09"
"066590","우수AMS","116420590370","3010","38677937","39073104","395167","2024-09"
"017370","우신시스템","127496896400","8200","15548402","18314054","2765652","2024-09"
"103840","우양","61865097840","3780","16366428","16366428","0","2024-09"
"046940","우원개발","41299889750","2285","18074350","18074350","0","2024-09"
"215380","우정바이오","33091728280","2105","15720536","15879576","159040","2024-09"
"065680","우주일렉트로","118969370800","14800","8038471","9530000","1491529","2024-09"
"105840","우진","161712072960","8160","19817656","20323614","505958","2024-09"
"018620","우진비앤지","29089381197","1007","28887171","28889293","2122","2024-09"
"010400","우진아이엔에스","23590276500","3500","6740079","7622000","881921","2024-09"
"457550","우진엔텍","205823725800","22200","9271339","9271339","0","2024-09"
"049800","우진플라임","45600000000","2280","20000000","20000000","0","2024-09"
"016880","웅진","70021616846","901","77715446","79927080","2211634","2024-09"
"095720","웅진씽크빅","195279793237","1733","112683089","115505985","2822896","2024-09"
"396470","워트","148304000000","9200","16120000","16120000","0","2024-09"
"005820","원림","33012121500","16050","2056830","2297970","241140","2024-09"
"307280","원바이오젠","47923858178","1351","35472878","36959013","1486135","2024-09"
"032940","원익","68406360560","3760","18193181","18193230","49","2024-09"
"240810","원익IPS","1364792104500","28050","48655690","49083901","428211","2024-09"
"074600","원익QnC","633540800000","24100","26288000","26288000","0","2024-09"
"104830","원익머트리얼즈","274224000000","21750","12608000","12608000","0","2024-09"
"014190","원익큐브","57481595304","1624","35395071","35399906","4835","2024-09"
"217820","원익피앤이","127859258620","2890","44241958","47454559","3212601","2024-09"
"030530","원익홀딩스","171479846225","2245","76383005","77237981","854976","2024-09"
"012620","원일특강","31284000000","7110","4400000","4400000","0","2024-09"
"382840","원준","217358611110","14310","15189281","15271581","82300","2024-09"
"336570","원텍","536020956000","6000","89336826","89340619","3793","2024-09"
"376980","원티드랩","41078639400","4600","8930139","9754994","824855","2024-09"
"008370","원풍","53681192565","4915","10921911","12000000","1078089","2024-09"
"008290","원풍물산","22175245335","555","39955397","40693679","738282","2024-09"
"101160","월덱스","318497054970","19290","16510993","16510993","0","2024-09"
"336060","웨이버스","66165244800","1374","48155200","48155200","0","2024-09"
"095270","웨이브일렉트로","56339629570","4415","12760958","14971256","2210298","2024-09"
"289930","웨이비스","130783768830","10530","12420111","12420111",,"자료 없음"
"010600","웰바이오텍","49552926545","545","90922801","90923407","606","2024-09"
"065950","웰크론","61440904855","2255","27246521","28231302","984781","2024-09"
"076080","웰크론한텍","33043102857","1497","22072881","22594156","521275","2024-09"
"043590","웰킵스하이텍","19760758720","740","26703728","27136762","433034","2024-09"
"196700","웹스","19276681248","1342","14364144","14364144","0","2024-09"
"069080","웹젠","475594394100","16140","29466815","34950884","5484069","2024-09"
"053580","웹케시","91556044120","7160","12787157","13636248","849091","2024-09"
"071460","위니아","21802751835","613","35567295","35967295","400000","2024-09"
"377460","위니아에이드","26030247855","1691","15393405","15393405","0","2024-09"
"044340","위닉스","92792396480","5870","15807904","17873425","2065521","2024-09"
"330350","위더스제약","93849724800","7110","13199680","13202139","2459","2024-09"
"348350","위드텍","81609560000","8350","9773600","10183600","410000","2024-09"
"112040","위메이드","1174848478950","34950","33615121","33948483","333362","2024-09"
"101730","위메이드맥스","319571251120","9680","33013559","33295292","281733","2024-09"
"123420","위메이드플레이","77903797090","7490","10401041","11469842","1068801","2024-09"
"065370","위세아이텍","30627864540","4410","6945094","7383954","438860","2024-09"
"038620","위즈코프","38019743355","605","62842551","66546465","3703914","2024-09"
"299900","위지윅스튜디오","207723489784","1226","169431884","171048884","1617000","2024-09"
"036090","위지트","83623313415","709","117945435","118392284","446849","2024-09"
"136540","윈스","152430167520","12330","12362544","13644162","1281618","2024-09"
"097800","윈팩","169551533424","1456","116450229","116450229","0","2024-09"
"192390","윈하이텍","41624215710","3810","10924991","10924991","0","2024-09"
"008600","윌비스","28425336480","432","65799390","67236039","1436649","2024-09"
"335870","윙스풋","20017706400","1200","16681422","16681422","0","2024-09"
"033270","유나이티드제약","310407775900","21100","14711269","16333822","1622553","2024-09"
"014830","유니드","461405565500","69500","6638929","6767600","128671","2024-09"
"446070","유니드비티플러스","45757837125","4475","10225215","10611215","386000","2024-09"
"036200","유니셈","208265655240","7080","29416053","30664223","1248170","2024-09"
"018000","유니슨","115685004468","687","168391564","168391564","0","2024-09"
"000910","유니온","74545480725","4775","15611619","15611619","0","2024-09"
"047400","유니온머티리얼","103740000000","2470","42000000","42000000","0","2024-09"
"203450","유니온커뮤니티","32571119835","2645","12314223","14079007","1764784","2024-09"
"011330","유니켐","138455772623","1541","89848003","96997167","7149164","2024-09"
"077500","유니퀘스트","100548474810","4655","21600102","21794015","193913","2024-09"
"011320","유니크","76413348725","3955","19320695","19320695","0","2024-09"
"086390","유니테스트","200074919280","9840","20332817","21134126","801309","2024-09"
"241690","유니테크노","89807491020","3670","24470706","24470706","0","2024-09"
"142210","유니트론텍","92184020590","4870","18928957","19246092","317135","2024-09"
"088340","유라클","49795782000","11500","4330068","4330068","0","2024-09"
"048430","유라테크","75131365120","6560","11452952","11520000","67048","2024-09"
"206650","유바이오로직스","443526486980","12140","36534307","36534307","0","2024-09"
"089850","유비벨록스","99064593300","6810","14546930","14730199","183269","2024-09"
"084440","유비온","16144783200","819","19712800","19712800","0","2024-09"
"032620","유비케어","189777481080","3740","50742642","52197139","1454497","2024-09"
"264450","유비쿼스","140630628460","14140","9945589","10245706","300117","2024-09"
"078070","유비쿼스홀딩스","158358845260","9590","16512914","18150700","1637786","2024-09"
"002920","유성기업","51551475000","2010","25647500","25947500","300000","2024-09"
"024800","유성티엔에스","66463866720","1990","33398928","37051812","3652884","2024-09"
"000700","유수홀딩스","125434449920","5120","24498916","26041812","1542896","2024-09"
"054930","유신","67950000000","22650","3000000","3000000","0","2024-09"
"069330","유아이디","17591791877","1247","14107291","14191091","83800","2024-09"
"049520","유아이엘","106283131920","4970","21384936","21784936","400000","2024-09"
"435380","유안타제10호스팩","11975700000","2090","5730000","5730000","0","2024-09"
"444920","유안타제11호스팩","10873000000","2075","5240000","5240000","0","2024-09"
"446150","유안타제12호스팩","9778500000","2050","4770000","4770000","0","2024-09"
"449020","유안타제13호스팩","19605950000","2015","9730000","9730000","0","2024-09"
"450940","유안타제14호스팩","9534000000","2100","4540000","4540000","0","2024-09"
"473050","유안타제15호스팩","14125150000","2015","7010000","7010000","0","2024-09"
"474490","유안타제16호스팩","11185300000","2030","5510000","5510000","0","2024-09"
"430700","유안타제9호스팩","11030200000","2105","5240000","5240000","0","2024-09"
"003470","유안타증권","558772298700","2900","192680103","199596576","6916473","2024-09"
"263770","유에스티","49611710490","2110","23512659","23700172","187513","2024-09"
"072130","유엔젤","57976337400","4850","11953884","13195454","1241570","2024-09"
"000220","유유제약","70961021105","4385","16182673","17032351","849678","2024-09"
"388720","유일로보틱스","369945918200","32300","11453434","11453434","0","2024-09"
"340930","유일에너테크","79122324000","2320","34104450","34204450","100000","2024-09"
"023410","유진기업","235773530480","3440","68538817","77310863","8772046","2024-09"
"056080","유진로봇","207067079040","5520","37512152","37512152","0","2024-09"
"468760","유진스팩10호","9010000000","2125","4240000","4240000","0","2024-09"
"442130","유진스팩9호","7785000000","2250","3460000","3460000","0","2024-09"
"084370","유진테크","798530521000","35900","22243190","22916042","672852","2024-09"
"240600","유진테크놀로지","43948850950","6410","6856295","6928151","71856","2024-09"
"001200","유진투자증권","364601405650","3970","91839145","96866418","5027273","2024-09"
"221800","유투바이오","35385359460","3135","11287196","11287196","0","2024-09"
"179900","유티아이","372598515150","23550","15821593","16286895","465302","2024-09"
"263050","유틸렉스","78741043200","2140","36794880","36798858","3978","2024-09"
"000100","유한양행","11091228430500","150300","73793935","80209064","6415129","2024-09"
"003460","유화증권","102264671175","2235","45756005","56702415","10946410","2024-09"
"191410","육일씨엔에쓰","18666288830","1666","11204255","11204255","0","2024-09"
"372170","윤성에프앤씨","454805736000","57000","7979048","7979048","0","2024-09"
"146060","율촌","29609186787","1233","24013939","24015595","1656","2024-09"
"008730","율촌화학","704320000000","28400","24800000","24800000","0","2024-09"
"072770","율호","140476488000","2000","70238244","70238244","0","2024-09"
"008250","이건산업","51224063640","5010","10224364","10952635","728271","2024-09"
"039020","이건홀딩스","72016909825","3325","21659221","22584709","925488","2024-09"
"025820","이구산업","153827629400","4600","33440789","33442000","1211","2024-09"
"067920","이글루","52353845000","5000","10470769","10996119","525350","2024-09"
"044960","이글벳","61251736030","4990","12274897","12641883","366986","2024-09"
"303530","이노뎁","53409542900","7510","7111790","7339299","227509","2024-09"
"296640","이노룰스","28359402720","5610","5055152","5178252","123100","2024-09"
"302430","이노메트리","91395982500","9300","9827525","9833208","5683","2024-09"
"214320","이노션","781200000000","19530","40000000","40000000","0","2024-09"
"462350","이노스페이스","182357248300","19450","9375694","9375694","0","2024-09"
"274400","이노시뮬레이션","40897689980","5230","7819826","7819826","0","2024-09"
"056090","이노시스","123156905025","1309","94084725","94084725","0","2024-09"
"073490","이노와이어리스","129949728140","17090","7603846","7603846","0","2024-09"
"215790","이노인스트루먼트","18127092600","450","40282428","40283149","721","2024-09"
"344860","이노진","22134258000","1851","11958000","12030000","72000","2024-09"
"088390","이녹스","97143381900","10350","9385834","9385844","10","2024-09"
"272290","이녹스첨단소재","453888358050","23550","19273391","20227658","954267","2024-09"
"053350","이니텍","68510061965","4085","16771129","19790916","3019787","2024-09"
"452400","이닉스","107405707520","11840","9071428","9071428","0","2024-09"
"264850","이랜시스","163893850920","5410","30294612","30294612","0","2024-09"
"054210","이랜텍","138371058360","5560","24886881","25291210","404329","2024-09"
"009730","이렘","78137480863","1697","46044479","46056774","12295","2024-09"
"065440","이루온","36587531952","1384","26436078","27275020","838942","2024-09"
"139480","이마트","1711775756700","63900","26788353","27875819","1087466","2024-09"
"115610","이미지스","60041770950","3810","15758995","15758995","0","2024-09"
"478110","이베스트스팩6호","10115300000","2015","5020000","5020000","0","2024-09"
"131400","이브이첨단소재","127513342360","2140","59585674","59589882","4208","2024-09"
"351330","이삭엔지니어링","66888356400","8070","8288520","8288520","0","2024-09"
"080010","이상네트웍스","50086782240","5280","9486133","9835071","348938","2024-09"
"457190","이수스페셜티케미컬","1281366302000","42800","29938465","30208280","269815","2024-09"
"086890","이수앱지스","226901480560","6320","35902133","35902133","0","2024-09"
"007660","이수페타시스","2757543868400","43600","63246419","63246419","0","2024-09"
"005950","이수화학","172657044920","7820","22078906","22722739","643833","2024-09"
"015020","이스타코","25901378694","666","38890959","42851600","3960641","2024-09"
"047560","이스트소프트","128468862500","12500","10277509","11603992","1326483","2024-09"
"239340","이스트에이드","45325664160","1680","26979562","26979634","72","2024-09"
"067010","이씨에스","34110204750","2995","11389050","12294000","904950","2024-09"
"093230","이아이디","354065768064","1392","254357592","254384360","26768","2024-09"
"418620","이에이트","130377944270","13510","9650477","9650477","0","2024-09"
"456070","이엔셀","230647068000","21600","10678105","10678105","0","2024-09"
"102710","이엔에프테크놀로지","237320955960","16610","14287836","14287836","0","2024-09"
"074610","이엔플러스","105439485573","1437","73374729","73374729","0","2024-09"
"041520","이엘씨","64105703080","5480","11698121","12188730","490609","2024-09"
"063760","이엘피","20704614700","2345","8829260","9325130","495870","2024-09"
"123570","이엠넷","55624901045","2605","21353129","22276078","922949","2024-09"
"083470","이엠앤아이","28679511168","1344","21338922","21340329","1407","2024-09"
"095190","이엠코리아","99930097260","2205","45319772","45319772","0","2024-09"
"091120","이엠텍","426543212100","25950","16437118","17132936","695818","2024-09"
"102460","이연제약","301525892040","16440","18340991","18586811","245820","2024-09"
"039030","이오테크닉스","2080360100700","171900","12102153","12319550","217397","2024-09"
"294090","이오플로우","179874744690","5910","30435659","30435659","0","2024-09"
"088290","이원컴포텍","36218916908","1156","31331243","31331669","426","2024-09"
"084680","이월드","266302236684","1878","141800978","141806193","5215","2024-09"
"353810","이지바이오","116897684400","3495","33447120","34191720","744600","2024-09"
"099750","이지케어텍","109685316480","16320","6720914","6834776","113862","2024-09"
"377330","이지트로닉스","45477440000","5750","7909120","8139954","230834","2024-09"
"035810","이지홀딩스","168384721590","2610","64515219","65145845","630626","2024-09"
"160600","이큐셀","106346383500","3100","34305285","34482552","177267","2024-09"
"092130","이크레더블","152592412000","12670","12043600","12043600","0","2024-09"
"096040","이트론","245561522409","271","906131079","906131295","216","2024-09"
"134060","이퓨쳐","15924874320","4140","3846588","4769250","922662","2024-09"
"001840","이화공영","47331000740","2390","19803766","19805760","1994","2024-09"
"000760","이화산업","31808000000","11360","2800000","2800000","0","2024-09"
"024810","이화전기","196810080587","899","218921113","218948640","27527","2024-09"
"014990","인디에프","55956942550","745","75109990","75112995","3005","2024-09"
"041830","인바디","302874192750","23250","13026847","13683782","656935","2024-09"
"352940","인바이오","24126360600","2220","10867730","10867730","0","2024-09"
"101140","인바이오젠","93257770480","9340","9984772","10044216","59444","2024-09"
"079950","인베니아","17105150000","785","21790000","23200000","1410000","2024-09"
"389470","인벤티지랩","177567709800","17700","10032074","10032074","0","2024-09"
"277410","인산가","50961182064","1352","37693182","38356789","663607","2024-09"
"060150","인선이엔티","249664059870","5570","44822991","46563612","1740621","2024-09"
"033230","인성정보","102719557050","2050","50107101","50515380","408279","2024-09"
"450520","인스웨이브시스템즈","48819198960","3320","14704578","14704578","0","2024-09"
"006490","인스코비","182554739133","1541","118465113","119368998","903885","2024-09"
"465480","인스피언","112529269200","11100","10137772","10137772",,"자료 없음"
"037330","인지디스플레","62789718204","1557","40327372","43885224","3557852","2024-09"
"100030","인지소프트","46508572300","16930","2747110","3283714","536604","2024-09"
"023800","인지컨트롤스","96169538980","6340","15168697","15809197","640500","2024-09"
"034590","인천도시가스","105110974500","25500","4121999","4374754","252755","2024-09"
"211050","인카금융서비스","250557259230","5130","48841571","51379800","2538229","2024-09"
"083640","인콘","25986466312","337","77111176","77720351","609175","2024-09"
"064090","인크레더블버즈","185035314720","3720","49740676","49742745","2069","2024-09"
"216050","인크로스","89440107900","7410","12070190","12843222","773032","2024-09"
"049070","인탑스","314157384250","19750","15906703","17200000","1293297","2024-09"
"119610","인터로조","312050211300","24900","12532137","13216478","684341","2024-09"
"017250","인터엠","20569394472","1016","20245467","21045467","800000","2024-09"
"129260","인터지스","62071090400","2200","28214132","29747874","1533742","2024-09"
"051370","인터플렉스","233274720000","10000","23327472","23327472","0","2024-09"
"064290","인텍플러스","160355378560","12940","12392224","12863962","471738","2024-09"
"189300","인텔리안테크","518279353200","49700","10428156","10733334","305178","2024-09"
"150840","인트로메딕","251537720850","5850","42997901","42997901","0","2024-09"
"048530","인트론바이오","191413023750","5850","32720175","34150762","1430587","2024-09"
"023810","인팩","70900000000","7090","10000000","10000000","0","2024-09"
"115310","인포바인","42551062860","19860","2142551","3192883","1050332","2024-09"
"039290","인포뱅크","49629015450","5950","8341011","8693978","352967","2024-09"
"071200","인피니트헬스케어","105793806020","4340","24376453","24396458","20005","2024-09"
"101930","인화정공","211460840500","22250","9503858","9615733","111875","2024-09"
"249420","일동제약","382394090540","13690","27932366","28062501","130135","2024-09"
"000230","일동홀딩스","89207511000","7900","11292090","11540400","248310","2024-09"
"013360","일성건설","64451681840","1193","54024880","54024880","0","2024-09"
"003120","일성아이에스","108914454540","15980","6815673","13300000","6484327","2024-09"
"333430","일승","86672918175","2825","30680679","30726747","46068","2024-09"
"068330","일신바이오","50137139874","1203","41676758","44216140","2539382","2024-09"
"003200","일신방직","171045504300","8030","21300810","23280000","1979190","2024-09"
"007110","일신석재","101044858050","1305","77429010","77456610","27600","2024-09"
"007570","일양약품","230950788400","12850","17972824","19085664","1112840","2024-09"
"178780","일월지엠엘","124101377000","8650","14346980","14349195","2215","2024-09"
"008500","일정실업","14912006540","12620","1181617","1200000","18383","2024-09"
"019540","일지테크","54372013490","4115","13213126","13513500","300374","2024-09"
"081000","일진다이아","173075204700","12190","14198130","14202975","4845","2024-09"
"020760","일진디스플","46871776277","911","51450907","51513741","62834","2024-09"
"103590","일진전기","1132335138750","23750","47677269","47685390","8121","2024-09"
"094820","일진파워","160588250850","10650","15078709","15078709","0","2024-09"
"271940","일진하이솔루스","742604735500","20450","36313190","36313190","0","2024-09"
"015860","일진홀딩스","184172075685","4005","45985537","49347483","3361946","2024-09"
"226320","잇츠한불","206819881900","11740","17616685","21929315","4312630","2024-09"
"049550","잉크테크","75778260605","3865","19606277","19606277","0","2024-09"
"389020","자람테크놀로지","203302253700","33150","6132798","6197730","64932","2024-09"
"254120","자비스","58414547340","1902","30712170","30754270","42100","2024-09"
"043910","자연과환경","67013167314","591","113389454","113391457","2003","2024-09"
"234920","자이글","42223263545","3145","13425521","13530910","105389","2024-09"
"289220","자이언트스텝","147330821700","6660","22121745","22121745","0","2024-09"
"317400","자이에스앤디","151878392200","3985","38112520","38782520","670000","2024-09"
"033240","자화전자","328317116400","15570","21086520","22155870","1069350","2024-09"
"174880","장원테크","11454988050","2650","4322637","4381265","58628","2024-09"
"049630","재영솔루텍","58892565952","704","83654213","83654213","0","2024-09"
"417840","저스템","56808970560","8010","7092256","7249175","156919","2024-09"
"000950","전방","21741087600","19080","1139470","1680000","540530","2024-09"
"079900","전진건설로봇","334017960000","23000","14522520","15360574","838054","2024-09"
"110020","전진바이오팜","20110451640","2220","9058762","9058762","0","2024-09"
"208140","정다운","86776646580","2655","32684236","32684246","10","2024-09"
"040420","정상제이엘에스","97699372680","6540","14938742","15677552","738810","2024-09"
"045510","정원엔시스","26789443407","851","31479957","32209292","729335","2024-09"
"217190","제너셈","74801054220","8530","8769174","8769174","0","2024-09"
"095700","제넥신","365656611120","8040","45479678","45540494","60816","2024-09"
"072520","제넨바이오","28838655818","389","74135362","74163194","27832","2024-09"
"122310","제노레이","80889492000","6000","13481582","14553844","1072262","2024-09"
"361390","제노코","115137111150","15350","7500789","7500789","0","2024-09"
"187420","제노포커스","95530081635","4035","23675361","23675361","0","2024-09"
"225220","제놀루션","54077794875","2995","18056025","19190021","1133996","2024-09"
"123330","제닉","168621983300","21550","7824686","7968680","143994","2024-09"
"381620","제닉스","121559392000","27800","4372640","4372640","0","2024-09"
"159580","제로투세븐","83936744840","4190","20032636","20032636","0","2024-09"
"147830","제룡산업","118742269800","6200","19151979","20000000","848021","2024-09"
"033100","제룡전기","859338881500","53500","16062409","16062409","0","2024-09"
"079370","제우스","386912138210","12610","30682961","31016990","334029","2024-09"
"054950","제이브이엠","230359360000","20000","11517968","12089892","571924","2024-09"
"023440","제이스코홀딩스","99534016960","1696","58687510","58687510","0","2024-09"
"090470","제이스텍","95599607510","5510","17350201","17476594","126393","2024-09"
"287410","제이시스메디칼","960860460300","12900","74485307","75692193","1206886","2024-06"
"137950","제이씨케미칼","101444475700","4700","21583931","22267814","683883","2024-09"
"033320","제이씨현시스템","80479711260","4260","18891951","19114432","222481","2024-09"
"417500","제이아이테크","106185891840","3360","31602944","32784744","1181800","2024-09"
"204270","제이앤티씨","1329698869300","23300","57068621","57848466","779845","2024-09"
"194370","제이에스코퍼레이션","221088594000","16600","13318590","13335601","17011","2024-09"
"026040","제이에스티나","25053583731","1749","14324519","16503790","2179271","2024-09"
"452160","제이엔비","55873009570","5810","9616697","9617527","830","2024-09"
"126880","제이엔케이글로벌","84911170795","3665","23168123","23204903","36780","2024-09"
"322510","제이엘케이","147849795840","9320","15863712","16195712","332000","2024-09"
"033050","제이엠아이","29801611008","936","31839328","32579342","740014","2024-09"
"094970","제이엠티","53980192820","3230","16712134","16748240","36106","2024-09"
"418550","제이오","585292673670","19790","29575173","31772273","2197100","2024-09"
"025620","제이준코스메틱","22349418210","4995","4474358","4484846","10488","2024-09"
"420570","제이투케이바이오","81708140800","14300","5713856","5732807","18951","2024-09"
"089790","제이티","42542603600","4655","9139120","10315513","1176393","2024-09"
"030000","제일기획","1863528540000","18400","101278725","115041225","13762500","2024-09"
"052670","제일바이오","56184286080","2080","27011676","29129064","2117388","2024-09"
"271980","제일약품","204875529020","14060","14571517","14704872","133355","2024-09"
"412540","제일엠앤에스","218161042350","10590","20600665","20600665","0","2024-09"
"001560","제일연마","56149500000","8250","6806000","9900000","3094000","2024-09"
"199820","제일일렉트릭","198202400000","8920","22220000","22220000","0","2024-09"
"038010","제일테크노스","53721360000","6460","8316000","9000000","684000","2024-09"
"002620","제일파마홀딩스","133247765000","8680","15351125","15973355","622230","2024-09"
"276730","제주맥주","34606253275","2915","11871785","11886605","14820","2024-09"
"080220","제주반도체","416323165440","12360","33683104","34442833","759729","2024-09"
"006220","제주은행","264741097760","8240","32128774","32128774","0","2024-09"
"089590","제주항공","720305732340","8940","80571111","80640985","69874","2024-09"
"216080","제테마","337351957510","18890","17858759","17858759","0","2024-09"
"229000","젠큐릭스","34146571200","2240","15244005","15244005","0","2024-09"
"082270","젬백스","563454807200","14200","39679916","39994174","314258","2024-09"
"044060","조광ILI","70075958688","732","95732184","95732184","0","2024-09"
"004910","조광페인트","62226112640","6080","10234558","12800000","2565442","2024-09"
"004700","조광피혁","184751996000","52000","3552923","6649138","3096215","2024-09"
"001550","조비","52281707960","10070","5191828","5192239","411","2024-09"
"462520","조선내화","205463983560","17340","11849134","11855168","6034","2024-09"
"120030","조선선재","90562697500","93500","968585","1257651","289066","2024-09"
"034940","조아제약","41605907661","1343","30979827","30979827","0","2024-09"
"067000","조이시티","109748410220","1570","69903446","69903446","0","2024-09"
"018470","조일알미늄","210082025139","1659","126631721","126631721","0","2024-09"
"002600","조흥","104040000000","173400","600000","600000","0","2024-09"
"185750","종근당","1318391123500","104500","12616183","13174420","558237","2024-09"
"063160","종근당바이오","143457827850","26150","5485959","5485962","3","2024-09"
"001630","종근당홀딩스","265163080600","55700","4760558","5009861","249303","2024-09"
"033340","좋은사람들","64181269396","662","96950558","96950558","0","2024-09"
"036930","주성엔지니어링","1278608083050","27050","47268321","47268321","0","2024-09"
"109070","주성코퍼레이션","216476814300","4100","52799223","52810230","11007","2024-09"
"044380","주연테크","22696699168","352","64479259","66403852","1924593","2024-09"
"072020","중앙백신","99782098560","10410","9585216","9658687","73471","2024-09"
"000440","중앙에너비스","88676700000","20000","4433835","6227130","1793295","2024-09"
"051980","중앙첨단소재","1184848830000","11880","99734750","99961003","226253","2024-09"
"228760","지노믹트리","396316650240","16520","23990112","24362333","372221","2024-09"
"314130","지놈앤컴퍼니","117534387135","3795","30970853","30970853","0","2024-09"
"013890","지누스","492454940900","24700","19937447","20260832","323385","2024-09"
"389030","지니너스","49927711965","1497","33351845","33351845","0","2024-09"
"043610","지니뮤직","150518984420","2590","58115438","58115438","0","2024-09"
"263860","지니언스","83766897990","9710","8626869","9444600","817731","2024-09"
"303030","지니틱스","40917894040","1145","35736152","35745668","9516","2024-09"
"036180","지더블유바이텍","53929030348","577","93464524","93464524","0","2024-09"
"208350","지란지교시큐리티","24256966800","3100","7824828","8838549","1013721","2024-09"
"144510","지씨셀","512425508100","34100","15027141","15800344","773203","2024-09"
"358570","지아이이노베이션","627892916200","14200","44217811","44217811","0","2024-09"
"382480","지아이텍","91418953860","2340","39067929","39357140","289211","2024-09"
"382800","지앤비에스 에코","105489521735","3335","31631041","31631041","0","2024-09"
"051160","지어소프트","136988949900","9430","14526930","15474430","947500","2024-09"
"053050","지에스이","113353116660","3780","29987597","29987597","0","2024-09"
"119850","지엔씨에너지","77259425460","5180","14914947","16448909","1533962","2024-09"
"065060","지엔코","34515704960","320","107861578","108008044","146466","2024-09"
"204840","지엘팜텍","82322614206","1071","76865186","76865206","20","2024-09"
"013870","지엠비코리아","72665386800","3810","19072280","19072280","0","2024-09"
"071320","지역난방공사","545937779600","47150","11578744","11578744","0","2024-09"
"270520","지오릿에너지","161013857004","1014","158790786","158790786","0","2024-09"
"311320","지오엘리먼트","83886824000","6650","12614560","12614560","0","2024-09"
"388050","지투파워","162300944700","8700","18655281","18709437","54156","2024-09"
"088790","진도","22318804992","1793","12447744","12447744","0","2024-09"
"018120","진로발효","117134422800","17700","6617764","6621120","3356","2024-09"
"109820","진매트릭스","65282813010","3270","19964163","20393640","429477","2024-09"
"086060","진바이오텍","29362101670","3410","8610587","8610587","0","2024-09"
"036890","진성티이씨","168277842640","8420","19985492","22482268","2496776","2024-09"
"363250","진시스템","67773918240","9990","6784176","7006491","222315","2024-09"
"003780","진양산업","85150000000","6550","13000000","13000000","0","2024-09"
"007370","진양제약","67308322680","5930","11350476","12574867","1224391","2024-09"
"010640","진양폴리","67400000000","6740","10000000","10000000","0","2024-09"
"100250","진양홀딩스","177188075640","3170","55895292","55895292","0","2024-09"
"051630","진양화학","42897000000","2715","15800000","15800000","0","2024-09"
"272450","진에어","549863874780","10670","51533634","52200000","666366","2024-09"
"285800","진영","45965172760","2630","17477252","17477270","18","2024-09"
"011000","진원생명과학","182410569735","2285","79829571","80039035","209464","2024-09"
"002780","진흥기업","106151938220","730","145413614","145471745","58131","2024-09"
"085660","차바이오텍","961287542010","17070","56314443","56314443","0","2024-09"
"261780","차백신연구소","105555383380","3935","26824748","26824748","0","2024-09"
"351870","차이커뮤니케이션","97162630200","8730","11129740","11131089","1349","2024-09"
"009310","참엔지니어링","31901840712","378","84396404","84867419","471015","2024-09"
"094850","참좋은여행","61773699455","4615","13385417","14000000","614583","2024-09"
"004650","창해에탄올","71321099400","9400","7587351","9190885","1603534","2024-09"
"278280","천보","553101000000","55700","9930000","10000000","70000","2024-09"
"000650","천일고속","58509214000","41000","1427054","1429220","2166","2024-09"
"362320","청담글로벌","133821514400","6650","20123536","20551290","427754","2024-09"
"012600","청호ICT","116119947330","2490","46634517","46634517","0","2024-09"
"066360","체리부로","34477498785","719","47952015","47952015","0","2024-09"
"033250","체시스","47360000000","1480","32000000","32000000","0","2024-09"
"047820","초록뱀미디어","131865872400","5400","24419606","24453930","34324","2024-09"
"094360","칩스앤미디어","276104692500","13650","20227450","20823124","595674","2024-09"
"016920","카스","28457061402","1158","24574319","26493538","1919219","2024-09"
"284620","카이노스메드","141806560800","5100","27805208","28180793","375585","2024-09"
"035720","카카오","16435962300100","37450","438877498","443530908","4653410","2024-09"
"293490","카카오게임즈","1384281323640","16920","81813317","82667326","854009","2024-09"
"323410","카카오뱅크","10576774926600","22200","476431303","476963637","532334","2024-09"
"377300","카카오페이","3284630058400","24400","134615986","134615986","0","2024-09"
"140430","카티스","51018907720","3190","15993388","17922947","1929559","2024-09"
"042000","카페24","595991865850","24650","24178169","24253054","74885","2024-09"
"006380","카프로","618528628380","3660","168996893","168999996","3103","2024-09"
"313760","캐리","48225593640","6590","7317996","7417913","99917","2024-09"
"317530","캐리소프트","29905462730","4355","6866926","6971196","104270","2024-09"
"071850","캐스텍코리아","49734922900","2050","24260938","24529188","268250","2024-09"
"050110","캠시스","79171251981","1081","73238901","73824118","585217","2024-09"
"452300","캡스톤파트너스","37566852700","2665","14096380","14096380","0","2024-09"
"451760","컨텍","124991757120","8480","14739594","14940476","200882","2024-09"
"078340","컴투스","447733423200","39200","11421771","12737755","1315984","2024-09"
"063080","컴투스홀딩스","141791425000","21500","6594950","6595192","242","2024-09"
"307930","컴퍼니케이","78362200000","5020","15610000","15610000","0","2024-09"
"079190","케스피온","22335827702","593","37665814","38355514","689700","2024-09"
"263700","케어랩스","57714937525","2975","19399979","19414200","14221","2024-09"
"214370","케어젠","813303736600","16600","48994201","53715000","4720799","2024-09"
"221980","케이디켐","46848461310","12510","3744881","4034800","289919","2024-09"
"038530","케이바이오","29682688137","257","115496841","115714347","217506","2024-09"
"001620","케이비아이동국실업","61990218267","557","111293031","111293031","0","2024-09"
"424140","케이비제21호스팩","16692150000","2165","7710000","7710000","0","2024-09"
"192250","케이사인","65517422949","957","68461257","70671257","2210000","2024-09"
"431190","케이쓰리아이","42448126140","5670","7486442","7486442","0","2024-09"
"029460","케이씨","220972400940","19020","11617897","13554044","1936147","2024-09"
"115500","케이씨에스","85920000000","7160","12000000","12000000","0","2024-09"
"281820","케이씨텍","698032814600","34850","20029636","20861556","831920","2024-09"
"089150","케이씨티","37387000000","2180","17150000","17150000","0","2024-09"
"025880","케이씨피드","44750860560","2835","15785136","16715858","930722","2024-09"
"093320","케이아이엔엑스","359376989100","74300","4836837","4880000","43163","2024-09"
"093640","케이알엠","136365379200","4185","32584320","32584320","0","2024-09"
"073010","케이에스피","156270636600","3900","40069394","40191250","121856","2024-09"
"105330","케이엔더블유","63005499910","3970","15870403","16060028","189625","2024-09"
"053080","케이엔솔","203189217280","15680","12958496","12999807","41311","2024-09"
"199430","케이엔알시스템","80203721940","7380","10867713","10867713","0","2024-09"
"432470","케이엔에스","139660351600","16100","8674556","8674556","0","2024-09"
"272110","케이엔제이","127605996300","15940","8005395","8005395","0","2024-09"
"039420","케이엘넷","55781875260","2610","21372366","24154730","2782364","2024-09"
"083550","케이엠","36387359580","3155","11533236","12374226","840990","2024-09"
"032500","케이엠더블유","310204678570","7790","39820883","39820883","0","2024-09"
"225430","케이엠제약","18405427260","660","27887011","27887050","39","2024-09"
"102370","케이옥션","110025232500","4250","25888290","27229210","1340920","2024-09"
"068100","케이웨더","35042781600","3600","9734106","9939614","205508","2024-09"
"381970","케이카","622512383160","12920","48182073","48182073","0","2024-09"
"036030","케이티알파","199262808165","4065","49019141","49019283","142","2024-09"
"064820","케이프","135881415360","4870","27901728","30901728","3000000","2024-09"
"256940","케이피에스","104242538480","5560","18748658","18748658","0","2024-09"
"024880","케이피에프","78369063300","4050","19350386","20682798","1332412","2024-09"
"042040","케이피엠테크","55997240472","321","174446232","174460917","14685","2024-09"
"054410","케이피티유","22361763820","3905","5726444","5726444","0","2024-09"
"258610","케일럼","40323291120","1520","26528481","26787133","258652","2024-09"
"274090","켄코아에어로스페이스","107438040320","8320","12913226","12913226","0","2024-09"
"089010","켐트로닉스","291550230360","19560","14905431","15334346","428915","2024-09"
"220260","켐트로스","126948635760","4780","26558292","26558307","15","2024-09"
"052400","코나아이","199209253760","13640","14604784","14899999","295215","2024-09"
"402030","코난테크놀로지","164921587200","14400","11452888","11452888","0","2024-09"
"391710","코닉오토메이션","84660954720","2040","41500468","41503222","2754","2024-09"
"046070","코다코","145807623880","10280","14183621","14219097","35476","2024-09"
"047770","코데즈컴바인","52546968528","1392","37749259","37842602","93343","2024-09"
"080530","코디","63434786520","1470","43152916","43300427","147511","2024-09"
"104540","코렌텍","80294447200","6280","12785740","12785740","0","2024-09"
"027050","코리아나","76194000000","2490","30600000","40000000","9400000","2024-09"
"007810","코리아써키트","244002357830","10330","23620751","23620751","0","2024-09"
"190650","코리아에셋투자증권","35708920000","5590","6388000","6388000","0","2024-09"
"123410","코리아에프티","145051917390","5210","27841059","27841064","5","2024-09"
"003690","코리안리","1348970538160","9160","147267526","165367526","18100000","2024-09"
"036690","코맥스","45885746130","2885","15904938","15904938","0","2024-09"
"049430","코메론","97390570800","10840","8984370","9048000","63630","2024-09"
"183300","코미코","527584256000","51200","10304380","10460684","156304","2024-09"
"041960","코미팜","301034895700","4345","69283060","70622233","1339173","2024-09"
"089890","코세스","144481321760","8810","16399696","16584962","185266","2024-09"
"360350","코셈","40951623400","7220","5671970","5671970","0","2024-09"
"082660","코스나인","47827116000","480","99639825","99640869","1044","2024-09"
"192820","코스맥스","1569105054600","138300","11345662","11349509","3847","2024-09"
"044820","코스맥스비티아이","83700389640","8760","9554839","9603921","49082","2024-09"
"222040","코스맥스엔비티","72250248540","3515","20554836","20628000","73164","2024-09"
"241710","코스메카코리아","790320000000","74000","10680000","10680000","0","2024-09"
"005070","코스모신소재","3529390965600","108600","32498996","32510756","11760","2024-09"
"005420","코스모화학","870870949300","22700","38364359","38408228","43869","2024-09"
"355150","코스텍시스","58834683890","7790","7552591","7797350","244759","2024-09"
"071950","코아스","32117427200","9760","3290720","3290720","0","2024-09"
"166480","코아스템켐온","326912931180","13420","24360129","32870376","8510247","2024-09"
"045970","코아시아","110618315980","4460","24802313","26314876","1512563","2024-09"
"196450","코아시아씨엠","37379323575","825","45308271","45319582","11311","2024-09"
"384470","코어라인소프트","96622738650","7530","12831705","12832064","359","2024-09"
"029960","코엔텍","357554099200","7360","48580720","50000000","1419280","2024-09"
"002020","코오롱","181694270140","14390","12626426","12626426","0","2024-09"
"138490","코오롱ENP","215460000000","5670","38000000","38000000","0","2024-09"
"003070","코오롱글로벌","170855500380","9060","18858223","18932713","74490","2024-09"
"450140","코오롱모빌리티그룹","145661794750","2375","61331282","62777250","1445968","2024-09"
"102940","코오롱생명과학","234056611080","18840","12423387","12423387","0","2024-09"
"120110","코오롱인더","877636978900","31900","27512131","27519091","6960","2024-09"
"021240","코웨이","4738811864700","65900","71909133","73799619","1890486","2024-09"
"033290","코웰패션","124261137280","2345","52989824","56156301","3166477","2024-09"
"056360","코위버","48326070960","5220","9257868","9796800","538932","2024-09"
"282880","코윈테크","153028694190","14010","10922819","11141807","218988","2024-09"
"121850","코이즈","27482511480","905","30367416","30614175","246759","2024-09"
"448710","코츠테크놀로지","96311522300","21700","4438319","5166069","727750","2024-09"
"126730","코칩","101215879320","12360","8188987","8503460","314473","2024-09"
"015710","코콤","77512365790","4670","16597937","17530500","932563","2024-09"
"052330","코텍","99824355780","7940","12572337","15574552","3002215","2024-09"
"322780","코퍼스코리아","40510435500","1098","36894750","37932613","1037863","2024-09"
"036420","콘텐트리중앙","183785838340","9620","19104557","19262308","157751","2024-09"
"200130","콜마비앤에이치","414333373160","14230","29116892","29415558","298666","2024-09"
"024720","콜마홀딩스","238701962640","6960","34296259","34296259","0","2024-09"
"031820","콤텍시스템","67425666562","557","121051466","121051466","0","2024-09"
"294570","쿠콘","135426558240","13280","10197783","10254685","56902","2024-09"
"192400","쿠쿠홀딩스","747435159250","24050","31078385","35562185","4483800","2024-09"
"284740","쿠쿠홈시스","506745788000","22600","22422380","22437330","14950","2024-09"
"317690","퀀타매트릭스","123038337840","7440","16537411","16537411","0","2024-09"
"078940","퀀타피아","151577916950","2855","53092090","53094278","2188","2024-09"
"227100","퀀텀온","16276477332","1038","15680614","15680614","0","2024-09"
"432720","퀄리타스반도체","141008186320","10210","13810792","13810792","0","2024-09"
"365270","큐라클","77694220800","5600","13873968","13873968","0","2024-09"
"348080","큐라티스","35997816540","854","42152010","42152010","0","2024-09"
"060280","큐렉소","279411932000","6800","41089990","41089990","0","2024-09"
"372320","큐로셀","424099376200","30050","14113124","14113124","0","2024-09"
"051780","큐로홀딩스","17785125658","131","135764318","136422450","658132","2024-09"
"115180","큐리언트","158369118210","4905","32287282","32292671","5389","2024-09"
"445680","큐리옥스바이오시스템즈","362981441900","22550","16096738","16096738","0","2024-09"
"182360","큐브엔터","188889012800","13600","13888898","14571557","682659","2024-09"
"405100","큐알티","166970826000","14160","11791725","12289301","497576","2024-09"
"066310","큐에스아이","60076766400","6720","8939995","9271621","331626","2024-09"
"016600","큐캐피탈","48342046094","277","174520022","178247112","3727090","2024-09"
"355390","크라우드웍스","43186057530","10230","4221511","4224606","3095","2024-09"
"264900","크라운제과","101416466360","8440","12016169","12523850","507681","2024-09"
"005740","크라운해태홀딩스","84714309150","5890","14382735","14847347","464612","2024-09"
"259960","크래프톤","15704889415500","345500","45455541","47900115","2444574","2024-09"
"096240","크레버스","133029522390","15770","8435607","11138180","2702573","2024-09"
"040350","크레오에스지","107236086531","707","151677633","152074086","396453","2024-09"
"110790","크리스에프앤씨","128608562950","6350","20253317","23430960","3177643","2024-09"
"045520","크린앤사이언스","31441380000","5140","6117000","6500000","383000","2024-09"
"036170","클라우드에어","52196165128","866","60272708","61365626","1092918","2024-09"
"214150","클래시스","3366990872600","51400","65505659","65505659","0","2024-09"
"466100","클로봇","241105063420","10070","23942906","23942906",,"자료 없음"
"352770","클리노믹스","22107103200","575","38447136","38886113","438977","2024-09"
"237880","클리오","382913012550","21850","17524623","18071353","546730","2024-09"
"139670","키네마스터","37697222700","2670","14118810","14118810","0","2024-09"
"020120","키다리스튜디오","128053328360","3455","37063192","37063766","574","2024-09"
"413600","키움제6호스팩","9192400000","2680","3430000","3430000","0","2024-09"
"433530","키움제7호스팩","9256775000","2255","4105000","4105000","0","2024-09"
"446840","키움제8호스팩","13524000000","2300","5880000","5880000","0","2024-09"
"039490","키움증권","3250494326700","134700","24131361","25526706","1395345","2024-09"
"054780","키이스트","85386588050","4370","19539265","19547793","8528","2024-09"
"219130","타이거일렉","120981796400","19160","6314290","6314290","0","2024-09"
"360070","탑머티리얼","281437051600","35150","8006744","8076743","69999","2024-09"
"065130","탑엔지니어링","61905632040","3990","15515196","17189982","1674786","2024-09"
"134580","탑코미디어","39395447000","1820","21645850","22025767","379917","2024-09"
"014580","태경비케이","120676062500","4375","27583100","27583100","0","2024-09"
"015890","태경산업","149358912500","5110","29228750","29228750","0","2024-09"
"006890","태경케미컬","124106194050","10950","11333899","11600000","266101","2024-09"
"023160","태광","320495128380","12390","25867242","26500000","632758","2024-09"
"003240","태광산업","547060150000","650000","841631","1113400","271769","2024-09"
"011280","태림포장","139743415630","2030","68839121","70805940","1966819","2024-09"
"323280","태성","737181841500","28550","25820730","25820730","0","2024-09"
"053620","태양","50074884990","6290","7961031","8600000","638969","2024-09"
"004100","태양금속","125480197700","3445","36423860","36700000","276140","2024-09"
"009410","태영건설","1330097939940","4620","287899987","287905337","5350","2024-09"
"044490","태웅","280703555430","14030","20007381","20007381","0","2024-09"
"124560","태웅로직스","103249887320","2855","36164584","38416584","2252000","2024-09"
"001420","태원물산","27865806600","3800","7333107","7600000","266893","2024-09"
"191420","테고사이언스","134990702760","16860","8006566","8108834","102268","2024-09"
"073640","테라사이언스","59577565530","654","91097195","95587404","4490209","2024-09"
"066700","테라젠이텍스","109618423075","3425","32005379","32474435","469056","2024-09"
"095610","테스","285395747020","16270","17541226","19768226","2227000","2024-09"
"055490","테이팩스","81990283500","17190","4769650","4769650","0","2024-09"
"064520","테크엘","47931144690","2145","22345522","22351062","5540","2024-09"
"089030","테크윙","1477868599900","41350","35740474","37353645","1613171","2024-09"
"054450","텔레칩스","188058911040","12740","14761296","15144233","382937","2024-09"
"078000","텔코웨어","51278549790","9930","5164003","9240077","4076074","2024-09"
"200230","텔콘RF제약","70586887945","587","120250235","120250235","0","2024-09"
"214420","토니모리","180704041560","7560","23902651","24054799","152148","2024-09"
"393210","토마토시스템","98742521100","6420","15380455","15614544","234089","2024-09"
"215480","토박스코리아","23745250800","2650","8960472","9400000","439528","2024-09"
"051360","토비스","317682684800","20800","15273206","16167058","893852","2024-09"
"045340","토탈소프트","43646004000","5100","8558040","8558040","0","2024-09"
"108230","톱텍","191651192880","5260","36435588","38023245","1587657","2024-09"
"079970","투비소프트","8851273494","1058","8366043","9290500","924457","2024-09"
"199800","툴젠","451237830400","56800","7944328","7946828","2500","2024-09"
"417790","트루엔","93168679900","8900","10468391","10999650","531259","2024-09"
"290090","트윔","61262783750","8750","7001461","7432268","430807","2024-09"
"026150","특수건설","109489105440","6240","17546331","17546331","0","2024-09"
"464280","티디에스팜","77899605000","14730","5288500","5530000","241500","2024-09"
"322180","티라유텍","92013475750","5570","16519475","16519475","0","2024-09"
"117730","티로보틱스","134491432400","7540","17837060","17837060","0","2024-09"
"033830","티비씨","79504481650","841","94535650","100000000","5464350","2024-09"
"057680","티사이언티픽","65477372419","919","71248501","71248501","0","2024-09"
"204610","티쓰리","82465765641","1407","58611063","63851720","5240657","2024-09"
"064760","티씨케이","1004050000000","86000","11675000","11675000","0","2024-09"
"246710","티앤알바이오팹","150181391160","6970","21546828","21546828","0","2024-09"
"340570","티앤엘","556161557900","68900","8072011","8128000","55989","2024-09"
"043220","티에스넥스젠","80072204895","563","142224165","142224165","0","2024-09"
"277880","티에스아이","125601983360","6230","20160832","20160832","0","2024-09"
"131290","티에스이","572711112000","53100","10785520","11061429","275909","2024-09"
"019180","티에이치엔","57060000000","3170","18000000","18000000","0","2024-09"
"425420","티에프이","178600690000","15790","11311000","11381000","70000","2024-09"
"131100","티엔엔터테인먼트","43467445150","1550","28043513","28048252","4739","2024-09"
"356860","티엘비","144830376600","14820","9772630","9832630","60000","2024-09"
"062860","티엘아이","42843237000","5800","7386765","9872720","2485955","2024-09"
"363280","티와이홀딩스","129935377450","3670","35404735","50429268","15024533","2024-09"
"321550","티움바이오","159276017160","6120","26025493","26025493","0","2024-09"
"091810","티웨이항공","714376302200","3320","215173585","215378976","205391","2024-09"
"004870","티웨이홀딩스","82065824740","730","112418938","112419447","509","2024-09"
"425040","티이엠씨","188685589560","8920","21153093","21316062","162969","2024-09"
"241790","티이엠씨씨엔에스","54492381570","5610","9713437","10002634","289197","2024-09"
"104480","티케이케미칼","131889274734","1451","90895434","90895434","0","2024-09"
"081150","티플랙스","80085726600","3300","24268402","24268402","0","2024-09"
"130740","티피씨글로벌","22271441025","1975","11276679","11276679","0","2024-09"
"084730","팅크웨어","106888309200","10200","10479246","11109424","630178","2024-09"
"440110","파두","1051582208600","21350","49254436","49334436","80000","2024-09"
"034230","파라다이스","886056934500","10260","86360325","91771623","5411298","2024-09"
"033540","파라텍","50295155904","1344","37421991","37751063","329072","2024-09"
"388870","파로스아이바이오","117542444580","9090","12930962","12930962","0","2024-09"
"043200","파루","21941184300","525","41792732","41804315","11583","2024-09"
"214450","파마리서치","2418140638000","233000","10378286","10498238","119952","2024-09"
"208340","파멥신","233760977175","2915","80192445","80201108","8663","2024-09"
"005690","파미셀","298819989720","4980","60004014","60016964","12950","2024-09"
"177830","파버나인","37124496240","3120","11898877","14288753","2389876","2024-09"
"037070","파세코","118235335200","5920","19972185","20000000","27815","2024-09"
"150900","파수","55333868095","4895","11304161","11685422","381261","2024-09"
"037030","파워넷","54027152270","2470","21873341","21878974","5633","2024-09"
"047310","파워로직스","185982635400","5080","36610755","36610755","0","2024-09"
"368770","파이버프로","153172444125","4685","32694225","32854225","160000","2024-09"
"170790","파이오링크","54108882900","8100","6680109","6856330","176221","2024-09"
"049120","파인디앤씨","54724593036","1173","46653532","46653532","0","2024-09"
"038950","파인디지털","30384530865","3705","8200953","10210765","2009812","2024-09"
"441270","파인엠텍","209265781980","5660","36972753","36987901","15148","2024-09"
"106240","파인테크닉스","16268658550","1025","15871862","15923057","51195","2024-09"
"131760","파인텍","34745266400","800","43431583","43431583","0","2024-09"
"065690","파커스","13863924880","1040","13330697","14049331","718634","2024-09"
"140860","파크시스템스","1436170554000","207000","6938022","6983609","45587","2024-09"
"091700","파트론","357228500950","7030","50814865","58918214","8103349","2024-09"
"032800","판타지오","37249153971","163","228522417","229785294","1262877","2024-09"
"318010","팜스빌","43045617260","5570","7728118","7929338","201220","2024-09"
"036580","팜스코","73889743960","2110","35018836","36727943","1709107","2024-09"
"027710","팜스토리","143782939300","1300","110602261","111416600","814339","2024-09"
"004720","팜젠사이언스","85876872025","4735","18136615","18178525","41910","2024-09"
"225590","패션플랫폼","22124346048","864","25606882","26636713","1029831","2024-09"
"054300","팬스타엔터프라이즈","33347961444","498","66963778","66985895","22117","2024-09"
"068050","팬엔터테인먼트","58681202930","2170","27042029","27694076","652047","2024-09"
"028670","팬오션","1860301901760","3480","534569512","534569512","0","2024-09"
"222110","팬젠","56861578180","4955","11475596","11475596","0","2024-09"
"271830","팸텍","59833455585","2085","28697101","29490202","793101","2024-09"
"010820","퍼스텍","169595981130","3490","48594837","48771938","177101","2024-09"
"016800","퍼시스","376750879200","42100","8948952","11500000","2551048","2024-09"
"263750","펄어비스","2352363403000","38300","61419410","64247855","2828445","2024-09"
"251970","펌텍코리아","450681331100","36350","12398386","12400000","1614","2024-09"
"001020","페이퍼코리아","142870950046","803","177921482","177983313","61831","2024-09"
"168360","펨트론","162216724080","7620","21288284","21288284","0","2024-09"
"087010","펩트론","1807221554200","87800","20583389","20657350","73961","2024-09"
"090080","평화산업","53584604784","976","54902259","54902259","0","2024-09"
"010770","평화홀딩스","40504925215","2815","14388961","14625466","236505","2024-09"
"064800","포니링크","170796611800","1355","126049160","127807298","1758138","2024-09"
"119500","포메탈","33113013440","2795","11847232","11847232","0","2024-09"
"389140","포바이포","61138320920","5540","11035798","11112735","76937","2024-09"
"105760","포스뱅크","61584502350","6510","9459985","9459985","0","2024-09"
"022100","포스코DX","4220666028200","27800","151822519","152034729","212210","2024-09"
"058430","포스코스틸리온","225246184000","37600","5990590","6000000","9410","2024-09"
"009520","포스코엠텍","678724811700","16300","41639559","41642703","3144","2024-09"
"047050","포스코인터내셔널","8863113324000","52000","170444487","175922788","5478301","2024-09"
"003670","포스코퓨처엠","18816769152000","243000","77435264","77463220","27956","2024-09"
"189690","포시에스","61185986565","2245","27254337","27321969","67632","2024-09"
"318020","포인트모바일","52283845540","4195","12463372","12662272","198900","2024-09"
"256630","포인트엔지니어링","72113930224","1267","56917072","57997072","1080000","2024-09"
"331380","포커스에이치엔에스","79988904880","3590","22281032","22725452","444420","2024-09"
"472850","폰드그룹","210183850500","6500","32335977","32343933","7956","2024-09"
"039980","폴라리스AI","169383734125","2375","71319467","72152777","833310","2024-09"
"041910","폴라리스AI파마","86474608500","6510","13283350","13501607","218257","2024-09"
"234100","폴라리스세원","69159193723","1271","54413213","54413213","0","2024-09"
"041020","폴라리스오피스","251399992580","5060","49683793","49725498","41705","2024-09"
"114630","폴라리스우노","39136287365","515","75992791","77757548","1764757","2024-09"
"290720","푸드나무","40341411230","3230","12489601","13403058","913457","2024-09"
"005670","푸드웰","47801262990","5070","9428257","10000000","571743","2024-09"
"094940","푸른기술","49642539640","6280","7904863","8361386","456523","2024-09"
"057880","푸른소나무","215672327790","8790","24536101","24580368","44267","2024-09"
"007330","푸른저축은행","102767912400","8770","11718120","15082800","3364680","2024-09"
"017810","풀무원","381167090700","10340","36863355","38120542","1257187","2024-09"
"093380","풍강","25936140510","2705","9588222","9879313","291091","2024-08"
"023900","풍국주정","127008000000","10080","12600000","12600000","0","2024-09"
"103140","풍산","1898342321000","69500","27314278","28024278","710000","2024-09"
"005810","풍산홀딩스","392106848000","28000","14003816","14417292","413476","2024-09"
"371950","풍원정밀","218610670320","10390","21040488","21040488","0","2024-09"
"370090","퓨런티어","132136554500","16150","8181830","8181830","0","2024-09"
"445180","퓨릿","110005873280","6560","16769188","16769188","0","2024-09"
"151910","퓨처코어","121645902080","640","190071722","190071722","0","2024-09"
"220100","퓨쳐켐","546898968000","24750","22096928","22102155","5227","2024-09"
"035200","프럼파스트","23277397000","2750","8464508","9730590","1266082","2024-09"
"334970","프레스티지바이오로직스","551987751810","7130","77417637","77417637","0","2024-09"
"321260","프로이천","58780430505","2085","28192053","28192084","31","2024-09"
"053610","프로텍","289350000000","32150","9000000","11000000","2000000","2024-09"
"303360","프로티아","35219183025","2735","12877215","12877215","0","2024-09"
"377220","프롬바이오","61715800000","2180","28310000","28310000","0","2024-09"
"335810","프리시젼바이오","39257097880","3380","11614526","11614526","0","2024-09"
"053160","프리엠스","70479844600","13150","5359684","6000000","640316","2024-09"
"405000","플라즈맵","46781858136","1794","26076844","26076844","0","2024-09"
"041590","플래스크","103917099150","789","131707350","131707350","0","2024-09"
"367000","플래티어","38084095300","4700","8102999","8388207","285208","2024-09"
"075130","플랜티넷","31450878840","2020","15569742","16622320","1052578","2024-09"
"009810","플레이그램","55283550140","364","151877885","151887500","9615","2024-09"
"237820","플레이디","81195796200","6330","12827140","12827140","0","2024-09"
"023770","플레이위드","35724791500","4075","8766820","8766820","0","2024-09"
"019570","플루토스","21143305534","403","52464778","52470042","5264","2024-09"
"300080","플리토","83387442050","15170","5496865","5501817","4952","2024-09"
"033790","피노","194562996000","8570","22702800","22822800","120000","2024-09"
"032580","피델릭스","46856871755","1415","33114397","33132064","17667","2024-09"
"051380","피씨디렉트","39767327170","2690","14783393","15340072","556679","2024-09"
"241820","피씨엘","51716299158","874","59171967","59171967","0","2024-09"
"237750","피앤씨테크","28617523000","4405","6496600","6496600","0","2024-09"
"460940","피앤에스미캐닉스","80055423800","12370","6471740","6471740","0","2024-09"
"319660","피에스케이","596714308400","20600","28966714","28966714","0","2024-09"
"031980","피에스케이홀딩스","1053322995750","48850","21562395","21562395","0","2024-09"
"002230","피에스텍","60989998950","3690","16528455","19370673","2842218","2024-09"
"043370","피에이치에이","200410765380","10260","19533213","21000000","1466787","2024-09"
"239890","피엔에이치테크","69550285000","7000","9935755","9935755","0","2024-09"
"347740","피엔케이피부임상연구센타","69893934220","2420","28881791","30010576","1128785","2024-09"
"137400","피엔티","1239083008800","53300","23247336","23743086","495750","2024-09"
"257370","피엔티엠에스","57801626045","4705","12285149","12504861","219712","2024-09"
"147760","피엠티","45443437200","4200","10819866","10819866","0","2024-09"
"128660","피제이메탈","81107016630","3270","24803369","24803369","0","2024-09"
"006140","피제이전자","77000700000","5180","14865000","15000000","135000","2024-09"
"376180","피코그램","61075974960","3320","18396378","18491378","95000","2024-09"
"304840","피플바이오","87807005150","4175","21031618","21089464","57846","2024-09"
"087600","픽셀플러스","44906961330","6930","6480081","8166558","1686477","2024-09"
"291810","핀텔","22533700608","1984","11357712","11357712","0","2024-09"
"378340","필에너지","339084100260","15930","21285882","21285882","0","2024-09"
"161580","필옵틱스","497981324000","21800","22843180","22843180","0","2024-09"
"347770","핌스","51999770550","2275","22857042","22857042","0","2024-09"
"163730","핑거","96919357950","10550","9186669","9360608","173939","2024-09"
"417180","핑거스토리","41533739130","2470","16815279","16816209","930","2024-09"
"446750","하나26호스팩","12934350000","2145","6030000","6030000","0","2024-09"
"448370","하나27호스팩","11970600000","2130","5620000","5620000","0","2024-09"
"454750","하나28호스팩","14800110000","2055","7202000","7202000","0","2024-09"
"454640","하나29호스팩","11450120000","2120","5401000","5401000","0","2024-09"
"469880","하나30호스팩","14938725000","2045","7305000","7305000","0","2024-09"
"469900","하나31호스팩","11546300000","2060","5605000","5605000","0","2024-09"
"475240","하나32호스팩","6944000000","2170","3200000","3200000","0","2024-09"
"475250","하나33호스팩","7862500000","2125","3700000","3700000","0","2024-09"
"406760","하나금융21호스팩","15486900000","2090","7410000","7410000","0","2024-09"
"418170","하나금융22호스팩","14003300000","2330","6010000","6010000","0","2024-09"
"435620","하나금융25호스팩","44611740000","10370","4302000","4302000","0","2024-09"
"086790","하나금융지주","18167149594800","65400","277785162","287240880","9455718","2024-09"
"299030","하나기술","230653153500","28850","7994910","7994910","0","2024-09"
"067310","하나마이크론","708729978880","10780","65744896","65744896","0","2024-09"
"166090","하나머티리얼즈","573920245300","29450","19487954","19777674","289720","2024-09"
"293480","하나제약","191678304880","11080","17299486","17772946","473460","2024-09"
"039130","하나투어","735771770000","47500","15489932","16039185","549253","2024-09"
"136480","하림","299978789150","2825","106187182","106209702","22520","2024-09"
"003380","하림지주","510621200250","5250","97261181","112005621","14744440","2024-09"
"450330","하스","62688072000","8000","7836009","7836009","0","2024-09"
"101670","하이드로리튬","82853207304","1659","49941656","51691656","1750000","2024-09"
"365590","하이딥","124090544660","860","144291331","144447309","155978","2024-09"
"149980","하이로닉","113960324500","6820","16709725","18594363","1884638","2024-09"
"013030","하이록코리아","274128759750","22650","12102815","12856050","753235","2024-09"
"352820","하이브","8109509753800","195400","41502097","41652097","150000","2024-09"
"126700","하이비젼시스템","227595074280","17880","12729031","14942112","2213081","2024-09"
"106080","하이소닉","95979589900","6100","15734359","15735465","1106","2024-09"
"071090","하이스틸","63174514630","3130","20183551","20191471","7920","2024-09"
"450050","하이제8호스팩","10554470000","2105","5014000","5014000","0","2024-09"
"160190","하이젠알앤엠","204697920000","7340","27888000","30888000","3000000","2024-09"
"221840","하이즈항공","33735812044","1804","18700561","18700561","0","2024-09"
"106190","하이텍팜","160233251860","15070","10632598","10633173","575","2024-09"
"019490","하이트론","88588396750","2950","30029965","30044269","14304","2024-09"
"000080","하이트진로","1462232795100","21300","68649427","70133611","1484184","2024-09"
"000140","하이트진로홀딩스","201058040430","9410","21366423","23206765","1840342","2024-09"
"065650","하이퍼코퍼레이션","128559440850","1207","106511550","106681728","170178","2024-09"
"066130","하츠","61824776650","5150","12004811","12800000","795189","2024-09"
"004590","한국가구","55425000000","3695","15000000","15000000","0","2024-09"
"036460","한국가스공사","3573929022300","40950","87275434","92313000","5037566","2024-09"
"039340","한국경제TV","115896201100","5450","21265358","23000000","1734642","2024-09"
"005430","한국공항","171871458200","56200","3058211","3166355","108144","2024-09"
"071050","한국금융지주","4139973270500","78500","52738513","55725992","2987479","2024-09"
"034950","한국기업평가","378281860800","84800","4460871","4540514","79643","2024-09"
"010040","한국내화","78847551950","2225","35437102","41067062","5629960","2024-09"
"025540","한국단자","751963500000","72900","10315000","10415000","100000","2024-09"
"222980","한국맥널티","41111216560","3785","10861616","11031483","169867","2024-09"
"010100","한국무브넥스","109469259900","3595","30450420","30450420","0","2024-09"
"256840","한국비엔씨","328234110880","4940","66444152","67912443","1468291","2024-09"
"219750","한국비티비","63245329550","967","65403650","65426885","23235","2024-09"
"004090","한국석유","203529906650","16150","12602471","12694120","91649","2024-09"
"025550","한국선재","62165247840","2810","22122864","23300000","1177136","2024-09"
"002200","한국수출포장","98122772880","2640","37167717","40000000","2832283","2024-09"
"002960","한국쉘석유","417950000000","321500","1300000","1300000","0","2024-09"
"017890","한국알콜","185225337000","9000","20580593","21605760","1025167","2024-09"
"000240","한국앤컴퍼니","1590317637760","16790","94718144","94935240","217096","2024-09"
"080720","한국유니온제약","15410411825","2725","5655197","7912828","2257631","2024-09"
"123890","한국자산신탁","357923635875","2925","122367055","123977752","1610697","2024-09"
"015760","한국전력","14636780955600","22800","641964077","641964077","0","2024-09"
"063570","한국전자금융","153774965760","5070","30330368","34147728","3817360","2024-09"
"041460","한국전자인증","64447711875","3405","18927375","19000000","72625","2024-09"
"006200","한국전자홀딩스","32014797510","730","43855887","46803136","2947249","2024-09"
"101680","한국정밀기계","19662479460","2340","8402769","8404000","1231","2024-09"
"039740","한국정보공학","21409119990","2670","8018397","8018397","0","2024-09"
"053300","한국정보인증","158744219195","3865","41072243","42441361","1369118","2024-09"
"025770","한국정보통신","289592618010","8110","35708091","37444271","1736180","2024-09"
"458610","한국제12호스팩","9263700000","2190","4230000","4230000","0","2024-09"
"464440","한국제13호스팩","9288000000","2150","4320000","4320000","0","2024-09"
"477530","한국제14호스팩","10942750000","2275","4810000","4810000","0","2024-09"
"479880","한국제15호스팩","14014800000","2040","6870000","6870000","0","2024-09"
"027970","한국제지","181784088320","956","190150720","190178237","27517","2024-09"
"023350","한국종합기술","45881265150","4410","10403915","10950000","546085","2024-09"
"025890","한국주강","22133207376","1986","11144616","11309259","164643","2024-09"
"000970","한국주철관","137024878900","6370","21510970","22800500","1289530","2024-09"
"104700","한국철강","276728313510","8070","34290993","42450000","8159007","2024-09"
"062970","한국첨단소재","19707212773","1997","9868409","9868409","0","2024-09"
"017960","한국카본","527614237120","10720","49217746","51908452","2690706","2024-09"
"023760","한국캐피탈","174821981425","559","312740575","315609576","2869001","2024-09"
"054040","한국컴퓨터","66352073580","4905","13527436","16071290","2543854","2024-09"
"161890","한국콜마","1598063712900","67700","23605077","23605077","0","2024-09"
"021650","한국큐빅","39893968495","2455","16250089","16350563","100474","2024-09"
"161390","한국타이어앤테크놀로지","4452589484500","36500","121988753","123875069","1886316","2024-09"
"034830","한국토지신탁","224065111920","1040","215447223","252489230","37042007","2024-09"
"007280","한국특강","93226805763","1533","60813311","60813311","0","2024-09"
"032300","한국파마","234494071500","21500","10906701","10906701","0","2024-09"
"037230","한국팩키지","59421852038","1994","29800327","29800327","0","2024-09"
"047810","한국항공우주","5400120927800","55400","97475107","97475107","0","2024-09"
"123690","한국화장품","104435961500","6500","16067071","16068000","929","2024-09"
"003350","한국화장품제조","270425522200","74600","3625007","4532000","906993","2024-09"
"030520","한글과컴퓨터","420730577400","17480","24069255","24179744","110489","2024-09"
"052600","한네트","46486074000","4020","11563700","11563700","0","2024-09"
"011500","한농화성","291198140800","19040","15294020","15637042","343022","2024-09"
"002390","한독","205076641700","14900","13763533","13763533","0","2024-09"
"256150","한독크린텍","52314521280","6720","7784899","8395000","610101","2024-09"
"092460","한라IMS","103128620800","6310","16343680","17109680","766000","2024-09"
"053690","한미글로벌","146063458000","14360","10171550","10957550","786000","2024-09"
"042700","한미반도체","9137096391000","95500","95676402","96993634","1317232","2024-09"
"008930","한미사이언스","2583277883900","38150","67713706","68391550","677844","2024-09"
"128940","한미약품","4159110192000","328000","12680214","12810991","130777","2024-09"
"452190","한빛레이저","98202169360","4240","23160889","23162757","1868","2024-09"
"047080","한빛소프트","33882524130","1365","24822362","24822362","0","2024-09"
"009240","한샘","846616422000","51000","16600322","23533928","6933606","2024-09"
"452280","한선엔지니어링","149622000000","8800","17002500","17002500","0","2024-09"
"020000","한섬","336329726040","15660","21476994","23398500","1921506","2024-09"
"003680","한성기업","29539327650","5230","5648055","6209515","561460","2024-09"
"066980","한성크린텍","110356031250","2125","51932250","51935125","2875","2024-09"
"105630","한세실업","612403146450","15550","39382839","40000000","617161","2024-09"
"069640","한세엠케이","52596853605","1917","27437065","30106502","2669437","2024-09"
"016450","한세예스24홀딩스","199935846430","5090","39280127","40000000","719873","2024-09"
"010420","한솔PNS","21435690552","1046","20493012","20493012","0","2024-09"
"009180","한솔로지스틱스","62692496490","2235","28050334","28057025","6691","2024-09"
"114810","한솔아이원스","190949025930","6910","27633723","29113174","1479451","2024-09"
"070590","한솔인티큐브","14919423792","1092","13662476","13879521","217045","2024-09"
"213500","한솔제지","223740327880","9410","23776868","23800576","23708","2024-09"
"014680","한솔케미칼","1416899375000","125000","11335195","11335195","0","2024-09"
"004710","한솔테크닉스","136194936195","4335","31417517","32109878","692361","2024-09"
"004150","한솔홀딩스","93950957510","2290","41026619","42008577","981958","2024-09"
"025750","한솔홈데코","56153908853","697","80565149","80565149","0","2024-09"
"226440","한송네오텍","100580954580","1530","65739186","65739186","0","2024-09"
"042520","한스바이오메드","109739972550","8450","12986979","13526367","539388","2024-09"
"004960","한신공영","78217945520","6760","11570702","11570702","0","2024-09"
"011700","한신기계","112241143970","3470","32346151","32446151","100000","2024-09"
"430690","한싹","51752694000","4750","10895304","10895327","23","2024-09"
"078350","한양디지텍","181018805400","12200","14837607","15244382","406775","2024-09"
"045100","한양이엔지","287410251840","17120","16787982","18000000","1212018","2024-09"
"001750","한양증권","157197394900","12350","12728534","12728534","0","2024-09"
"018880","한온시스템","2067965166250","3875","533668430","533800000","131570","2024-09"
"009420","한올바이오파마","2337743908000","46100","50710280","52240638","1530358","2024-09"
"320000","한울반도체","78024088170","2790","27965623","27965627","4","2024-09"
"091440","한울소재과학","73070348000","5200","14051990","14606671","554681","2024-09"
"014130","한익스프레스","41477000000","3515","11800000","12000000","200000","2024-09"
"024740","한일단조","109626959520","3510","31232752","31532546","299794","2024-09"
"005860","한일사료","160767034800","4080","39403685","39403685","0","2024-09"
"300720","한일시멘트","988362175800","14270","69261540","69261540","0","2024-09"
"002220","한일철강","48683126260","1999","24353740","26697460","2343720","2024-09"
"006390","한일현대시멘트","268654640800","13900","19327672","19327672","0","2024-09"
"003300","한일홀딩스","445206051360","14440","30831444","30832884","1440","2024-09"
"007770","한일화학","40786200000","11620","3510000","3510000","0","2024-09"
"051600","한전KPS","2022750000000","44950","45000000","45000000","0","2024-09"
"052690","한전기술","2723914958000","71600","38043505","38220000","176495","2024-09"
"130660","한전산업","438470000000","13450","32600000","32600000","0","2024-09"
"198940","한주라이트메탈","38529758520","990","38918948","38922978","4030","2024-09"
"058450","한주에이알티","32271464490","2235","14439134","14452469","13335","2024-09"
"107640","한중엔시에스","349008894000","39000","8948946","8948946","0","2024-09"
"002320","한진","275783466620","19060","14469227","14947628","478401","2024-09"
"003480","한진중공업홀딩스","89226103680","3420","26089504","29529812","3440308","2024-09"
"180640","한진칼","5882782599300","88700","66322239","66762279","440040","2024-09"
"005110","한창","22551214950","1254","17983425","18606407","622982","2024-09"
"079170","한창산업","42082554580","8140","5169847","5200000","30153","2024-09"
"009460","한창제지","43139592378","723","59667486","59667486","0","2024-09"
"372910","한컴라이프케어","112081344300","4050","27674406","27674406","0","2024-09"
"054920","한컴위드","61574567175","2475","24878613","28217081","3338468","2024-09"
"457370","한켐","120808291450","15050","8027129","8027134","5","2024-09"
"002680","한탑","21680742501","699","31016799","32316799","1300000","2024-09"
"000880","한화","1956404102400","28200","69376032","74958735","5582703","2024-09"
"452260","한화갤러리아","249197516494","1286","193777229","193859610","82381","2024-09"
"088350","한화생명","2179031725000","2900","751390250","868530000","117139750","2024-09"
"000370","한화손해보험","542837900070","4695","115620426","116738915","1118489","2024-09"
"009830","한화솔루션","3683325068250","21750","169348279","171892536","2544257","2024-09"
"272210","한화시스템","3534172632900","18900","186993261","188919389","1926128","2024-09"
"012450","한화에어로스페이스","17163621870000","377500","45466548","45581161","114613","2024-09"
"082740","한화엔진","1192150895150","14290","83425535","83447142","21607","2024-09"
"042660","한화오션","9054036875850","29550","306397187","306413394","16207","2024-09"
"489790","한화인더스트리얼솔루션즈","2221649602200","44100","50377542","50488390","110848","2024-09"
"003530","한화투자증권","723951263380","3385","213870388","214547775","677387","2024-09"
"430460","한화플러스제3호스팩","12698400000","2145","5920000","5920000","0","2024-09"
"455310","한화플러스제4호스팩","10929600000","2160","5060000","5060000","0","2024-09"
"195870","해성디에스","448800000000","26400","17000000","17000000","0","2024-09"
"034810","해성산업","198548604000","6700","29634120","32556857","2922737","2024-09"
"059270","해성에어로보틱스","68293097870","6130","11140799","11140799","0","2024-09"
"076610","해성옵틱스","28293725481","1113","25421137","25453198","32061","2024-09"
"101530","해태제과식품","153802439600","5800","26517662","29116822","2599160","2024-09"
"220180","핸디소프트","61135200000","3150","19408000","19408000","0","2024-09"
"143210","핸즈코퍼레이션","41375382125","1925","21493705","21875747","382042","2024-09"
"214180","헥토이노베이션","153842853340","12430","12376738","13257185","880447","2024-09"
"234340","헥토파이낸셜","131380372740","15810","8309954","9453000","1143046","2024-09"
"084990","헬릭스미스","168761844520","3665","46046888","46092797","45909","2024-09"
"187660","현대ADM","75515956530","3570","21152929","21836250","683321","2024-09"
"000720","현대건설","3179207090750","28550","111355765","111355765","0","2024-09"
"170030","현대공업","79787354360","5320","14997623","15340000","342377","2024-09"
"453340","현대그린푸드","394020809400","11640","33850585","33880914","30329","2024-09"
"086280","현대글로비스","9217500000000","122900","75000000","75000000","0","2024-09"
"064350","현대로템","6941449834800","63600","109142293","109142293","0","2024-09"
"079430","현대리바트","158097627720","7860","20114202","20535282","421080","2024-09"
"012330","현대모비스","22772186679000","253000","90008643","92995094","2986451","2024-09"
"319400","현대무벡스","367864784380","3155","116597396","117741058","1143662","2024-09"
"048410","현대바이오","684494660880","17190","39819352","39821608","2256","2024-09"
"052260","현대바이오랜드","158100000000","5270","30000000","30000000","0","2024-09"
"069960","현대백화점","1003153037400","45900","21855186","23402441","1547255","2024-09"
"004560","현대비앤지스틸","197532424100","13100","15078811","15078811","0","2024-09"
"016790","현대사료","187340898626","994","188471729","188471729","0","2024-09"
"004310","현대약품","101929222200","3900","26135698","32000000","5864302","2024-08"
"041440","현대에버다임","144517867200","8100","17841712","17915944","74232","2024-09"
"039010","현대에이치티","46614000000","6000","7769000","8625000","856000","2024-09"
"017800","현대엘리베이","1631948802400","45200","36105062","39092385","2987323","2024-09"
"307950","현대오토에버","3894082472000","142000","27423116","27423982","866","2024-09"
"011210","현대위아","1153761537900","43300","26645763","27195083","549320","2024-09"
"090850","현대이지웰","124668395250","5250","23746361","23746361","0","2024-09"
"004020","현대제철","3380725492300","25700","131545739","133445785","1900046","2024-09"
"005440","현대지에프홀딩스","700789832995","4495","155904301","155904301","0","2024-09"
"005380","현대차","46168827046500","226500","203835881","209416191","5580310","2024-09"
"001500","현대차증권","280656173700","8850","31712562","31712562","0","2024-09"
"011760","현대코퍼레이션","228328463660","19010","12010966","13228966","1218000","2024-09"
"227840","현대코퍼레이션홀딩스","92627860500","10500","8821701","9100836","279135","2024-09"
"126560","현대퓨처넷","431250384825","3915","110153355","110202945","49590","2024-09"
"001450","현대해상","2368117900000","30200","78414500","89400000","10985500","2024-09"
"057050","현대홈쇼핑","543195737500","47450","11447750","12000000","552250","2024-09"
"460930","현대힘스","349805322900","9900","35333871","35333871","0","2024-09"
"092300","현우산업","51782176870","2830","18297589","18672816","375227","2024-09"
"138360","협진","39619895720","820","48316946","48348248","31302","2024-09"
"011080","형지I&C","15450695382","606","25496197","25503364","7167","2024-09"
"093240","형지엘리트","46828259679","1383","33859913","34164255","304342","2024-09"
"003010","혜인","52505557855","4885","10748323","12712747","1964424","2024-09"
"111110","호전실업","75225373040","8170","9207512","9749984","542472","2024-09"
"008770","호텔신라","1614420763500","43500","37113121","39248121","2135000","2024-09"
"060560","홈센타홀딩스","96728286096","762","126940008","127669525","729517","2024-09"
"064240","홈캐스트","93289422675","2715","34360745","35038012","677267","2024-09"
"039610","화성밸브","100980880000","9700","10410400","10410400","0","2024-09"
"378850","화승알앤에이","72354894660","3810","18990786","18993623","2837","2024-09"
"241590","화승엔터프라이즈","560450803000","9250","60589276","60589276","0","2024-09"
"006060","화승인더","204303843590","4130","49468243","55320000","5851757","2024-09"
"013520","화승코퍼레이션","83037802540","1870","44405242","50051252","5646010","2024-09"
"010690","화신","308913640490","8890","34748441","34920410","171969","2024-09"
"126640","화신정공","46974919400","1340","35055910","36373887","1317977","2024-09"
"133820","화인베스틸","25893939120","840","30826118","30826118","0","2024-09"
"127980","화인써키트","80509511200","6800","11839634","11840684","1050","2024-09"
"061250","화일약품","104054562192","1396","74537652","76877652","2340000","2024-09"
"010660","화천기계","62700000000","2850","22000000","22000000","0","2024-09"
"000850","화천기공","58520000000","26600","2200000","2200000","0","2024-09"
"016580","환인제약","200151287700","13110","15267070","18600070","3333000","2024-09"
"032560","황금에스티","89870656780","5290","16988782","17000000","11218","2024-09"
"004800","효성","842603529600","50400","16718324","16740407","22083","2024-09"
"094280","효성ITX","137096493300","12420","11038365","11558200","519835","2024-09"
"097870","효성오앤비","48681300000","6170","7890000","8490000","600000","2024-09"
"298040","효성중공업","3682793565500","395500","9311741","9324548","12807","2024-09"
"298020","효성티앤씨","1333548210000","309000","4315690","4327682","11992","2024-09"
"298000","효성화학","152690992000","40400","3779480","3791811","12331","2024-09"
"093370","후성","661764806120","6170","107255236","107255330","94","2024-09"
"081660","휠라홀딩스","2333258558400","39200","59521902","60095839","573937","2024-09"
"290270","휴네시온","33617956375","3625","9273919","9607672","333753","2024-09"
"005870","휴니드","102367631800","7820","13090490","14116015","1025525","2024-09"
"353190","휴럼","31068854601","789","39377509","39378420","911","2024-09"
"192410","휴림네트웍스","36831302200","2590","14220580","14235530","14950","2024-09"
"090710","휴림로봇","133573641352","1219","109576408","109623165","46757","2024-09"
"078590","휴림에이텍","31145386360","580","53698942","54210339","511397","2024-09"
"205470","휴마시스","171428067600","1515","113153840","129375009","16221169","2024-09"
"115160","휴맥스","74384454675","1725","43121423","43970124","848701","2024-09"
"028080","휴맥스홀딩스","32754174000","3000","10918058","12577506","1659448","2024-09"
"175140","휴먼테크놀로지","100476413640","4670","21515292","21515292","0","2024-09"
"200670","휴메딕스","322147468750","31250","10308719","11229930","921211","2024-09"
"079980","휴비스","87212348000","2650","32910320","34500000","1589680","2024-09"
"065510","휴비츠","97139602350","8930","10877895","12159371","1281476","2024-09"
"215090","휴센텍","149904424845","1505","99604269","99649272","45003","2024-09"
"005010","휴스틸","224471359625","3995","56188075","56188075","0","2024-09"
"263920","휴엠앤씨","49927946412","1018","49045134","49045134","0","2024-09"
"243070","휴온스","326565910300","27650","11810702","11979665","168963","2024-09"
"084110","휴온스글로벌","411166623400","33800","12164693","12621492","456799","2024-09"
"145020","휴젤","2914793830000","265000","10999222","12604033","1604811","2024-09"
"024060","흥구석유","238614806970","16410","14540817","15000000","459183","2024-09"
"010240","흥국","54357117360","4910","11070696","12322696","1252000","2024-09"
"189980","흥국에프엔비","70731255516","1828","38693247","40137827","1444580","2024-09"
"000540","흥국화재","223564404600","3480","64242645","64242645","0","2024-09"
"003280","흥아해운","463470880218","1929","240264842","240424899","160057","2024-09"
"037440","희림","57567811200","4560","12624520","13922475","1297955","2024-09"
"238490","힘스","47896241100","4315","11099940","11312236","212296","2024-09"