종목코드,종목명,자기주식 제외 시가총액(A*B),종가,자기주식 제외 발행주식수(B=C-D),총발행주식수(C),자기주식수(D),자기주식수 반영시점
"060310","3S","104978939310","2055","51084642","51084642","0","2024-09"
"095570","AJ네트웍스","217266347750","4855","44751050","45252759","501709","2024-09"
"006840","AK홀딩스","159546403850","12230","13045495","13247561","202066","2024-09"
"054620","APS","113377330560","6240","18169444","19894221","1724777","2024-09"
"265520","AP시스템","258496506140","17210","15020134","15281421","261287","2024-09"
"211270","AP위성","143612594490","10090","14233161","15082304","849143","2024-09"
"109960","AP헬스케어","61053086665","535","114117919","114153169","35250","2024-09"
"139050","BF랩스","24234697905","2805","8639821","8644551","4730","2024-09"
"027410","BGF","341680294620","3570","95708766","95716791","8025","2024-09"
"282330","BGF리테일","1914071662000","110800","17275015","17283906","8891","2024-09"
"126600","BGF에코머티리얼즈","207446070000","3350","61924200","62766899","842699","2024-09"
"138930","BNK금융지주","3155180673290","9910","318383519","320436727","2053208","2024-09"
"001460","BYC","202899775000","32500","6243070","6246150","3080","2024-09"
"013720","CBI","48850499904","1096","44571624","44628136","56512","2024-09"
"083790","CG인바이츠","188775216810","2455","76894182","76894182","0","2024-09"
"001040","CJ","2795138401500","103300","27058455","29176998","2118543","2024-09"
"079160","CJ CGV","905722616410","5470","165580003","165580003","0","2024-09"
"035760","CJ ENM","1270725644700","61300","20729619","21929154","1199535","2024-09"
"311690","CJ 바이오사이언스","102151147420","11210","9112502","9112502","0","2024-09"
"000120","CJ대한통운","1769132942300","88700","19945129","22812344","2867215","2024-09"
"011150","CJ씨푸드","110666780840","3080","35930773","35930773","0","2024-09"
"097950","CJ제일제당","3960808890500","269500","14696879","15054186","357307","2024-09"
"051500","CJ프레시웨이","214282127300","18050","11871586","11871586","0","2024-09"
"058820","CMG제약","288201406300","2075","138892244","138892244","0","2024-09"
"023460","CNH","6855355312","208","32958439","37200000","4241561","2024-09"
"056730","CNT85","57302772454","823","69626698","74111186","4484488","2024-09"
"000480","CR홀딩스","233924649840","5670","41256552","46890490","5633938","2024-09"
"065770","CS","19003496270","979","19411130","19411130","0","2024-09"
"083660","CSA 코스믹","49171270020","830","59242494","61247181","2004687","2024-09"
"000590","CS홀딩스","72260251600","69400","1041214","1154482","113268","2024-09"
"012030","DB","296861448282","1554","191030533","201173933","10143400","2024-09"
"456440","DB금융스팩11호","12091625000","2275","5315000","5315000","0","2024-09"
"477760","DB금융스팩12호","12234800000","2095","5840000","5840000","0","2024-09"
"016610","DB금융투자","217907581150","5350","40730389","42446389","1716000","2024-09"
"005830","DB손해보험","6820938078400","113600","60043469","70800000","10756531","2024-09"
"000990","DB하이텍","1480672316400","35600","41591919","44398588","2806669","2024-09"
"139130","DGB금융지주","1367749079040","8220","166392832","169145833","2753001","2024-09"
"099520","DGI","58000622016","1284","45171824","45281824","110000","2024-09"
"060900","DGP","29900248192","1184","25253588","25258229","4641","2024-09"
"290120","DH오토리드","39873904660","2570","15515138","15515138","0","2024-09"
"025440","DH오토웨어","36783561485","239","153906115","153906120","5","2024-09"
"001530","DI동일","730279876300","37700","19370819","25215672","5844853","2024-09"
"000210","DL","827810252850","39550","20930727","20955884","25157","2024-09"
"375500","DL이앤씨","1159598185200","30150","38460968","38693623","232655","2024-09"
"068790","DMS","124705268800","5300","23529296","24573061","1043765","2024-09"
"007340","DN오토모티브","884130479550","17590","50263245","59065865","8802620","2024-09"
"004840","DRB동일","87496532560","4540","19272364","19930000","657636","2024-09"
"241520","DSC인베스트먼트","74001104000","2830","26148800","27496125","1347325","2024-09"
"155660","DSR","60240000000","3765","16000000","16000000","0","2024-09"
"069730","DSR제강","51480000000","3575","14400000","14400000","0","2024-09"
"017860","DS단석","386852664000","66000","5861404","5861404","0","2024-09"
"180400","DXVX","113941281240","2315","49218696","49219432","736","2024-09"
"017940","E1","435365850300","75300","5781751","6860000","1078249","2024-09"
"245620","EDGC","57441040175","415","138412145","138493951","81806","2024-09"
"037370","EG","59512306800","6900","8624972","8624972","0","2024-09"
"050120","ES큐브","23694175283","1769","13394107","13564086","169979","2024-09"
"383220","F&F","2163326479600","57200","37820393","38307075","486682","2024-09"
"007700","F&F홀딩스","511815598300","13100","39069893","39114367","44474","2024-09"
"214270","FSN","75471856780","2270","33247514","33250463","2949","2024-09"
"130500","GH신소재","43344198340","2980","14545033","14545052","19","2024-09"
"114090","GKL","658762885500","10650","61855670","61855670","0","2024-09"
"078930","GS","3906255564750","42050","92895495","92915378","19883","2024-09"
"083450","GST","276411305800","14860","18601030","18618260","17230","2024-09"
"006360","GS건설","1536488999500","18100","84888895","85581490","692595","2024-09"
"001250","GS글로벌","280071210790","3395","82495202","82533764","38562","2024-09"
"007070","GS리테일","2099796596800","20300","103438256","104717922","1279666","2024-09"
"297890","HB솔루션","271718495510","3715","73140914","73140914","0","2024-09"
"440290","HB인베스트먼트","50012433450","1845","27107010","27107010","0","2024-09"
"078150","HB테크놀러지","202144255950","2275","88854618","92715916","3861298","2024-09"
"012630","HDC","545337747400","10900","50030986","59741721","9710735","2024-09"
"039570","HDC랩스","183335336940","7980","22974353","25957601","2983248","2024-09"
"089470","HDC현대EP","98754678030","3810","25919863","31900000","5980137","2024-09"
"294870","HDC현대산업개발","1392474461000","21700","64169330","65907330","1738000","2024-09"
"009540","HD한국조선해양","14135854537000","199900","70714630","70773116","58486","2024-09"
"267250","HD현대","5710009144000","80800","70668430","78993085","8324655","2024-09"
"267270","HD현대건설기계","876907823850","49650","17661789","18305586","643797","2024-09"
"443060","HD현대마린솔루션","5965190000000","134200","44450000","44450000","0","2024-09"
"071970","HD현대마린엔진","702174491100","20700","33921473","33921495","22","2024-09"
"010620","HD현대미포","4407214929000","110500","39884298","39942149","57851","2024-09"
"322000","HD현대에너지솔루션","251440000000","22450","11200000","11200000","0","2024-09"
"042670","HD현대인프라코어","1369322237520","7110","192591032","192655867","64835","2024-09"
"267260","HD현대일렉트릭","12417482880000","345000","35992704","36047135","54431","2024-09"
"329180","HD현대중공업","17585954279600","198100","88773116","88773116","0","2024-09"
"097230","HJ중공업","184023031400","2210","83268340","83274281","5941","2024-09"
"195940","HK이노엔","1315923436950","46450","28329891","28329891","0","2024-09"
"014790","HL D&I","92185693435","2435","37858601","37858601","0","2024-09"
"028300","HLB","8545890404800","65300","130871216","131127236","256020","2024-09"
"003580","HLB글로벌","190647179965","4015","47483731","47489591","5860","2024-09"
"278650","HLB바이오스텝","179757439470","2135","84195522","86730589","2535067","2024-09"
"067630","HLB생명과학","1043762288800","8800","118609351","118679271","69920","2024-09"
"024850","HLB이노베이션","359403821360","3940","91219244","91226268","7024","2024-09"
"047920","HLB제약","619770559370","19490","31799413","31799994","581","2024-09"
"115450","HLB테라퓨틱스","713439150780","8940","79803037","80139933","336896","2024-09"
"046210","HLB파나진","122881929100","2900","42373079","42373079","0","2024-09"
"204320","HL만도","1887676224000","40200","46957120","46957120","0","2024-09"
"060980","HL홀딩스","335765647350","35350","9498321","10169410","671089","2024-09"
"011200","HMM","12606334717680","16830","749039496","749039496","0","2024-09"
"403870","HPSP","2438502898650","30450","80082197","82934144","2851947","2024-09"
"036640","HRS","81187366200","5080","15981765","16354800","373035","2024-09"
"035000","HS애드","103404768720","6380","16207644","16567409","359765","2024-09"
"002460","HS화성","84614677260","8940","9464729","10150000","685271","2024-09"
"487570","HS효성","146766589200","39600","3706227","3725927","19700","2024-09"
"298050","HS효성첨단소재","1132643577000","253500","4468022","4479948","11926","2024-09"
"439730","IBKS제20호스팩","9352700000","2170","4310000","4310000","0","2024-09"
"442770","IBKS제21호스팩","9198850000","2185","4210000","4210000","0","2024-09"
"448760","IBKS제22호스팩","9746000000","2200","4430000","4430000","0","2024-09"
"467930","IBKS제23호스팩","9179100000","2170","4230000","4230000","0","2024-09"
"469480","IBKS제24호스팩","9263700000","2190","4230000","4230000","0","2024-09"
"003560","IHQ","63618682920","10760","5912517","5994566","82049","2024-09"
"095340","ISC","1307661868800","63900","20464192","21197058","732866","2024-09"
"175330","JB금융지주","3507410345820","18290","191766558","195083198","3316640","2024-09"
"234080","JW생명과학","167388028740","10810","15484554","15834554","350000","2024-09"
"067290","JW신약","71476415130","1410","50692493","50841502","149009","2024-09"
"001060","JW중외제약","610308009450","26550","22987119","23285930","298811","2024-09"
"096760","JW홀딩스","212609166800","2950","72070904","73924942","1854038","2024-09"
"035900","JYP Ent.","1686472703100","50900","33133059","35532492","2399433","2024-09"
"318000","KBG","48020472720","5520","8699361","8740223","40862","2024-09"
"024840","KBI메탈","93191866675","2675","34838081","34909199","71118","2024-09"
"105560","KB금융","38098784690000","101000","377215690","393528423","16312733","2024-09"
"024120","KB오토시스","41802500000","3635","11500000","11500000","0","2024-09"
"455250","KB제25호스팩","11365200000","2640","4305000","4305000","0","2024-09"
"458320","KB제26호스팩","12276150000","2230","5505000","5505000","0","2024-09"
"464680","KB제27호스팩","25732570000","1994","12905000","12905000","0","2024-09"
"476470","KB제28호스팩","11560500000","2100","5505000","5505000","0","2024-09"
"478390","KB제29호스팩","12719900000","2045","6220000","6220000","0","2024-09"
"486630","KB제30호스팩","10726200000","2020","5310000","5310000","0","2024-09"
"002380","KCC","1897376118000","258000","7354171","8886471","1532300","2024-09"
"021320","KCC건설","84967557360","4260","19945436","21400000","1454564","2024-09"
"344820","KCC글라스","615412653800","38600","15943333","15970512","27179","2024-09"
"036670","KCI","80486296000","7480","10760200","11270000","509800","2024-09"
"009070","KCTC","131884357500","4410","29905750","30000000","94250","2024-09"
"009440","KC그린홀딩스","18452233320","834","22124980","22434980","310000","2024-09"
"119650","KC코트렐","26263660561","409","64214329","64214329","0","2024-09"
"044180","KD","12073458332","452","26711191","26717799","6608","2024-09"
"092220","KEC","170648669850","850","200763141","200763141","0","2024-09"
"046440","KG모빌리언스","163067781690","4395","37103022","38825568","1722546","2024-09"
"003620","KG모빌리티","950596589360","4840","196404254","196404254","0","2024-09"
"016380","KG스틸","649867973040","6520","99673002","100008897","335895","2024-09"
"151860","KG에코솔루션","216937015460","5170","41960738","49603002","7642264","2024-09"
"035600","KG이니시스","242760610560","9120","26618488","27904434","1285946","2024-09"
"001390","KG케미칼","265659875200","3880","68469040","68469040","0","2024-09"
"226360","KH 건설","60474013950","2555","23668890","23756732","87842","2024-09"
"111870","KH 미래물산","43747975260","8910","4909986","4930249","20263","2024-09"
"033180","KH 필룩스","125157155370","6630","18877399","18903579","26180","2024-09"
"060720","KH바텍","193488740760","8780","22037442","23677442","1640000","2024-09"
"015590","KIB플러그에너지","95977524105","405","236981541","236981544","3","2024-09"
"001940","KISCO홀딩스","240591174900","19050","12629458","16176380","3546922","2024-09"
"058400","KNN","104487049080","789","132429720","132429720","0","2024-09"
"025000","KPX케미칼","223019864900","46900","4755221","4840000","84779","2024-09"
"092230","KPX홀딩스","219361462200","55800","3931209","4224646","293437","2024-09"
"000040","KR모터스","30721963860","511","60121260","60132868","11608","2024-09"
"044450","KSS해운","200488422000","8880","22577525","23085880","508355","2024-09"
"101000","KS인더스트리","66894460800","2220","30132640","30149619","16979","2024-09"
"030200","KT","10865499255000","44200","245825775","252021685","6195910","2024-09"
"033780","KT&G","12244310398800","111600","109716043","130322497","20606454","2024-09"
"058850","KTcs","105469666620","2780","37938729","42685000","4746271","2024-09"
"058860","KTis","79917631020","2610","30619782","34802000","4182218","2024-09"
"122450","KX","147599497530","3555","41518846","45335964","3817118","2024-09"
"052900","KX하이텍","52116586480","959","54344720","55107517","762797","2024-09"
"376190","LB루셈","116727000000","4745","24600000","24600000","0","2024-09"
"061970","LB세미콘","191557590000","4375","43784592","43784592","0","2024-09"
"309960","LB인베스트먼트","88302501120","3840","22995443","23217239","221796","2024-09"
"093050","LF","413332511280","14930","27684696","29240000","1555304","2024-09"
"003550","LG","11399877101600","75400","151192004","157300993","6108989","2024-09"
"034220","LG디스플레이","5055000000000","10110","500000000","500000000","0","2024-09"
"051900","LG생활건강","5072285610000","346000","14659785","15618197","958412","2024-09"
"373220","LG에너지솔루션","95238000000000","407000","234000000","234000000","0","2024-09"
"032640","LG유플러스","4281090385920","9960","429828352","436611361","6783009","2024-09"
"011070","LG이노텍","4077394556100","172300","23664507","23667107","2600","2024-09"
"066570","LG전자","15001675159800","92100","162884638","163647814","763176","2024-09"
"037560","LG헬로비전","198651208725","2565","77446865","77446865","0","2024-09"
"051910","LG화학","22766030617500","322500","70592343","70592343","0","2024-09"
"079550","LIG넥스원","5426795640000","249000","21794360","22000000","205640","2024-09"
"225190","LK삼양","129154779800","2545","50748440","50748440","0","2024-09"
"006260","LS","2964473119200","108400","27347538","32200000","4852462","2024-09"
"010120","LS ELECTRIC","4433429377000","149500","29655046","30000000","344954","2024-09"
"000680","LS네트웍스","249017524240","3160","78803014","78803016","2","2024-09"
"060370","LS마린솔루션","419169079920","15320","27360906","28706781","1345875","2024-09"
"417200","LS머트리얼즈","1028320416800","15200","67652659","67652659","0","2024-09"
"229640","LS에코에너지","843106612800","27800","30327576","30624879","297303","2024-09"
"078020","LS증권","221785044800","4400","50405692","55481190","5075498","2024-09"
"108320","LX세미콘","967725850000","59500","16264300","16264300","0","2024-09"
"001120","LX인터내셔널","1044867553100","29050","35967902","38760000","2792098","2024-09"
"108670","LX하우시스","360229248750","40250","8949795","8967670","17875","2024-09"
"383800","LX홀딩스","533644503000","7000","76234929","76280690","45761","2024-09"
"476080","M83","98713800000","12680","7785000","7785000","0","2024-09"
"086960","MDS테크","96720303096","1042","92821788","92821788","0","2024-09"
"023150","MH에탄올","37206472200","5800","6414909","7378526","963617","2024-09"
"038340","MIT","39924432729","1233","32379913","32424892","44979","2024-09"
"035420","NAVER","25378901603200","167800","151244944","160784508","9539564","2024-09"
"160550","NEW","64184043800","2300","27906106","27906106","0","2024-09"
"053290","NE능률","57181022220","3460","16526307","16526307","0","2024-09"
"181710","NHN","515829447600","15670","32918280","33766123","847843","2024-09"
"060250","NHN KCP","271824208510","7030","38666317","40160611","1494294","2024-09"
"104200","NHN벅스","46375568820","3430","13520574","14827550","1306976","2024-09"
"005940","NH투자증권","4424988823120","13540","326808628","327492299","683671","2024-09"
"034310","NICE","395402899100","11300","34991407","37503477","2512070","2024-09"
"030190","NICE평가정보","647433798700","11050","58591294","60107670","1516376","2024-09"
"008260","NI스틸","107679440505","3765","28600117","28600117","0","2024-09"
"004250","NPC","170554045950","5030","33907365","36720000","2812635","2024-09"
"222160","NPX","79551289560","8040","9894439","9894439","0","2024-09"
"456040","OCI","653532135000","73000","8952495","8952495","0","2024-09"
"010060","OCI홀딩스","1283106921600","67200","19093853","19563983","470130","2024-09"
"178920","PI첨단소재","568825657140","19370","29366322","29366322","0","2024-09"
"024940","PN풍년","58459789600","6220","9398680","10000000","601320","2024-09"
"005490","POSCO홀딩스","25370771354500","335500","75620779","82624377","7003598","2024-09"
"218410","RFHIC","369952002340","14380","25726843","26484442","757599","2024-09"
"327260","RF머트리얼즈","55315283080","6680","8280731","8433231","152500","2024-09"
"091340","S&K폴리텍","26826753915","2505","10709283","11703721","994438","2024-09"
"010950","S-Oil","6496027098400","57700","112582792","112582792","0","2024-09"
"419530","SAMG엔터","102323228000","12880","7944350","8590930","646580","2024-09"
"019550","SBI인베스트먼트","104259134741","647","161142403","162066575","924172","2024-09"
"034120","SBS","278411393940","15010","18548394","18551238","2844","2024-09"
"036120","SCI평가정보","76233384640","2240","34032761","35500000","1467239","2024-09"
"246960","SCL사이언스","63365588700","8700","7283401","7283401","0","2024-09"
"099220","SDN","65764578554","1214","54171811","56171811","2000000","2024-09"
"036540","SFA반도체","573057671505","3495","163964999","164460303","495304","2024-09"
"255220","SG","249174621225","2985","83475585","94073791","10598206","2024-09"
"040610","SG&G","52238941128","1548","33746086","34087196","341110","2024-09"
"049470","SGA","18832625630","322","58486415","58862249","375834","2024-09"
"184230","SGA솔루션즈","31055905986","498","62361257","62599161","237904","2024-09"
"016250","SGC E&C","50203816640","15520","3234782","3243585","8803","2024-09"
"005090","SGC에너지","403402776000","28000","14407242","14409333","2091","2024-09"
"001380","SG글로벌","137140636150","3050","44964143","44964143","0","2024-09"
"004060","SG세계물산","65397710644","329","198777236","202424960","3647724","2024-09"
"001770","SHD","21491191820","17690","1214878","1214878","0","2024-09"
"002360","SH에너지화학","55643993916","511","108892356","111133730","2241374","2024-09"
"009160","SIMPAC","211651112400","3900","54269516","65429516","11160000","2024-09"
"033530","SJG세종","121329561015","4485","27052299","27820961","768662","2024-09"
"123700","SJM","50949991970","3265","15604898","15604898","0","2024-09"
"025530","SJM홀딩스","48583887735","3585","13551991","14934008","1382017","2024-09"
"034730","SK","8101723861400","148600","54520349","72502703","17982354","2024-09"
"011790","SKC","4769416400000","140000","34067260","37868298","3801038","2024-09"
"018670","SK가스","1700771217000","189500","8975046","9230244","255198","2024-09"
"001740","SK네트웍스","985157237200","5080","193928590","221277902","27349312","2024-09"
"006120","SK디스커버리","578222292700","32650","17709718","18785855","1076137","2024-09"
"210980","SK디앤디","146615997080","7880","18606091","18617382","11291","2024-09"
"302440","SK바이오사이언스","4097563423900","52300","78347293","78347293","0","2024-09"
"326030","SK바이오팜","9287951450000","118600","78313250","78313250","0","2024-09"
"402340","SK스퀘어","12732932297000","95500","133329134","134749960","1420826","2024-09"
"361610","SK아이이테크놀로지","2195853352000","30800","71293940","71297592","3652","2024-09"
"100090","SK오션플랜트","738168732960","12470","59195568","59195568","0","2024-09"
"096770","SK이노베이션","10893098673600","114400","95219394","95735590","516196","2024-09"
"475150","SK이터닉스","503015935680","14940","33669072","33691895","22823","2024-09"
"001510","SK증권","207367007703","501","413906203","472590171","58683968","2024-09"
"285130","SK케미칼","815505546100","47350","17222926","17253783","30857","2024-09"
"017670","SK텔레콤","12240964665000","57500","212886342","214790053","1903711","2024-09"
"000660","SK하이닉스","138496784931000","201000","689038731","728002365","38963634","2024-09"
"048550","SM C&C","161235189360","1680","95973327","96714620","741293","2024-09"
"063440","SM Life Design","62461561978","1357","46029154","46029154","0","2024-09"
"003570","SNT다이내믹스","600155206800","26800","22393851","33252697","10858846","2024-09"
"064960","SNT모티브","551299363800","46050","11971756","14623136","2651380","2024-09"
"100840","SNT에너지","251163682680","12710","19761108","20680783","919675","2024-09"
"036530","SNT홀딩스","327511344300","22650","14459662","16303886","1844224","2024-09"
"067160","SOOP","947350404000","88900","10656360","11494767","838407","2024-09"
"005610","SPC삼립","397155927000","49000","8105223","8629009","523786","2024-09"
"011810","STX","153041447000","4940","30980050","31017927","37877","2024-09"
"465770","STX그린로지스","79304949000","11100","7144590","7171032","26442","2024-09"
"077970","STX엔진","454472234320","19760","22999607","23008904","9297","2024-09"
"002820","SUN&L","38903832900","3225","12063204","12607989","544785","2024-09"
"289080","SV인베스트먼트","83417678000","1567","53234000","53234000","0","2024-09"
"084870","TBH글로벌","28698982944","1376","20856819","20856819","0","2024-09"
"002710","TCC스틸","1188791158950","45350","26213697","26213697","0","2024-09"
"089230","THE E&M","28195896649","1289","21874241","21882953","8712","2024-09"
"032540","TJ미디어","73001631160","5240","13931609","13931609","0","2024-09"
"022220","TKG애강","52312524790","1010","51794579","51794579","0","2024-09"
"069260","TKG휴켐스","758208529520","19760","38370877","40878588","2507711","2024-09"
"007980","TP","64223694480","1320","48654314","51175130","2520816","2024-09"
"048770","TPC","36890278850","2350","15697991","15697991","0","2024-09"
"246690","TS인베스트먼트","40347560480","989","40796320","41477862","681542","2024-09"
"317240","TS트릴리온","29786621715","279","106762085","107240922","478837","2024-09"
"002900","TYM","130712492715","3045","42926927","45050956","2124029","2024-09"
"024070","WISCOM","32032255420","2090","15326438","15326438","0","2024-09"
"057030","YBM넷","56726136235","3505","16184347","16312697","128350","2024-09"
"037270","YG PLUS","385016518700","6070","63429410","63429410","0","2024-09"
"040300","YTN","128940000000","3070","42000000","42000000","0","2024-09"
"051390","YW","29793842280","3690","8074212","11355368","3281156","2024-09"
"052220","iMBC","56350000000","2450","23000000","23000000","0","2024-09"
"079940","가비아","169813387400","13100","12962854","13535684","572830","2024-09"
"078890","가온그룹","57202122720","3560","16068012","17410157","1342145","2024-09"
"000500","가온전선","274096515600","38450","7128648","7357946","229298","2024-09"
"399720","가온칩스","423344592000","36850","11488320","11488320","0","2024-09"
"036620","감성코퍼레이션","335302375940","3695","90744892","90744892","0","2024-09"
"000860","강남제비스코","162500000000","25000","6500000","6500000","0","2024-09"
"198440","강동씨앤엘","88002727104","1446","60859424","60931896","72472","2024-09"
"217730","강스템바이오텍","119675608115","2135","56054149","56054149","0","2024-09"
"035250","강원랜드","3292481327520","16240","202738998","213940500","11201502","2024-09"
"114190","강원에너지","324709362340","12430","26123038","26123038","0","2024-09"
"094480","갤럭시아머니트리","314623300760","8020","39229838","39229838","0","2024-09"
"011420","갤럭시아에스엠","65292656280","2370","27549644","27549644","0","2024-09"
"039240","경남스틸","75947585260","2815","26979604","26979604","0","2024-09"
"053950","경남제약","22886372945","643","35593115","35593402","287","2024-09"
"002100","경농","164176133500","9190","17864650","19522575","1657925","2024-09"
"009450","경동나비엔","1300763880000","90000","14452932","14568592","115660","2024-09"
"267290","경동도시가스","110092080630","18690","5890427","5895406","4979","2024-09"
"012320","경동인베스트","163090329600","74800","2180352","2365023","184671","2024-09"
"011040","경동제약","169733151000","6300","26941770","30768766","3826996","2024-09"
"000050","경방","161700102300","6490","24915270","27415270","2500000","2024-09"
"214390","경보제약","177867038400","7440","23906860","23906860","0","2024-09"
"012610","경인양행","121201917060","2930","41365842","41616365","250523","2024-09"
"009140","경인전자","27092769600","20800","1302537","1570797","268260","2024-09"
"024910","경창산업","78640374800","2210","35583880","35819005","235125","2024-09"
"013580","계룡건설","118074434010","13330","8857797","8930907","73110","2024-09"
"012200","계양전기","41228611464","1516","27195654","27222829","27175","2024-09"
"002140","고려산업","79565329500","3225","24671420","24939425","268005","2024-09"
"049720","고려신용정보","138420623040","9940","13925616","14300000","374384","2024-09"
"010130","고려아연","25753383887000","1253000","20553379","20703283","149904","2024-09"
"002240","고려제강","475520935890","19030","24987963","25000000","12037","2024-09"
"014570","고려제약","51843494645","4805","10789489","11000000","210511","2024-09"
"348150","고바이오랩","136585642500","7050","19373850","19373850","0","2024-09"
"098460","고영","648063689800","9850","65793268","68654755","2861487","2024-09"
"035290","골드앤에스","21025327680","441","47676480","47676480","0","2024-09"
"215000","골프존","399939660000","66600","6005100","6275415","270315","2024-09"
"121440","골프존뉴딘홀딩스","156224638570","3835","40736542","42836818","2100276","2024-09"
"366030","공구우먼","95146170000","4200","22653850","22653850","0","2024-09"
"009290","광동제약","223649814960","5580","40080612","52420851","12340239","2024-09"
"014200","광림","87868591200","30200","2909556","3023556","114000","2024-09"
"017040","광명전기","60282622465","1391","43337615","43337615","0","2024-09"
"029480","광무","203668673910","3705","54971302","55009083","37781","2024-09"
"017900","광전자","89294951799","1773","50363763","57943763","7580000","2024-09"
"037710","광주신세계","223094781000","29250","7627172","7957190","330018","2024-09"
"026910","광진실업","14059863975","2195","6405405","6405405","0","2024-09"
"421800","교보12호스팩","16205800000","2710","5980000","5980000","0","2024-06"
"440790","교보13호스팩","8869500000","2190","4050000","4050000","0","2024-09"
"456490","교보14호스팩","9009000000","2145","4200000","4200000","0","2024-09"
"465320","교보15호스팩","8229600000","2160","3810000","3810000","0","2024-09"
"482520","교보16호스팩","12505000000","2050","6100000","6100000","0","2024-09"
"030610","교보증권","624167577390","5530","112869363","113962961","1093598","2024-09"
"339770","교촌에프앤비","256820511200","10280","24982540","24982540","0","2024-09"
"053270","구영테크","57775209440","2215","26083616","27410405","1326789","2024-09"
"007690","국도화학","280658969100","33650","8340534","9010616","670082","2024-09"
"005320","국동","28008959382","423","66215034","67327897","1112863","2024-09"
"001140","국보","33448047050","2110","15852155","15856388","4233","2024-09"
"066620","국보디자인","109520475480","16570","6609564","7500000","890436","2024-09"
"043650","국순당","79331948640","5040","15740466","17858304","2117838","2024-09"
"006050","국영지앤엠","62536723335","1845","33895243","34895243","1000000","2024-09"
"060480","국일신동","21414790000","1931","11090000","11090000","0","2024-09"
"078130","국일제지","901924696800","800","1127405871","1127405871","0","2024-09"
"307750","국전약품","203882326560","4155","49069152","49069269","117","2024-09"
"002720","국제약품","105681385380","5190","20362502","21159832","797330","2024-09"
"035080","그래디언트","150491286000","11000","13681026","14527584","846558","2024-09"
"453450","그리드위즈","153771640000","19360","7942750","7942750","0","2024-09"
"204020","그리티","55860423030","2790","20021657","20147430","125773","2024-09"
"402490","그린리소스","131180531280","15870","8265944","8265944","0","2024-09"
"114450","그린생명과학","38747564100","2030","19087470","20000000","912530","2024-09"
"083420","그린케미칼","132260257080","5670","23326324","24000000","673676","2024-09"
"186230","그린플러스","94513654400","8800","10740188","10820188","80000","2024-09"
"014530","극동유화","125755283700","3735","33669420","34869420","1200000","2024-09"
"204620","글로벌텍스프리","237738528670","3890","61115303","61116035","732","2024-09"
"019660","글로본","18787002840","540","34790746","34790746","0","2024-09"
"014280","금강공업","107488468000","4000","26872117","29329357","2457240","2024-09"
"053260","금강철강","73761114880","4640","15896792","18720000","2823208","2024-09"
"008870","금비","44526400000","54400","818500","1000000","181500","2024-09"
"001570","금양","2505274025750","43250","57925411","58050037","124626","2024-09"
"282720","금양그린파워","123203049000","10210","12066900","12119500","52600","2024-09"
"002990","금호건설","103019694680","2870","35895364","36953595","1058231","2024-09"
"011780","금호석유","3253538700100","141700","22960753","27334587","4373834","2024-09"
"214330","금호에이치티","121433321068","596","203747183","213914131","10166948","2024-09"
"001210","금호전기","36696060680","860","42669838","43535722","865884","2024-09"
"073240","금호타이어","1192130191050","4150","287260287","287260287","0","2024-09"
"036190","금화피에스시","160932777500","27250","5905790","6000000","94210","2024-09"
"049080","기가레인","56954478658","671","84879998","84883347","3349","2024-09"
"420770","기가비스","463932742800","36600","12675758","12675758","0","2024-09"
"035460","기산텔레콤","26807728260","1839","14577340","14577340","0","2024-09"
"092440","기신정기","75190000000","2575","29200000","29200000","0","2024-09"
"000270","기아","36323127582300","92700","391835249","399858417","8023168","2024-09"
"024110","기업은행","11738108762240","14720","797425867","797425869","2","2024-09"
"013700","까뮤이앤씨","77078570700","1290","59750830","59750830","0","2024-09"
"308100","까스텔바작","19768830095","3065","6449863","6624733","174870","2024-09"
"004540","깨끗한나라","75595671410","2030","37239247","37240693","1446","2024-09"
"407400","꿈비","68644717500","5820","11794625","12259474","464849","2024-09"
"187790","나노","31435070025","1025","30668361","30840830","172469","2024-09"
"286750","나노브릭","49664817600","2400","20693674","20694559","885","2024-09"
"121600","나노신소재","1014595705600","84800","11964572","12196078","231506","2024-09"
"247660","나노씨엠에스","34212328020","8010","4271202","4343920","72718","2024-09"
"039860","나노엔텍","136628398910","4255","32110082","32110082","0","2024-09"
"091970","나노캠텍","22406589820","620","36139661","37417493","1277832","2024-09"
"417010","나노팀","184619710080","9360","19724328","19724328","0","2024-09"
"405920","나라셀라","45751206240","3680","12432393","12878076","445683","2024-09"
"051490","나라엠앤디","64716039500","4900","13207355","14200000","992645","2024-09"
"137080","나래나노텍","34837179300","3150","11059422","11059422","0","2024-09"
"190510","나무가","184607399040","11680","15805428","16264384","458956","2024-09"
"242040","나무기술","57791116352","1744","33137108","34606264","1469156","2024-09"
"089600","나스미디어","174341125980","15420","11306169","11568163","261994","2024-09"
"293580","나우IB","89425072800","944","94729950","94929950","200000","2024-09"
"138610","나이벡","191427907800","18600","10291823","10291823","0","2024-09"
"130580","나이스디앤비","77924000000","5060","15400000","15400000","0","2024-09"
"036800","나이스정보통신","164455312500","18750","8770950","10000000","1229050","2024-09"
"267320","나인테크","95919005650","2210","43402265","43664104","261839","2024-09"
"001260","남광토건","60710552520","6180","9823714","9832572","8858","2024-09"
"008350","남선알미늄","173353217870","1343","129079090","129079090","0","2024-09"
"004270","남성","40562620665","1295","31322487","36212160","4889673","2024-09"
"003920","남양유업","433040103000","659000","657117","679731","22614","2024-09"
"025860","남해화학","305433187150","6370","47948695","49678843","1730148","2024-09"
"111710","남화산업","105410560000","5120","20588000","20588000","0","2024-09"
"091590","남화토건","46725200000","3980","11740000","11740000","0","2024-09"
"168330","내츄럴엔도텍","48086198343","1523","31573341","31754900","181559","2024-09"
"094860","네오리진","28975420270","1355","21384074","21399569","15495","2024-09"
"253590","네오셈","471739588200","11100","42499062","43869164","1370102","2024-09"
"212560","네오오토","66854988930","8490","7874557","7874963","406","2024-09"
"095660","네오위즈","388026468470","19490","19909003","22033719","2124716","2024-09"
"042420","네오위즈홀딩스","126853805390","19510","6501989","8856866","2354877","2024-09"
"311390","네오크레마","77430182310","7110","10890321","10979147","88826","2024-09"
"085910","네오티스","45884049820","3430","13377274","13934818","557544","2024-09"
"092730","네오팜","210374893200","26900","7820628","8207361","386733","2024-09"
"290660","네오펙트","39686001246","942","42129513","42129513","0","2024-09"
"306620","네온테크","88723852560","2170","40886568","42608149","1721581","2024-09"
"153460","네이블","40014600000","6250","6402336","6530014","127678","2024-09"
"007390","네이처셀","967931626240","15040","64357156","64357156","0","2024-09"
"033640","네패스","170091355280","7480","22739486","23059202","319716","2024-09"
"330860","네패스아크","150472955750","12350","12184045","12184045","0","2024-09"
"005720","넥센","225031716450","4645","48446010","53543977","5097967","2024-09"
"002350","넥센타이어","668335810700","6950","96163426","97667877","1504451","2024-09"
"089140","넥스턴바이오","55365862130","4910","11276143","11282627","6484","2024-09"
"389650","넥스트바이오메디컬","281416672800","34800","8086686","8086686","0","2024-09"
"137940","넥스트아이","33534060516","438","76561782","78320992","1759210","2024-09"
"396270","넥스트칩","241487349000","13350","18088940","18088940","0","2024-09"
"348210","넥스틴","697722255000","67500","10336626","10437250","100624","2024-09"
"092790","넥스틸","229857680000","8840","26002000","26002000","0","2024-09"
"225570","넥슨게임즈","930752834850","14550","63969267","65860174","1890907","2024-09"
"217270","넵튠","228822980100","5100","44867251","46676150","1808899","2024-09"
"251270","넷마블","4588335976000","56000","81934571","85953502","4018931","2024-09"
"104620","노랑풍선","69388511880","4380","15842126","15842126","0","2024-09"
"090350","노루페인트","168000000000","8400","20000000","20000000","0","2024-09"
"000320","노루홀딩스","137742433920","13440","10248693","13291151","3042458","2024-09"
"194700","노바렉스","173658738960","9810","17702216","18754848","1052632","2024-09"
"285490","노바텍","114457306890","11530","9926913","10575831","648918","2024-09"
"145170","노브랜드","102827049600","12400","8292504","9079834","787330","2024-09"
"106520","노블엠앤비","15902299386","411","38691726","38695952","4226","2024-09"
"376930","노을","103451768000","2800","36947060","36947060","0","2024-09"
"006280","녹십자","1855782742800","162600","11413178","11686538","273360","2024-09"
"142280","녹십자엠에스","86502100110","3985","21706926","21741926","35000","2024-09"
"234690","녹십자웰빙","198390955880","11180","17745166","17752276","7110","2024-09"
"005250","녹십자홀딩스","700074680200","15580","44934190","47028210","2094020","2024-09"
"004370","농심","2070179034000","358000","5782623","6082642","300019","2024-09"
"072710","농심홀딩스","310731930000","67000","4637790","4637790","0","2024-09"
"054050","농우바이오","114137594320","7120","16030561","16030561","0","2024-09"
"069140","누리플랜","17769385701","1359","13075339","13102743","27404","2024-09"
"040160","누리플렉스","27793043100","2460","11297985","12055535","757550","2024-09"
"332290","누보","38071537387","1157","32905391","33384803","479412","2024-09"
"348340","뉴로메카","216785443500","20550","10549170","10549170","0","2024-09"
"060260","뉴보텍","13342356000","1000","13342356","13512009","169653","2024-09"
"123840","뉴온","58742215382","226","259921307","292370108","32448801","2024-09"
"012340","뉴인텍","26266253988","516","50903593","50907162","3569","2024-09"
"214870","뉴지랩파마","64715071880","6920","9351889","9359221","7332","2024-09"
"270870","뉴트리","76456191000","8500","8994846","9200224","205378","2024-09"
"144960","뉴파워프라즈마","193628771655","4785","40465783","43692624","3226841","2024-09"
"085670","뉴프렉스","132276036440","5410","24450284","24450761","477","2024-09"
"064260","다날","202716739825","3035","66792995","68949040","2156045","2024-09"
"340360","다보링크","107168883640","2470","43388212","43388212","0","2024-09"
"039560","다산네트웍스","133070441920","3440","38683268","39505981","822713","2024-09"
"154040","다산솔루에타","30730560928","1712","17950094","17950094","0","2024-09"
"058730","다스코","58452686600","3215","18181240","18796941","615701","2024-09"
"030210","다올투자증권","170610943680","2880","59239911","60911106","1671195","2024-09"
"023590","다우기술","784482434820","18180","43150849","44866617","1715768","2024-09"
"032190","다우데이타","430492000000","11240","38300000","38300000","0","2024-09"
"323350","다원넥스뷰","48055081200","6330","7591640","7596111","4471","2024-09"
"068240","다원시스","404532432200","10600","38163437","38163437","0","2024-09"
"145210","다이나믹디자인","94697655120","2740","34561188","34581687","20499","2024-09"
"019680","대교","152622671670","2265","67383078","84702850","17319772","2024-09"
"006370","대구백화점","59915599200","7200","8321611","10821611","2500000","2024-09"
"008060","대덕","209780028500","6190","33890150","33890150","0","2024-09"
"353200","대덕전자","781775753500","15820","49416925","49416925","0","2024-09"
"000490","대동","187606748520","7960","23568687","25640788","2072101","2024-09"
"020400","대동금속","20027962480","6280","3189166","3189166","0","2024-09"
"008830","대동기어","65339270400","7270","8987520","8987520","0","2024-09"
"048470","대동스틸","34468324455","3665","9404727","10000000","595273","2024-09"
"008110","대동전자","105136322880","15040","6990447","10490447","3500000","2024-09"
"004780","대륙제관","64726019930","4070","15903199","15903199","0","2024-09"
"005750","대림B&Co","58019395200","3480","16672240","16672240","0","2024-09"
"017650","대림제지","58345000000","7000","8335000","9000000","665000","2024-09"
"006570","대림통상","39619561360","2630","15064472","15225000","160528","2024-09"
"007720","대명소노시즌","121162140900","1202","100800450","100800450","0","2024-09"
"389260","대명에너지","201360500000","11810","17050000","17050000","0","2024-09"
"317850","대모","81662560200","9810","8324420","8324420","0","2024-09"
"290670","대보마그네틱","120215984480","16090","7471472","7857660","386188","2024-09"
"078140","대봉엘에스","192797256090","17610","10948169","11086579","138410","2024-09"
"065150","대산F&B","18113400725","145","124920005","125282405","362400","2024-09"
"001680","대상","682219612250","19690","34648025","34648025","0","2024-09"
"084690","대상홀딩스","297667062360","8220","36212538","36212538","0","2024-09"
"036480","대성미생물","38266000000","10070","3800000","3800000","0","2024-09"
"128820","대성산업","128677209090","3435","37460614","45235478","7774864","2024-09"
"117580","대성에너지","255084841480","9380","27194546","27500000","305454","2024-09"
"027830","대성창투","76248000000","1412","54000000","54000000","0","2024-09"
"104040","대성파인텍","44168684172","948","46591439","47224987","633548","2024-09"
"129920","대성하이텍","56780319420","4140","13715053","13715053","0","2024-09"
"016710","대성홀딩스","125327966060","7790","16088314","16089459","1145","2024-09"
"438220","대신밸런스제13호스팩","15679200000","2780","5640000","5640000","0","2024-09"
"442310","대신밸런스제14호스팩","15198150000","2265","6710000","6710000","0","2024-09"
"457390","대신밸런스제15호스팩","16778475000","2385","7035000","7035000","0","2024-09"
"457630","대신밸런스제16호스팩","16228200000","2220","7310000","7310000","0","2024-09"
"471050","대신밸런스제17호스팩","12847200000","2120","6060000","6060000","0","2024-09"
"478780","대신밸런스제18호스팩","16294600000","2060","7910000","7910000","0","2024-09"
"020180","대신정보통신","33356298220","868","38428915","38428915","0","2024-09"
"003540","대신증권","642586651040","17120","37534267","50773400","13239133","2024-09"
"045390","대아티아이","180411845120","2560","70473377","70473377","0","2024-09"
"009190","대양금속","72342891684","1708","42355323","42359986","4663","2024-09"
"108380","대양전기공업","104084197120","11260","9243712","9567333","323621","2024-09"
"014160","대영포장","94973315721","997","95259093","108394549","13135456","2024-09"
"047040","대우건설","1487406306400","3620","410885720","415622638","4736918","2024-09"
"003090","대웅","1028401356500","25150","40890710","58141980","17251270","2024-09"
"069620","대웅제약","1759308683000","152900","11506270","11586575","80305","2024-09"
"007680","대원","56340726060","4190","13446474","13446474","0","2024-09"
"000430","대원강업","236840000000","3820","62000000","62000000","0","2024-09"
"048910","대원미디어","96191935440","7960","12084414","12578946","494532","2024-09"
"005710","대원산업","119023344000","5940","20037600","20037600","0","2024-09"
"006340","대원전선","209566794125","2795","74979175","74979175","0","2024-09"
"003220","대원제약","307569849650","14350","21433439","22427583","994144","2024-09"
"024890","대원화성","40841111184","1002","40759592","41249152","489560","2024-09"
"290380","대유","56838037000","2300","24712190","24713612","1422","2024-09"
"002880","대유에이텍","49489348968","1059","46732152","46744020","11868","2024-09"
"000300","대유플러스","156936737152","1984","79101178","79101178","0","2024-09"
"120240","대정화금","97555397600","13600","7173191","7190391","17200","2024-09"
"003310","대주산업","50858806950","1437","35392350","35392350","0","2024-09"
"078600","대주전자재료","1540888398000","102900","14974620","15480593","505973","2024-09"
"012800","대창","94255355610","1235","76320126","91140499","14820373","2024-09"
"015230","대창단조","130608209200","5180","25213940","28572230","3358290","2024-09"
"096350","대창솔루션","54431105418","342","159155279","163761009","4605730","2024-09"
"140520","대창스틸","46015082480","2180","21107836","21109243","1407","2024-09"
"131220","대한과학","35696981630","4790","7452397","7454490","2093","2024-09"
"010170","대한광통신","77268079142","1037","74511166","74511166","0","2024-09"
"054670","대한뉴팜","107510313740","7660","14035289","14354920","319631","2024-09"
"001070","대한방직","21168165900","5860","3612315","5300000","1687685","2024-09"
"023910","대한약품","148470000000","25250","5880000","6000000","120000","2024-09"
"006650","대한유화","617610000000","100000","6176100","6500000","323900","2024-09"
"001440","대한전선","2162212574160","11640","185757094","186447300","690206","2024-09"
"084010","대한제강","227153130540","13020","17446477","23414397","5967920","2024-09"
"001790","대한제당","252137163000","2850","88469180","89696580","1227400","2024-09"
"001130","대한제분","222759673800","135400","1645197","1690000","44803","2024-09"
"003490","대한항공","8579540282900","23300","368220613","368220661","48","2024-09"
"005880","대한해운","563986571820","1767","319177460","319177460","0","2024-09"
"003830","대한화섬","132911462000","118600","1120670","1328000","207330","2024-09"
"016090","대현","91442970150","2065","44282310","44282310","0","2024-09"
"069460","대호에이엘","75097960980","1113","67473460","67544896","71436","2024-09"
"021040","대호특수강","28372608574","1549","18316726","21704774","3388048","2024-09"
"067080","대화제약","329313020000","18800","17516650","18616650","1100000","2024-09"
"298540","더네이쳐홀딩스","143405260340","9820","14603387","14765856","162469","2024-09"
"032860","더라미","72842991120","1808","40289265","40395863","106598","2024-09"
"192080","더블유게임즈","995242961400","50200","19825557","21495906","1670349","2024-09"
"393890","더블유씨피","522632994180","15510","33696518","33696518","0","2024-09"
"299170","더블유에스아이","45342201480","1510","30027948","30027963","15","2024-09"
"012510","더존비즈온","1513558062000","54000","28028853","30382784","2353931","2024-09"
"224060","더코디","21929607045","4645","4721121","4748398","27277","2024-09"
"043090","더테크놀로지","30062751404","404","74412751","74412751","0","2024-09"
"213420","덕산네오룩스","633723207000","25800","24562915","24831179","268264","2024-09"
"317330","덕산테코피아","727942561200","35550","20476584","20476584","0","2024-09"
"077360","덕산하이메탈","207874284150","4575","45437002","45437002","0","2024-09"
"004830","덕성","89545932250","6470","13840175","15680000","1839825","2024-09"
"090410","덕신이피씨","64241144790","1394","46084035","46084095","60","2024-09"
"024900","덕양산업","110415909900","3405","32427580","32564980","137400","2024-09"
"263600","덕우전자","89209736000","5600","15930310","15930310","0","2024-09"
"194480","데브시스터즈","370880522400","34350","10797104","12035480","1238376","2024-09"
"263800","데이타솔루션","68202492900","4205","16219380","16219380","0","2024-09"
"206560","덱스터","204762782620","8140","25155133","25411736","256603","2024-09"
"261200","덴티스","106639218500","6980","15277825","15809700","531875","2024-09"
"145720","덴티움","647654214100","75100","8623891","11068830","2444939","2024-09"
"067990","도이치모터스","137265643250","4625","29679058","30181550","502492","2024-09"
"002150","도화엔지니어링","220418361500","6620","33295825","33720000","424175","2024-09"
"006620","동구바이오제약","147786549100","5450","27116798","28464992","1348194","2024-09"
"100130","동국S&C","137662295810","2470","55733723","57143000","1409277","2024-09"
"005160","동국산업","338000136160","6560","51524411","54244482","2720071","2024-09"
"460850","동국씨엠","189537441600","6350","29848416","29898656","50240","2024-09"
"075970","동국알앤에스","44252000000","2405","18400000","18400000","0","2024-09"
"460860","동국제강","416715853220","8410","49550042","49608017","57975","2024-09"
"086450","동국제약","756694787200","17210","43968320","44460000","491680","2024-09"
"001230","동국홀딩스","247879297710","7970","31101543","31800483","698940","2024-09"
"023450","동남합성","112468455000","32450","3465900","3500000","34100","2024-09"
"004140","동방","110406001860","2310","47794806","47971766","176960","2024-09"
"099410","동방선기","41838165000","3000","13946055","14000000","53945","2024-09"
"007590","동방아그로","77659625660","6260","12405691","13617577","1211886","2024-09"
"005960","동부건설","91768216000","4000","22942054","22946345","4291","2024-09"
"026960","동서","2037587599950","20650","98672523","99700000","1027477","2024-09"
"002210","동성제약","102210966360","4470","22865988","26100970","3234982","2024-09"
"102260","동성케미컬","207732531570","4265","48706338","49689728","983390","2024-09"
"033500","동성화인텍","312396468040","10760","29033129","29989494","956365","2024-09"
"025950","동신건설","166320000000","19800","8400000","8400000","0","2024-09"
"000640","동아쏘시오홀딩스","754462266100","120700","6250723","6348913","98190","2024-09"
"170900","동아에스티","660768876800","73600","8977838","9167274","189436","2024-09"
"088130","동아엘텍","78946192710","9030","8742657","8742657","0","2024-09"
"028100","동아지질","171973058400","12980","13249080","14052646","803566","2024-09"
"041930","동아화성","101109854220","6810","14847262","15800000","952738","2024-09"
"001520","동양","143302067565","755","189804063","238684063","48880000","2024-09"
"084670","동양고속","21863420000","8380","2609000","2895569","286569","2024-09"
"082640","동양생명","890447451730","5710","155945263","161358585","5413322","2024-09"
"060380","동양에스텍","27792000000","1440","19300000","19700000","400000","2024-09"
"079960","동양이엔피","144375949300","18700","7720639","7860000","139361","2024-09"
"008970","동양철관","115579658144","736","157037579","157052160","14581","2024-09"
"228340","동양파일","40100000000","2005","20000000","20000000","0","2024-09"
"092780","동양피스톤","72696568320","5760","12620932","13168460","547528","2024-09"
"088910","동우팜투테이블","50774762136","1974","25721764","25831764","110000","2024-09"
"094170","동운아나텍","344334982320","18270","18847016","19067208","220192","2024-09"
"049770","동원F&B","605882468000","31400","19295620","19295620","0","2024-09"
"013120","동원개발","228836412000","2520","90808100","90808100","0","2024-09"
"018500","동원금속","57449365345","1229","46744805","46754933","10128","2024-09"
"006040","동원산업","1197728008750","33250","36021895","36021895","0","2024-09"
"030720","동원수산","25828617750","5550","4653805","4653805","0","2024-09"
"014820","동원시스템즈","1458261484600","50300","28991282","28991282","0","2024-09"
"111380","동인기연","113669593350","19150","5935749","6128000","192251","2024-09"
"163560","동일고무벨트","101470000000","7300","13900000","13900000","0","2024-09"
"109860","동일금속","73087704000","8640","8459225","9100000","640775","2024-09"
"032960","동일기연","41684708360","11030","3779212","3986323","207111","2024-09"
"004890","동일산업","85126590300","39300","2166071","2425215","259144","2024-09"
"002690","동일제강","27663158880","1458","18973360","20300360","1327000","2024-09"
"023790","동일철강","25905116956","1244","20824049","20841335","17286","2024-09"
"005290","동진쎄미켐","1375337714500","26750","51414494","51414494","0","2024-09"
"025900","동화기업","499035160980","10910","45741078","50557285","4816207","2024-09"
"000020","동화약품","208161654300","7510","27717930","27931470","213540","2024-09"
"000150","두산","2785731614000","206000","13522969","16523835","3000866","2024-09"
"454910","두산로보틱스","4291082676000","66200","64819980","64819980","0","2024-09"
"241560","두산밥캣","3783485500200","37800","100092209","100249166","156957","2024-09"
"034020","두산에너빌리티","13193582460800","20600","640465168","640561146","95978","2024-09"
"131970","두산테스나","488926182900","28900","16917861","17006566","88705","2024-09"
"336260","두산퓨얼셀","1113205543000","17000","65482679","65493726","11047","2024-09"
"016740","두올","106225721580","3410","31151238","32066680","915442","2024-09"
"073190","듀오백","28156449710","2545","11063438","11968040","904602","2024-09"
"030350","드래곤플라이","16445186601","237","69388973","69388973","0","2024-09"
"203650","드림시큐리티","155022452820","3180","48749199","50605754","1856555","2024-09"
"223250","드림씨아이에스","105787995180","4445","23799324","23799324","0","2024-09"
"060570","드림어스컴퍼니","186029069580","2460","75621573","75621573","0","2024-09"
"362990","드림인사이트","36401535360","2220","16397088","16800574","403486","2024-09"
"192650","드림텍","558368873190","8270","67517397","68883113","1365716","2024-09"
"217620","디딤이앤에프","21715711458","381","56996618","57747210","750592","2024-09"
"016670","디모아","17471181480","3540","4935362","4941846","6484","2024-09"
"187870","디바이스이엔지","86374950100","12850","6721786","7036609","314823","2024-09"
"024090","디씨엠","105976011240","12210","8679444","11400000","2720556","2024-09"
"003160","디아이","528140410700","20300","26016769","28300000","2283231","2024-09"
"092200","디아이씨","141422443750","3650","38745875","38888569","142694","2024-09"
"110990","디아이티","254788408380","13820","18436209","18900000","463791","2024-09"
"263690","디알젬","77709604680","7090","10960452","11325610","365158","2024-09"
"214680","디알텍","207541459960","2815","73726984","73727108","124","2024-09"
"347850","디앤디파마텍","456326965700","43300","10538729","10538729","0","2024-09"
"263720","디앤씨미디어","216972090680","17480","12412591","12524473","111882","2024-09"
"376300","디어유","564974062800","23800","23738406","23738406","0","2024-09"
"109740","디에스케이","126520214600","5020","25203230","25710390","507160","2024-09"
"196490","디에이테크놀로지","36209568780","203","178372260","178549360","177100","2024-09"
"066900","디에이피","42417188130","2410","17600493","22744503","5144010","2024-09"
"127120","디엔에이링크","80154900295","3565","22483843","22483843","0","2024-09"
"092070","디엔에프","118264388760","10220","11571858","11571858","0","2024-09"
"039840","디오","230798248360","15970","14451988","14981755","529767","2024-09"
"013570","디와이","112738202870","4570","24669191","26319633","1650442","2024-09"
"219550","디와이디","40349406574","514","78500791","78500791","0","2024-09"
"310870","디와이씨","25940603898","1254","20686287","20687271","984","2024-09"
"210540","디와이파워","136072042830","12330","11035851","11041708","5857","2024-09"
"104460","디와이피엔에프","93567092960","9680","9666022","10713625","1047603","2024-09"
"079810","디이엔티","157776197980","7220","21852659","22028094","175435","2024-09"
"113810","디젠스","28288520217","867","32628051","32628051","0","2024-09"
"043360","디지아이","18504785675","2075","8917969","9000000","82031","2024-09"
"197140","디지캡","32990552400","2600","12688674","13013154","324480","2024-09"
"068930","디지털대성","194168676000","7410","26203600","27675342","1471742","2024-09"
"033130","디지틀조선","61240190550","1650","37115267","37115267","0","2024-09"
"105740","디케이락","72196442300","7100","10168513","10168513","0","2024-09"
"263020","디케이앤디","51558614415","3465","14879831","15069831","190000","2024-09"
"290550","디케이티","158009717000","7900","20001230","20001230","0","2024-09"
"066670","디티씨","51566727690","3285","15697634","18691918","2994284","2024-09"
"187220","디티앤씨","40683013490","3530","11524933","11698021","173088","2024-09"
"383930","디티앤씨알오","97055891200","7600","12770512","12770512","0","2024-09"
"131180","딜리","27898008444","1004","27786861","29350000","1563139","2024-09"
"315640","딥노이드","144392965920","6440","22421268","22421268","0","2024-09"
"223310","딥마인드","50691719760","2220","22834108","22839375","5267","2024-09"
"317120","라닉스","33334643400","3460","9634290","9660000","25710","2024-09"
"462510","라메디텍","96282680550","11130","8650735","8650735","0","2024-09"
"042510","라온시큐어","100440767320","1858","54058540","56025871","1967331","2024-09"
"232680","라온테크","83306247640","6830","12197108","12534234","337126","2024-09"
"418420","라온텍","95801454760","3190","30031804","30108433","76629","2024-09"
"300120","라온피플","99919457480","4790","20860012","20860012","0","2024-09"
"171120","라이온켐텍","83121373500","2355","35295700","35901760","606060","2024-09"
"388790","라이콤","90339519690","3030","29815023","29913930","98907","2024-09"
"347700","라이프시맨틱스","70980180350","3550","19994417","19994417","0","2024-09"
"214260","라파스","147224565550","17530","8398435","8912435","514000","2024-09"
"115390","락앤락","373800441360","8630","43314072","43326411","12339","2024-09"
"200350","래몽래인","132747212000","13280","9996025","9996025","0","2024-09"
"171010","램테크놀러지","51975963520","3635","14298752","14298752","0","2024-09"
"084650","랩지노믹스","245734366900","3310","74239990","74239990","0","2024-09"
"217500","러셀","49023307060","1690","29007874","31812000","2804126","2024-09"
"038390","레드캡투어","132094493800","15800","8360411","8589480","229069","2024-09"
"294140","레몬","91954959540","4380","20994283","21000000","5717","2024-09"
"443250","레뷰코퍼레이션","100430083200","9320","10775760","11279386","503626","2024-09"
"228670","레이","128610608200","8300","15495254","15495254","0","2024-09"
"228850","레이언스","107637249600","6840","15736440","16591014","854574","2024-09"
"412350","레이저쎌","43329415980","4965","8726972","8726972","0","2024-09"
"199550","레이저옵텍","79023361140","6780","11655363","11656947","1584","2024-09"
"281740","레이크머티리얼즈","925485580800","14080","65730510","65730548","38","2024-09"
"277810","레인보우로보틱스","2366782676000","122000","19399858","19399858","0","2024-09"
"215100","로보로보","63376193050","3130","20247985","20348454","100469","2024-09"
"090360","로보스타","197437500000","20250","9750000","9750000","0","2024-09"
"108490","로보티즈","221581884700","17180","12897665","13053665","156000","2024-09"
"067730","로지시스","25103827590","2595","9673922","9673922","0","2024-09"
"071280","로체시스템즈","276096437190","18510","14916069","15296603","380534","2024-09"
"032350","롯데관광개발","722339814840","9480","76196183","76196183","0","2024-09"
"089860","롯데렌탈","1037051998650","28550","36324063","36634063","310000","2024-09"
"000400","롯데손해보험","678496515850","2195","309110030","310336320","1226290","2024-09"
"023530","롯데쇼핑","1781050320000","63000","28270640","28288755","18115","2024-09"
"020150","롯데에너지머티리얼즈","1713017520250","37150","46110835","46110835","0","2024-09"
"280360","롯데웰푸드","1148480583300","129900","8841267","9434574","593307","2024-09"
"286940","롯데이노베이트","337384884100","22300","15129367","15129367","0","2024-09"
"004000","롯데정밀화학","1148697000000","45100","25470000","25800000","330000","2024-09"
"004990","롯데지주","1681625875000","23750","70805300","104909237","34103937","2024-09"
"005300","롯데칠성","1092124646800","117700","9278884","9278884","0","2024-09"
"011170","롯데케미칼","3849860521100","91300","42167147","42775419","608272","2024-09"
"071840","롯데하이마트","182772124800","7900","23135712","23607712","472000","2024-09"
"328130","루닛","1089961488000","37750","28873152","28873152","0","2024-09"
"038060","루멘스","59647805560","1240","48103069","48103069","0","2024-09"
"474170","루미르","159710219760","9310","17154696","17154696",,"자료 없음"
"141080","리가켐바이오","4589845848000","126000","36427348","36567348","140000","2024-09"
"058470","리노공업","2741349072000","180600","15179120","15242370","63250","2024-09"
"016100","리더스코스메틱","48039866740","2620","18335827","19100894","765067","2024-09"
"012700","리드코프","110185837860","4305","25594852","26446135","851283","2024-09"
"302550","리메드","105088614400","3430","30638080","30638080","0","2024-09"
"073570","리튬포어스","58981757010","1630","36185127","36189497","4370","2024-09"
"377450","리파인","205421441400","13510","15205140","17330000","2124860","2024-09"
"277070","린드먼아시아","50171022000","3960","12669450","13692000","1022550","2024-09"
"042500","링네트","73826826360","4585","16101816","19070134","2968318","2024-09"
"193250","링크드","27419022241","433","63323377","63323377","0","2024-09"
"219420","링크제니시스","47213705615","4195","11254757","11469507","214750","2024-09"
"439090","마녀공장","294808680000","18000","16378260","16378260","0","2024-09"
"027740","마니커","58167115688","916","63501218","63511228","10010","2024-09"
"195500","마니커에프앤지","45776970000","2865","15978000","15978000","0","2024-09"
"377480","마음AI","63203561980","10130","6239246","6239246","0","2024-09"
"305090","마이크로디지탈","216633259000","13100","16536890","16536890","0","2024-09"
"098120","마이크로컨텍솔","43060127880","5180","8312766","8312766","0","2024-09"
"424980","마이크로투나노","53329198900","9010","5918890","5918890","0","2024-09"
"038290","마크로젠","175332031490","17570","9979057","10841400","862343","2024-09"
"001080","만호제강","90902289000","30750","2956172","4150000","1193828","2024-09"
"267980","매일유업","274234296000","38000","7216692","7843638","626946","2024-09"
"005990","매일홀딩스","104330953750","8350","12494725","13718304","1223579","2024-09"
"093520","매커스","82931527900","8450","9814382","16163092","6348710","2024-09"
"377030","맥스트","45110883010","2305","19570882","19570882","0","2024-09"
"100590","머큐리","52634826475","3325","15830023","15830023","0","2024-09"
"067280","멀티캠퍼스","178396047900","30100","5926779","5926779","0","2024-09"
"072870","메가스터디","126503652180","11090","11407002","11920959","513957","2024-09"
"215200","메가스터디교육","452950826700","42100","10758927","11461955","703028","2024-09"
"133750","메가엠디","44105820030","1998","22074985","23407077","1332092","2024-09"
"446540","메가터치","83914840000","4040","20771000","20771000","0","2024-09"
"235980","메드팩토","183014787750","5450","33580695","33580695","0","2024-09"
"041920","메디아나","82869730250","4465","18559850","18598223","38373","2024-09"
"014100","메디앙스","25031079295","2215","11300713","11800000","499287","2024-09"
"054180","메디콕스","18897664188","321","58871228","58878283","7055","2024-09"
"086900","메디톡스","1144993449600","170100","6731296","7298497","567201","2024-09"
"078160","메디포스트","224370005300","6580","34098785","34217785","119000","2024-09"
"138040","메리츠금융지주","19389155000800","104800","185011021","190720114","5709093","2024-09"
"408920","메쎄이상","92962766880","2160","43038318","43232455","194137","2024-09"
"021880","메이슨캐피탈","46872797664","308","152184408","152184408","0","2024-09"
"140410","메지온","906257269500","30250","29958918","29958918","0","2024-09"
"241770","메카로","74838340000","7600","9847150","10192640","345490","2024-09"
"090370","메타랩스","40340638980","1620","24901629","24904689","3060","2024-09"
"059210","메타바이오메드","88168121340","3855","22871108","23862351","991243","2024-09"
"118000","메타케어","55199695350","335","164775210","164777364","2154","2024-09"
"058110","멕아이씨에스","38743825000","2500","15497530","16050530","553000","2024-09"
"017180","명문제약","76216594680","2280","33428331","33953454","525123","2024-09"
"009900","명신산업","678963521020","12940","52470133","52470133","0","2024-09"
"012690","모나리자","115166441250","3150","36560775","36571255","10480","2024-09"
"005360","모나미","41574075400","2200","18897307","18897307","0","2024-09"
"070960","모나용평","179757035400","3800","47304483","48133333","828850","2024-09"
"434480","모니터랩","43527910000","3700","11764300","12253300","489000","2024-09"
"080420","모다이노칩","152268298020","1910","79721622","79721622","0","2024-09"
"417970","모델솔루션","59617244000","9320","6396700","6396700","0","2024-09"
"080160","모두투어","170526046650","9850","17312289","18900000","1587711","2024-09"
"087260","모바일어플라이언스","67872715185","2085","32552861","32552861","0","2024-09"
"101330","모베이스","71408584465","3085","23147029","23147029","0","2024-09"
"012860","모베이스전자","127190252000","1750","72680144","73233457","553313","2024-09"
"363260","모비데이즈","85027127200","2680","31726540","32163769","437229","2024-09"
"348030","모비릭스","48883342000","5090","9603800","9603800","0","2024-09"
"250060","모비스","101571196790","3170","32041387","32171314","129927","2024-09"
"288980","모아데이타","58262363532","1686","34556562","34556562","0","2024-09"
"142760","모아라이프플러스","48791110623","1293","37734811","37734811","0","2024-09"
"033200","모아텍","28764153125","3125","9204529","14331185","5126656","2024-09"
"333050","모코엠시스","28754265024","1251","22985024","24444326","1459302","2024-09"
"009680","모토닉","186646395120","8630","21627624","33000000","11372376","2024-09"
"118990","모트렉스","246710468900","9950","24795022","24861990","66968","2024-09"
"006920","모헨즈","27955200000","2560","10920000","10920000","0","2024-09"
"009580","무림P&P","170564932830","2735","62363778","62368324","4546","2024-09"
"001810","무림SP","35110075000","1586","22137500","22137500","0","2024-09"
"009200","무림페이퍼","83634713100","2010","41609310","41609310","0","2024-09"
"033920","무학","155477915160","5870","26486868","28500000","2013132","2024-09"
"008420","문배철강","42702504150","2230","19149105","20503505","1354400","2024-09"
"279600","미디어젠","52938025300","11300","4684781","4684781","0","2024-09"
"095500","미래나노텍","284291277660","10020","28372383","31009999","2637616","2024-09"
"254490","미래반도체","220612640000","15280","14438000","14438000","0","2024-09"
"025560","미래산업","33948774850","1090","31145665","31166865","21200","2024-09"
"218150","미래생명자원","87730060500","4500","19495569","20415802","920233","2024-09"
"007120","미래아이앤지","28060838078","1027","27323114","28878608","1555494","2024-09"
"442900","미래에셋드림스팩1호","76723200000","9990","7680000","7680000","0","2024-09"
"100790","미래에셋벤처투자","248338702150","4675","53120578","53124634","4056","2024-09"
"412930","미래에셋비전스팩1호","16613440000","2690","6176000","6176000","0","2024-09"
"446190","미래에셋비전스팩2호","11038500000","2230","4950000","4950000","0","2024-09"
"448830","미래에셋비전스팩3호","10553400000","2145","4920000","4920000","0","2024-09"
"477380","미래에셋비전스팩4호","16321500000","2015","8100000","8100000","0","2024-09"
"477470","미래에셋비전스팩5호","11425800000","2085","5480000","5480000","0","2024-09"
"478440","미래에셋비전스팩6호","14033250000","2025","6930000","6930000","0","2024-09"
"482680","미래에셋비전스팩7호","16306775000","1985","8215000","8215000","0","2024-09"
"085620","미래에셋생명","682410400000","5230","130480000","177016189","46536189","2024-09"
"006800","미래에셋증권","4114235260360","9160","449152321","595316408","146164087","2024-09"
"049950","미래컴퍼니","142362256840","17960","7926629","8817884","891255","2024-09"
"207760","미스터블루","108911271230","1322","82383715","83079783","696068","2024-09"
"002840","미원상사","916764093000","197400","4644195","4750000","105805","2024-09"
"268280","미원에스씨","712933914000","146000","4883109","5000000","116891","2024-09"
"107590","미원홀딩스","184772910000","79800","2315450","2320000","4550","2024-09"
"134380","미원화학","160203360000","80000","2002542","2199268","196726","2024-09"
"003650","미창석유","143733005000","95000","1512979","1739672","226693","2024-09"
"059090","미코","308031828660","9780","31496097","33416778","1920681","2024-09"
"214610","미코바이오메드","71524835286","1642","43559583","43568945","9362","2024-09"
"201490","미투온","65030741750","2125","30602702","31257770","655068","2024-09"
"452200","민테크","142644450000","6500","21945300","21945300","0","2024-09"
"418470","밀리의서재","113975465490","13410","8499289","8499289","0","2024-09"
"206640","바디텍메드","353819975600","16100","21976396","23486560","1510164","2024-09"
"018700","바른손","38696586432","1124","34427568","35119757","692189","2024-09"
"035620","바른손이앤에이","34905598570","470","74267231","74439675","172444","2024-09"
"053030","바이넥스","656062125600","20600","31847676","32684188","836512","2024-09"
"301300","바이브컴퍼니","49674884875","4015","12372325","12394861","22536","2024-09"
"377740","바이오노트","468376668300","4605","101710460","102056048","345588","2024-09"
"064550","바이오니아","597508236650","23150","25810291","25810291","0","2024-09"
"314930","바이오다인","554163088000","18800","29476760","29764103","287343","2024-09"
"208710","바이오로그디바이스","28798590168","437","65900664","65900664","0","2024-09"
"086820","바이오솔루션","125890566420","15690","8023618","8143426","119808","2024-09"
"038460","바이오스마트","79960320400","3470","23043320","23933216","889896","2024-09"
"251120","바이오에프디엔씨","138168973800","16200","8528949","8695700","166751","2024-09"
"199730","바이오인프라","40276958760","8280","4864367","4864367","0","2024-09"
"086040","바이오톡스텍","69564491325","4425","15720789","15958247","237458","2024-09"
"099430","바이오플러스","307408794420","5460","56301977","57930864","1628887","2024-09"
"032980","바이온","29949129690","669","44767010","44777990","10980","2024-09"
"308080","바이젠셀","57983857400","3010","19263740","19263740","0","2024-09"
"043150","바텍","341647888000","23000","14854256","14854256","0","2024-09"
"323990","박셀바이오","280167449000","12200","22964545","22993200","28655","2024-09"
"003610","방림","117331802835","3315","35394209","42314090","6919881","2024-09"
"267790","배럴","36168772500","4585","7888500","7888500","0","2024-09"
"001340","백광산업","408379239750","9250","44149107","44918407","769300","2024-09"
"046310","백금T&A","38275262340","2380","16082043","16418641","336598","2024-09"
"035150","백산","284015000000","13210","21500000","21500000","0","2024-09"
"331520","밸로프","33212580128","677","49058464","50864390","1805926","2024-09"
"199480","뱅크웨어글로벌","74247039300","7350","10101638","10101638","0","2024-09"
"438700","버넥트","39062839450","3505","11144890","11144890","0","2024-09"
"066410","버킷스튜디오","96977294204","1153","84108668","84109926","1258","2024-09"
"002410","범양건영","25078251520","1010","24829952","24831982","2030","2024-09"
"382900","범한퓨얼셀","118352675000","13790","8582500","8761000","178500","2024-09"
"206400","베노티앤알","128543039950","3965","32419430","32420452","1022","2024-09"
"019010","베뉴지","86430000000","2150","40200000","48200000","8000000","2024-09"
"177350","베셀","27831386232","312","89203161","89372043","168882","2024-09"
"424760","벨로크","20169339840","1040","19393596","19665002","271406","2024-09"
"007210","벽산","110900114185","1981","55981885","67560000","11578115","2024-09"
"225530","보광산업","140448499615","3865","36338551","36338727","176","2024-09"
"250000","보라티알","64968123520","9920","6549206","6750733","201527","2024-09"
"002760","보락","80146200000","1338","59900000","59900000","0","2024-09"
"003850","보령","719912210300","10930","65865710","68690000","2824290","2024-09"
"310210","보로노이","1852769311200","103200","17953191","18356592","403401","2024-09"
"006910","보성파워텍","149969910560","3065","48929824","49129824","200000","2024-09"
"000890","보해양조","57855446272","416","139075592","139120129","44537","2024-09"
"226340","본느","68759950820","1639","41952380","41952420","40","2024-09"
"003000","부광약품","330293787575","4825","68454671","68454671","0","2024-09"
"001270","부국증권","163622811100","27550","5939122","10369886","4430764","2024-09"
"026940","부국철강","49500000000","2475","20000000","20000000","0","2024-09"
"014470","부방","91662349548","1708","53666481","60052260","6385779","2024-09"
"011390","부산산업","55123200000","52200","1056000","1056000","0","2024-09"
"005030","부산주공","38288532168","486","78782988","78782988","0","2024-09"
"008470","부스타","31680699120","3920","8081811","8404800","322989","2024-09"
"338220","뷰노","402758293000","29000","13888217","13888217","0","2024-09"
"100120","뷰웍스","223120437300","24300","9181911","10001865","819954","2024-09"
"406820","뷰티스킨","47426816800","13420","3534040","3534040","0","2024-09"
"337930","브랜드엑스코퍼레이션","251493073260","8580","29311547","29311547","0","2024-09"
"099390","브레인즈컴퍼니","51609861530","6530","7903501","8208283","304782","2024-09"
"064480","브리지텍","59227219940","5110","11590454","11952500","362046","2024-09"
"288330","브릿지바이오테라퓨틱스","242090524010","5090","47561989","47561989","0","2024-09"
"365900","브이씨","24781917000","3390","7310300","7310300","0","2024-09"
"089970","브이엠","179545999600","8150","22030184","24075595","2045411","2024-09"
"251630","브이원텍","61432146125","4025","15262645","15942886","680241","2024-09"
"018290","브이티","1077198194450","30350","35492527","35798007","305480","2024-09"
"439580","블루엠텍","241835284650","21650","11170221","11170221","0","2024-09"
"033560","블루콤","57936513565","3395","17065247","17100000","34753","2024-09"
"369370","블리츠웨이스튜디오","79607013153","1671","47640343","49871911","2231568","2024-09"
"126340","비나텍","214594238100","36300","5911687","6085118","173431","2024-09"
"121800","비덴트","256296018720","3320","77197596","77201611","4015","2024-09"
"082800","비보존 제약","232836945600","4900","47517744","48242965","725221","2024-09"
"318410","비비씨","45497440170","8190","5555243","5555243","0","2024-09"
"002070","비비안","24192719880","812","29793990","29793990","0","2024-09"
"100220","비상교육","63707878000","5200","12251515","12996741","745226","2024-09"
"419540","비스토스","41451790365","1803","22990455","22992511","2056","2024-09"
"146320","비씨엔씨","164533731840","12960","12695504","12792923","97419","2024-09"
"200780","비씨월드제약","41391161325","4905","8438565","8892384","453819","2024-09"
"413640","비아이매트릭스","53691703000","7450","7206940","7206940","0","2024-09"
"141000","비아트론","73030641780","6620","11031819","12114710","1082891","2024-09"
"090460","비에이치","489562491600","15600","31382211","34464379","3082168","2024-09"
"083650","비에이치아이","345004794100","11150","30942134","30944375","2241","2024-09"
"445360","비엔케이제1호스팩","9072550000","2105","4310000","4310000","0","2024-09"
"473370","비엔케이제2호스팩","8525250000","2025","4210000","4210000","0","2024-09"
"065170","비엘팜텍","22331156752","251","88968752","88970559","1807","2024-09"
"086670","비엠티","78476496400","8600","9125174","9125174","0","2024-09"
"335890","비올","500631289800","8670","57742940","58419125","676185","2024-09"
"230980","비유테크놀러지","21370405721","229","93320549","93320557","8","2024-09"
"138580","비즈니스온","356042480800","15850","22463248","22556163","92915","2024-09"
"082920","비츠로셀","450283496400","20100","22402164","22872213","470049","2024-09"
"054220","비츠로시스","21532342362","438","49160599","49160599","0","2024-09"
"042370","비츠로테크","178684170500","6820","26200025","26200025","0","2024-09"
"050090","비케이홀딩스","15505281185","787","19701755","19784735","82980","2024-09"
"148780","비큐AI","32955119800","1048","31445725","31445725","0","2024-09"
"307870","비투엔","34109302887","753","45297879","45297879","0","2024-09"
"357880","비트나인","20773028484","1989","10443956","10443956","0","2024-09"
"032850","비트컴퓨터","76894575120","4770","16120456","16623293","502837","2024-09"
"238200","비피도","33292600000","4070","8180000","8180000","0","2024-09"
"093190","빅솔론","68328085060","4540","15050239","19238905","4188666","2024-09"
"065450","빅텍","144696640000","5050","28652800","28652800","0","2024-09"
"210120","빅텐츠","77200175500","24550","3144610","3144610","0","2024-09"
"044480","빌리언스","24398236800","600","40663728","40663728","0","2024-09"
"005180","빙그레","555265102800","62800","8841801","9851241","1009440","2024-09"
"069540","빛과전자","58155568400","1370","42449320","42449320","0","2024-09"
"072950","빛샘전자","30921008640","3860","8010624","8052610","41986","2024-09"
"451250","삐아","93195234540","9420","9893337","10089877","196540","2024-09"
"143240","사람인","175871444400","16200","10856262","11709263","853001","2024-09"
"003960","사조대림","353642023350","42350","8350461","9164467","814006","2024-09"
"008040","사조동아원","144469848850","1025","140946194","141144600","198406","2024-09"
"007160","사조산업","303075100000","60700","4993000","5000000","7000","2024-09"
"014710","사조씨푸드","115536423530","6710","17218543","17218543","0","2024-09"
"006090","사조오양","81883575840","8690","9422736","9422739","3","2024-09"
"452430","사피엔반도체","93906222400","11600","8095364","8096454","1090","2024-09"
"419120","산돌","47263821260","6460","7316381","7774326","457945","2024-09"
"062040","산일전기","1271589106950","41850","30384447","30445200","60753","2024-09"
"122350","삼기","55499812416","1462","37961568","38339428","377860","2024-09"
"419050","삼기이브이","126117709200","2205","57196240","57196240","0","2024-09"
"014970","삼륭물산","58952203200","3960","14886920","15125000","238080","2024-09"
"018310","삼목에스폼","314383594200","22100","14225502","14700000","474498","2024-09"
"053700","삼보모터스","95362221240","4290","22228956","22877190","648234","2024-09"
"009620","삼보산업","18593703324","252","73784537","73785902","1365","2024-09"
"023600","삼보판지","142175896140","9070","15675402","16170000","494598","2024-09"
"001470","삼부토건","100178097152","448","223611824","223611824","0","2024-09"
"028050","삼성E&A","3610320000000","18420","196000000","196000000","0","2024-09"
"006400","삼성SDI","21069470758000","322000","65433139","68764530","3331391","2024-09"
"006660","삼성공조","82380827680","10480","7860766","8126314","265548","2024-09"
"028260","삼성물산","21438554208200","132200","162167581","177784107","15616526","2024-09"
"207940","삼성바이오로직스","75515614000000","1061000","71174000","71174000","0","2024-09"
"032830","삼성생명","18262755024300","101700","179574779","200000000","20425221","2024-09"
"425290","삼성스팩6호","11730000000","2125","5520000","5520000","0","2024-09"
"439250","삼성스팩7호","36315740000","10370","3502000","3502000","0","2024-09"
"448740","삼성스팩8호","46873200000","10050","4664000","4664000","0","2024-09"
"468510","삼성스팩9호","22321000000","2020","11050000","11050000","0","2024-09"
"018260","삼성에스디에스","10975991393400","141900","77350186","77377800","27614","2024-09"
"009150","삼성전기","8505162432000","117000","72693696","74693696","2000000","2024-09"
"005930","삼성전자","333710844545000","55900","5969782550","5969782550","0","2024-09"
"001360","삼성제약","144004052880","1530","94120296","94162079","41783","2024-09"
"010140","삼성중공업","8454952152900","9900","854035571","880000000","25964429","2024-09"
"016360","삼성증권","4210495000000","47150","89300000","89300000","0","2024-09"
"068290","삼성출판사","139700000000","13970","10000000","10000000","0","2024-09"
"029780","삼성카드","4375138495000","41000","106710695","115858891","9148196","2024-09"
"000810","삼성화재","14198787524000","356500","39828296","47374837","7546541","2024-09"
"006110","삼아알미늄","723090671400","49150","14711916","14711916","0","2024-09"
"009300","삼아제약","129696017500","21250","6103342","6370000","266658","2024-09"
"145990","삼양사","480900912500","49750","9666350","10313449","647099","2024-09"
"003230","삼양식품","3945349712000","529000","7458128","7533015","74887","2024-09"
"002170","삼양통상","129809000000","47900","2710000","3000000","290000","2024-09"
"272550","삼양패키징","250933532780","16180","15508871","15788671","279800","2024-09"
"000070","삼양홀딩스","520488150000","70000","7435545","8564271","1128726","2024-09"
"003720","삼영","152222507550","4590","33163945","34000000","836055","2024-09"
"002810","삼영무역","222642953520","12630","17628104","18466948","838844","2024-09"
"361670","삼영에스앤씨","37262095440","6680","5578158","5667658","89500","2024-09"
"054540","삼영엠텍","47974150000","3955","12130000","13000000","870000","2024-09"
"065570","삼영이엔씨","30221705820","2220","13613381","13613381","0","2024-09"
"005680","삼영전자","191780505600","9600","19977136","20000000","22864","2024-09"
"023000","삼원강재","102131686920","2570","39739956","40000000","260044","2024-09"
"004380","삼익THK","179883000000","8690","20700000","21000000","300000","2024-09"
"002450","삼익악기","83481944670","1098","76030915","90530915","14500000","2024-09"
"032280","삼일","22614629760","1458","15510720","16213590","702870","2024-09"
"002290","삼일기업공사","34906000000","2815","12400000","12400000","0","2024-09"
"004440","삼일씨엔에스","55320309715","4345","12731947","12731947","0","2024-09"
"000520","삼일제약","331772210560","15680","21158942","21621100","462158","2024-09"
"009770","삼정펄프","67249219900","26900","2499971","2499971","0","2024-09"
"037460","삼지전자","132179962320","8610","15351912","16318522","966610","2024-09"
"032750","삼진","36731986060","4070","9025058","9031122","6064","2024-09"
"054090","삼진엘앤디","21366370726","862","24786973","24959232","172259","2024-09"
"005500","삼진제약","226119209000","18050","12527380","13900000","1372620","2024-09"
"000250","삼천당제약","2928115724800","125900","23257472","23457472","200000","2024-09"
"004690","삼천리","306107835000","89400","3424025","4055025","631000","2024-09"
"024950","삼천리자전거","48289645320","3990","12102668","13273577","1170909","2024-09"
"038500","삼표시멘트","325281262560","3030","107353552","107916306","562754","2024-09"
"437730","삼현","79057533720","7480","10569189","10569189","0","2024-09"
"017480","삼현철강","72813226350","4715","15442890","15702890","260000","2024-09"
"010960","삼호개발","70434000000","3150","22360000","25000000","2640000","2024-09"
"046390","삼화네트웍스","62036567862","1567","39589386","43172933","3583547","2024-09"
"004450","삼화왕관","57738208000","32000","1804319","2154379","350060","2024-09"
"009470","삼화전기","278441822000","42100","6613820","6613820","0","2024-09"
"011230","삼화전자","48928128660","2895","16900908","16902700","1792","2024-09"
"001820","삼화콘덴서","336047750000","32750","10261000","10395000","134000","2024-09"
"000390","삼화페인트","174099144600","7380","23590670","27203469","3612799","2024-09"
"027580","상보","66584711226","1182","56332243","59181279","2849036","2024-09"
"038540","상상인","87723014428","1603","54724276","55328313","604037","2024-09"
"415580","상상인제3호스팩","11151000000","2100","5310000","5310000","0","2024-09"
"452670","상상인제4호스팩","10518300000","2015","5220000","5220000","0","2024-09"
"001290","상상인증권","49944005270","470","106263841","108337120","2073279","2024-09"
"041650","상신브레이크","65728252450","3395","19360310","21471450","2111140","2024-09"
"091580","상신이디피","133948600950","10050","13328219","13428219","100000","2024-09"
"263810","상신전자","44645807745","3135","14241087","14244718","3631","2024-09"
"089980","상아프론테크","323503767250","20750","15590543","15989037","398494","2024-09"
"042940","상지건설","23118257260","5810","3979046","3981814","2768","2024-09"
"042600","새로닉스","161579026490","13210","12231569","12423574","192005","2024-09"
"075180","새론오토모티브","75360000000","3925","19200000","19200000","0","2024-09"
"107600","새빗켐","109593990000","22000","4981545","4981545","0","2024-09"
"411080","샌즈랩","99221711160","6820","14548638","15248638","700000","2024-09"
"252990","샘씨엔에스","321558249360","5640","57013874","58388063","1374189","2024-09"
"007540","샘표","88176725000","43750","2015468","2875800","860332","2024-09"
"248170","샘표식품","129919656200","28450","4566596","4568286","1690","2024-09"
"378800","샤페론","147700851900","4900","30143031","30143031","0","2024-09"
"294630","서남","85246976745","3555","23979459","23979459","0","2024-09"
"038070","서린바이오","59531567700","7050","8444194","8900676","456482","2024-09"
"006730","서부T&D","391483144640","6070","64494752","66426923","1932171","2024-09"
"079650","서산","24140000000","1207","20000000","20000000","0","2024-09"
"100660","서암기계공업","46242000000","3670","12600000","12600000","0","2024-09"
"007860","서연","147826617660","6810","21707286","23479844","1772558","2024-09"
"200880","서연이화","359672815810","13310","27022751","27028437","5686","2024-09"
"019770","서연탑메탈","42639000000","3660","11650000","11650000","0","2024-09"
"017390","서울가스","201128625600","51800","3882792","5000000","1117208","2024-09"
"043710","서울리거","32076741177","639","50198343","50198880","537","2024-09"
"092190","서울바이오시스","182268650590","4030","45227953","45868383","640430","2024-09"
"046890","서울반도체","515889261000","9150","56381340","58305400","1924060","2024-09"
"004410","서울식품","57337577577","153","374755409","374755559","150","2024-09"
"063170","서울옥션","113313131140","6730","16837018","17774267","937249","2024-09"
"027040","서울전자통신","18440864520","265","69588168","69588847","679","2024-09"
"018680","서울제약","46637276000","4000","11659319","11659319","0","2024-09"
"021050","서원","59105864550","1245","47474590","47474590","0","2024-09"
"093920","서원인텍","107880000000","5800","18600000","18600000","0","2024-09"
"189860","서전기전","47233058600","4870","9698780","9698780","0","2024-09"
"178320","서진시스템","1532756746500","27250","56247954","56247954","0","2024-09"
"122690","서진오토모티브","49196850960","2265","21720464","21844410","123946","2024-09"
"140070","서플러스글로벌","112826939850","3275","34450974","36988000","2537026","2024-09"
"011370","서한","76886579295","783","98194865","100894865","2700000","2024-09"
"065710","서호전기","106747100300","21650","4930582","5150000","219418","2024-09"
"008490","서흥","177016278960","15920","11119113","11569113","450000","2024-09"
"035890","서희건설","270245310960","1398","193308520","229808457","36499937","2024-09"
"357550","석경에이티","245570850000","45150","5439000","5455000","16000","2024-09"
"003100","선광","98249800000","15620","6290000","6600000","310000","2024-09"
"007610","선도전기","50907057000","3000","16969019","18000000","1030981","2024-09"
"067370","선바이오","83799317730","6810","12305333","12313555","8222","2024-09"
"171090","선익시스템","373855622700","42700","8755401","9494405","739004","2024-09"
"136490","선진","156467188640","6580","23779208","23779604","396","2024-09"
"086710","선진뷰티사이언스","119021676600","9910","12010260","12203280","193020","2024-09"
"014620","성광벤드","341891324930","12770","26773009","28600000","1826991","2024-09"
"037350","성도이엔지","63984515000","4505","14203000","15470000","1267000","2024-09"
"014910","성문전자","25635212395","1235","20757257","22460985","1703728","2024-09"
"003080","성보화학","51418555125","2625","19588021","20020000","431979","2024-09"
"004980","성신양회","190509266300","7900","24115097","24516073","400976","2024-09"
"011300","성안머티리얼스","36276332612","443","81887884","81887884","0","2024-09"
"081580","성우전자","69409450935","4565","15204699","15508143","303444","2024-09"
"045300","성우테크론","25941221000","2650","9789140","10151583","362443","2024-09"
"015750","성우하이텍","490348465090","6130","79991593","80000000","8407","2024-09"
"365340","성일하이텍","643279391000","53000","12137347","12137347","0","2024-09"
"000180","성창기업지주","95838698400","1374","69751600","69751600","0","2024-09"
"080470","성창오토텍","30076000000","4120","7300000","7300000","0","2024-09"
"043260","성호전자","93028338225","1525","61002189","61002189","0","2024-09"
"148150","세경하이테크","241070111490","6810","35399429","35860429","461000","2024-09"
"002420","세기상사","32130141440","5780","5558848","5558848","0","2024-09"
"188260","세니젠","20336632365","2865","7098301","7228470","130169","2024-09"
"053060","세동","20393698710","1155","17656882","17657419","537","2024-09"
"340440","세림B&G","39956729472","1408","28378359","28378364","5","2024-09"
"017510","세명전기","77602140000","5090","15246000","15246000","0","2024-09"
"004360","세방","213454155600","11900","17937324","19308690","1371366","2024-09"
"004490","세방전지","924759803400","70300","13154478","14000000","845522","2024-09"
"011560","세보엠이씨","97391048040","9820","9917622","10530000","612378","2024-09"
"396300","세아메카닉스","76604287500","2925","26189500","26489500","300000","2024-09"
"001430","세아베스틸지주","702180290020","19580","35862119","35862119","0","2024-09"
"306200","세아제강","318091360000","113600","2800100","2836300","36200","2024-09"
"003030","세아제강지주","639604976300","158300","4040461","4141657","101196","2024-09"
"019440","세아특수강","114324705300","13700","8344869","8570000","225131","2024-09"
"058650","세아홀딩스","383327925600","98400","3895609","4000000","104391","2024-09"
"013000","세우글로벌","35591696440","1240","28702981","28705031","2050","2024-09"
"100700","세운메디칼","117102425500","2705","43291100","43800000","508900","2024-09"
"024830","세원물산","51937000000","6220","8350000","8350000","0","2024-09"
"091090","세원이앤씨","54828158060","1270","43171778","43180255","8477","2024-09"
"021820","세원정공","70700000000","7070","10000000","10000000","0","2024-09"
"067830","세이브존I&C","81088868950","2150","37715753","41040895","3325142","2024-09"
"258830","세종메디칼","22974088612","412","55762351","55786351","24000","2024-09"
"036630","세종텔레콤","93073424360","490","189945764","200000000","10054236","2024-09"
"039310","세중","30806833900","1700","18121667","18121667","0","2024-09"
"075580","세진중공업","414432534240","7290","56849456","56849456","0","2024-09"
"067770","세진티에스","20407394940","2460","8295689","8396593","100904","2024-09"
"053450","세코닉스","79577935680","5440","14628297","14792803","164506","2024-09"
"222810","세토피아","81189010800","1080","75175010","75659350","484340","2024-09"
"252500","세화피앤씨","37462210170","903","41486390","41486390","0","2024-09"
"321370","센서뷰","55058427050","2090","26343745","26343745","0","2024-09"
"347000","센코","79599618045","2445","32556081","33004976","448895","2024-09"
"331920","셀레믹스","31146224620","3815","8164148","8164148","0","2024-09"
"049180","셀루메드","143189176440","2780","51506898","51515906","9008","2024-09"
"299660","셀리드","102349438450","4850","21102977","21102977","0","2024-09"
"268600","셀리버리","248384003120","6680","37183234","37183234","0","2024-09"
"108860","셀바스AI","275063900720","10220","26914276","26914790","514","2024-09"
"208370","셀바스헬스케어","104413370740","4060","25717579","25740564","22985","2024-09"
"318160","셀바이오휴먼텍","31419207700","3580","8776315","9260901","484586","2024-09"
"308430","셀비온","226117409750","17750","12739009","12739009","0","2024-09"
"068270","셀트리온","38416089919200","186400","206094903","217021190","10926287","2024-09"
"068760","셀트리온제약","2549662253600","61600","41390621","41600387","209766","2024-09"
"068940","셀피글로벌","29334496224","778","37705008","38260597","555589","2024-09"
"060230","소니드","37206705978","813","45764706","46066730","302024","2024-09"
"290690","소룩스","414136836720","9090","45559608","45564340","4732","2024-09"
"032680","소프트센","41607483792","399","104279408","105590764","1311356","2024-09"
"258790","소프트캠프","21580786800","900","23978652","24991284","1012632","2024-09"
"066910","손오공","53221129220","1580","33684259","33784259","100000","2024-09"
"336370","솔루스첨단소재","828505116400","11800","70212298","70217344","5046","2024-09"
"248070","솔루엠","973420320000","20000","48671016","50005551","1334535","2024-09"
"035610","솔본","99972750775","3895","25666945","27345997","1679052","2024-09"
"357780","솔브레인","1509912690000","195000","7743142","7778566","35424","2024-09"
"036830","솔브레인홀딩스","981425667500","47500","20661593","20964056","302463","2024-09"
"304100","솔트룩스","215802804720","17790","12130568","12130568","0","2024-09"
"328380","솔트웨어","36998844120","1080","34258189","34262778","4589","2024-09"
"004430","송원산업","322560000000","13440","24000000","24000000","0","2024-09"
"086980","쇼박스","270980920000","4340","62438000","62638000","200000","2024-09"
"050960","수산아이앤티","67172450000","9950","6751000","6751000","0","2024-09"
"126720","수산인더스트리","310335558750","22050","14074175","14286000","211825","2024-09"
"017550","수산중공업","106328117520","1704","62399130","62399130","0","2024-09"
"084180","수성웹툰","72479281841","617","117470473","117470473","0","2024-09"
"253840","수젠텍","89444557800","5850","15289668","16743200","1453532","2024-09"
"298830","슈어소프트테크","238523819720","4570","52193396","52619061","425665","2024-09"
"236200","슈프리마","179385596000","26000","6899446","7193273","293827","2024-09"
"094840","슈프리마에이치큐","52267158780","5710","9153618","10471840","1318222","2024-09"
"192440","슈피겐코리아","123008572800","20400","6029832","6216363","186531","2024-09"
"424960","스마트레이더시스템","162107989200","10380","15617340","15617340","0","2024-09"
"099440","스맥","113534323140","3045","37285492","40243394","2957902","2024-09"
"053210","스카이라이프","235759254020","4985","47293732","47522955","229223","2024-09"
"276040","스코넥","37726194370","3005","12554474","12554474","0","2024-09"
"159910","스킨앤스킨","27277842540","754","36177510","36410098","232588","2024-09"
"060240","스타코링크","16742801710","551","30386210","31136323","750113","2024-09"
"115570","스타플렉스","23591153820","2990","7890018","7984508","94490","2024-09"
"330730","스톤브릿지벤처스","67125119600","3850","17435096","18150830","715734","2024-09"
"352090","스톰테크","86262323580","3210","26872998","26872998","0","2024-09"
"253450","스튜디오드래곤","1161760947700","38650","30058498","30058498","0","2024-09"
"408900","스튜디오미르","136220702415","4165","32706051","32706134","83","2024-09"
"204630","스튜디오산타클로스","23613109200","4650","5078088","5089941","11853","2024-09"
"415380","스튜디오삼익","32923595600","8120","4054630","4225498","170868","2024-09"
"026890","스틱인베스트먼트","287271917400","7860","36548590","41678175","5129585","2024-09"
"013810","스페코","69613482500","4750","14655470","14655470","0","2024-09"
"203690","스피어파워","66509717050","5050","13170241","13337850","167609","2024-09"
"049830","승일","41884359340","7090","5907526","6132112","224586","2024-09"
"020710","시공테크","65455529550","3470","18863265","20047970","1184705","2024-09"
"033170","시그네틱스","85728319000","1000","85728319","85728319","0","2024-09"
"048870","시너지이노베이션","223726070520","2705","82708344","82708344","0","2024-09"
"025320","시노펙스","573457187940","6870","83472662","83817936","345274","2024-09"
"134790","시디즈","48689782000","29000","1678958","2000000","321042","2024-09"
"269620","시스웍","131663951937","889","148103433","148582691","479258","2024-09"
"429270","시지트로닉스","29831375000","6620","4506250","4506250","0","2024-09"
"418250","시큐레터","52279100100","6550","7981542","7981542","0","2024-09"
"131090","시큐브","34793893120","896","38832470","44000000","5167530","2024-09"
"232830","시큐센","24351541760","2080","11707472","11707472","0","2024-09"
"462870","시프트업","3383413760000","58000","58334720","58334720","0","2024-09"
"016590","신대양제지","179432563050","5850","30672233","40297820","9625587","2024-09"
"290520","신도기연","32337817020","2055","15736164","15929362","193198","2024-09"
"029530","신도리코","345342298950","40050","8622779","10080029","1457250","2024-09"
"004970","신라교역","149326100000","9460","15785000","16000000","215000","2024-09"
"001000","신라섬유","25491417000","1050","24277540","24277540","0","2024-09"
"025870","신라에스지","24640000000","6160","4000000","4000000","0","2024-09"
"215600","신라젠","329501100000","2400","137292125","137367125","75000","2024-09"
"065350","신성델타테크","1204248896400","44300","27183948","27483948","300000","2024-09"
"416180","신성에스티","231881094200","25900","8952938","9039778","86840","2024-09"
"011930","신성이엔지","293745736557","1443","203565999","205848151","2282152","2024-09"
"005390","신성통상","320469709700","2230","143708390","143708390","0","2024-09"
"004170","신세계","1350744813600","146400","9226399","9845181","618782","2024-09"
"035510","신세계 I&C","128303105600","9760","13145810","17200000","4054190","2024-09"
"034300","신세계건설","138197911620","18210","7589122","7760554","171432","2024-09"
"031430","신세계인터내셔날","433901370000","12530","34629000","35700000","1071000","2024-09"
"031440","신세계푸드","131657894000","34000","3872291","3872480","189","2024-09"
"006880","신송홀딩스","75743701020","7020","10789701","11828858","1039157","2024-09"
"162300","신스틸","96395947200","2350","41019552","41471382","451830","2024-09"
"290560","신시웨이","24453988540","6310","3875434","3877972","2538","2024-09"
"002800","신신제약","84954800000","5600","15170500","15170500","0","2024-09"
"472220","신영스팩10호","10036600000","2140","4690000","4690000","0","2024-09"
"430220","신영스팩8호","14804400000","2190","6760000","6760000","0","2024-09"
"445970","신영스팩9호","11604400000","2165","5360000","5360000","0","2024-09"
"005800","신영와코루","81630000000","9070","9000000","9000000","0","2024-09"
"001720","신영증권","624694484800","81100","7702768","16440000","8737232","2024-09"
"009270","신원","94716073272","1262","75052356","102586356","27534000","2024-09"
"017000","신원종합개발","33866429850","3025","11195514","11668027","472513","2024-09"
"002700","신일전자","101571691460","1445","70291828","71047521","755693","2024-09"
"012790","신일제약","84038008470","7270","11559561","11986415","426854","2024-09"
"138070","신진에스엠","40217323480","2390","16827332","17503204","675872","2024-09"
"226330","신테카바이오","67747629000","4440","15258475","15258475","0","2024-09"
"002870","신풍","25462163220","919","27706380","34958700","7252320","2024-09"
"019170","신풍제약","566124123210","11490","49271029","52984990","3713961","2024-09"
"418210","신한제10호스팩","8216700000","2245","3660000","3660000","0","2024-09"
"452980","신한제11호스팩","36845845000","1949","18905000","18905000","0","2024-09"
"474660","신한제12호스팩","11730000000","2125","5520000","5520000","0","2024-09"
"474930","신한제13호스팩","7801100000","2155","3620000","3620000","0","2024-09"
"055550","신한지주","29199828792000","58000","503445324","509393214","5947890","2024-09"
"056700","신화인터텍","48970721608","1688","29011091","29135091","124000","2024-09"
"187270","신화콘텍","29987413180","3260","9198593","10143845","945252","2024-09"
"004080","신흥","134940541450","14290","9443005","9500000","56995","2024-09"
"243840","신흥에스이씨","287010908400","7440","38576735","38919035","342300","2024-09"
"257720","실리콘투","2188392762300","35950","60873234","60873234","0","2024-09"
"222800","심텍","505712526760","15880","31845877","31854143","8266","2024-09"
"036710","심텍홀딩스","71914542880","1552","46336690","48350145","2013455","2024-09"
"160980","싸이맥스","108847558200","10650","10220428","10924243","703815","2024-09"
"356890","싸이버원","34255395000","2875","11914920","11916325","1405","2024-09"
"217330","싸이토젠","163332392760","7080","23069547","23129547","60000","2024-09"
"102280","쌍방울","70634046631","269","262580099","262592129","12030","2024-09"
"010280","쌍용정보통신","39139388174","601","65123774","65123786","12","2024-09"
"004770","써니전자","57520772897","1583","36336559","36702884","366325","2024-09"
"208640","썸에이지","32442979182","233","139240254","139240254","0","2024-09"
"222420","쎄노텍","36186341488","796","45460228","45460231","3","2024-09"
"037760","쎄니트","47610974286","1566","30402921","33832921","3430000","2024-09"
"099320","쎄트렉아이","407935105500","37250","10951278","10951278","0","2024-09"
"049960","쎌바이오텍","93008601000","13590","6843900","9400000","2556100","2024-09"
"088280","쏘닉스","44996874000","2600","17306490","17306490","0","2024-09"
"403550","쏘카","609372730140","18570","32814902","32814902","0","2024-09"
"050890","쏠리드","261794324160","4320","60600538","61095231","494693","2024-09"
"475400","씨메스","227038543500","19850","11437710","11437710",,"자료 없음"
"109670","씨싸이트","52926161930","9070","5835299","5836602","1303","2024-09"
"066790","씨씨에스","98530327269","1629","60485161","65152039","4666878","2024-09"
"222080","씨아이에스","589615067940","8220","71729327","71729327","0","2024-09"
"004920","씨아이테크","65636254623","1311","50065793","50065793","0","2024-09"
"352480","씨앤씨인터내셔널","687800755200","68800","9997104","10013941","16837","2024-09"
"264660","씨앤지하이테크","117901091520","12640","9327618","9627896","300278","2024-09"
"352700","씨앤투스","75228443640","2940","25587906","27276899","1688993","2024-09"
"458870","씨어스테크놀로지","153130496000","12200","12551680","12551680","0","2024-09"
"297090","씨에스베어링","140440500000","5150","27270000","27270000","0","2024-09"
"112610","씨에스윈드","2336622728400","56400","41429481","42171403","741922","2024-09"
"359090","씨엔알리서치","67458251900","1195","56450420","56450891","471","2024-09"
"115530","씨엔플러스","31330943000","461","67963000","67963000","0","2024-09"
"115480","씨유메디칼","36670913196","762","48124558","48224558","100000","2024-09"
"340810","씨유박스","33913161600","3200","10597863","10597863","0","2024-09"
"376290","씨유테크","55179687500","3125","17657500","17657500","0","2024-09"
"189330","씨이랩","40391842920","6630","6092284","6092284","0","2024-09"
"096530","씨젠","1048447351600","22700","46187108","52225994","6038886","2024-09"
"101240","씨큐브","50141511600","4850","10338456","10340947","2491","2024-09"
"060590","씨티씨바이오","191748375500","8020","23908775","24181020","272245","2024-09"
"308170","씨티알모빌리티","49163100000","5710","8610000","8610000","0","2024-09"
"260930","씨티케이","105148342620","5580","18843789","19341591","497802","2024-09"
"052300","씨티프라퍼티","62565217029","371","168639399","168651433","12034","2024-09"
"413630","씨피시스템","95134535530","2570","37017329","38703425","1686096","2024-09"
"013990","아가방컴퍼니","134648357760","4480","30055437","32887536","2832099","2024-09"
"123860","아나패스","218948874900","18060","12123415","12123415","0","2024-09"
"025980","아난티","420546873110","4745","88629478","88629478","0","2024-09"
"008700","아남전자","96787269150","1255","77121330","77124820","3490","2024-09"
"125210","아모그린텍","114652690500","6950","16496790","16496790","0","2024-09"
"002790","아모레G","1700867272500","22300","76272075","82458180","6186105","2024-09"
"090430","아모레퍼시픽","6852899427000","117300","58421990","58492759","70769","2024-09"
"357580","아모센스","80224887600","7150","11220264","11220264","0","2024-09"
"052710","아모텍","55966051180","3830","14612546","14615109","2563","2024-09"
"074430","아미노로직스","104777424892","1193","87826844","87826844","0","2024-09"
"092040","아미코젠","238176467210","4345","54816218","55018347","202129","2024-09"
"083930","아바코","213399767700","14700","14516991","14912798","395807","2024-09"
"149950","아바텍","166423200450","12030","13834015","15607500","1773485","2024-09"
"036010","아비코전자","65334770610","4915","13292934","13292934","0","2024-09"
"002030","아세아","432743685000","257500","1680558","2115648","435090","2024-09"
"183190","아세아시멘트","409391301500","10900","37558835","38501886","943051","2024-09"
"002310","아세아제지","329250212000","8240","39957550","42782510","2824960","2024-09"
"050860","아세아텍","43257594310","2185","19797526","22500000","2702474","2024-09"
"012170","아센디오","44741974752","432","103569386","103569488","102","2024-09"
"136410","아셈스","86837140770","8170","10628781","11019106","390325","2024-09"
"246720","아스타","60985013500","4495","13567300","13567300","0","2024-09"
"067390","아스트","183045556540","532","344070595","344203992","133397","2024-09"
"159010","아스플로","79875202200","6180","12924790","13334739","409949","2024-09"
"127710","아시아경제","45898867830","1315","34904082","34904082","0","2024-09"
"267850","아시아나IDT","196470000000","17700","11100000","11100000","0","2024-09"
"020560","아시아나항공","715841169680","9620","74411764","74411764","0","2024-09"
"154030","아시아종묘","27703331280","2390","11591352","11591352","0","2024-09"
"227610","아우딘퓨쳐스","48599738577","1371","35448387","35583547","135160","2024-09"
"143160","아이디스","150502686150","14930","10080555","10716390","635835","2024-09"
"054800","아이디스홀딩스","80014377540","9060","8831609","10347756","1516147","2024-09"
"332370","아이디피","45786838020","3630","12613454","13273726","660272","2024-09"
"122900","아이마켓코리아","261468665400","8310","31464340","33428840","1964500","2024-09"
"339950","아이비김영","74759139480","1724","43363770","44946655","1582885","2024-09"
"469750","아이비젼웍스","49248750972","1454","33871218","33936481","65263","2024-09"
"460470","아이빔테크놀로지","72027866750","4775","15084370","15084370","0","2024-09"
"099190","아이센스","523387694840","18940","27633986","27637273","3287","2024-09"
"461300","아이스크림미디어","167619910300","13100","12795413","13063433","268020","2024-09"
"289010","아이스크림에듀","29443608250","2350","12529195","12864037","334842","2024-09"
"214430","아이쓰리시스템","245041374600","35300","6941682","7106760","165078","2024-09"
"040910","아이씨디","79680949635","4885","16311351","18574275","2262924","2024-09"
"368600","아이씨에이치","61959362115","3605","17187063","17538346","351283","2024-09"
"456010","아이씨티케이","94404337440","7140","13221896","13221896","0","2024-09"
"052860","아이앤씨","26015422027","1603","16229209","17862854","1633645","2024-09"
"464500","아이언디바이스","60893552980","4460","13653263","13653263","0","2024-09"
"010780","아이에스동서","635435844800","21050","30186976","30186976","0","2024-09"
"038880","아이에이","60934122200","200","304670611","315334702","10664091","2024-09"
"307180","아이엘사이언스","82614810005","3055","27042491","27042828","337","2024-09"
"101390","아이엠","31225478130","2970","10513629","10548085","34456","2024-09"
"461030","아이엠비디엑스","199192227500","14210","14017750","14017750","0","2024-09"
"451220","아이엠티","71107737330","9030","7874611","7874611","0","2024-09"
"090150","아이윈","34473345648","868","39715836","41875293","2159457","2024-09"
"123010","아이윈플러스","22273918809","687","32422007","32658542","236535","2024-09"
"031310","아이즈비전","43680798876","1788","24429977","25334636","904659","2024-09"
"185490","아이진","75413097360","2790","27029784","27029784","0","2024-09"
"059100","아이컴포넌트","29694356570","4495","6606086","7070860","464774","2024-09"
"262840","아이퀘스트","41778508560","2220","18819148","19290000","470852","2024-09"
"175250","아이큐어","90808334550","2430","37369685","37558368","188683","2024-09"
"052460","아이크래프트","28160939280","2355","11957936","14607936","2650000","2024-09"
"119830","아이텍","116463421940","5470","21291302","21434297","142995","2024-09"
"052770","아이톡시","69208663698","1413","48979946","48979946","0","2024-09"
"124500","아이티센","146188520100","6300","23204527","23204527","0","2024-09"
"372800","아이티아이즈","34850980800","5920","5886990","6026990","140000","2024-09"
"084850","아이티엠반도체","380672466400","18400","20688721","22682934","1994213","2024-09"
"114840","아이패밀리에스씨","339272296800","19700","17221944","17221944","0","2024-09"
"027360","아주IB투자","227466201668","1921","118410308","120945406","2535098","2024-09"
"139990","아주스틸","133118321880","5020","26517594","26517744","150","2024-09"
"032080","아즈텍WB","23089031900","1100","20990029","21491029","501000","2024-09"
"013310","아진산업","107098879920","2760","38803942","38806582","2640","2024-09"
"059120","아진엑스텍","70493754100","7700","9155033","9748596","593563","2024-09"
"009320","아진전자부품","54525545620","1106","49299770","49299770","0","2024-09"
"158430","아톤","85273976760","3990","21371924","22602474","1230550","2024-09"
"321820","아티스트유나이티드","212131274700","15870","13366810","13366810","0","2024-09"
"001540","안국약품","80239476900","7060","11365365","13042420","1677055","2024-09"
"053800","안랩","562430111600","57400","9798434","11126506","1328072","2024-09"
"065660","안트로젠","144997457700","14900","9731373","9731373","0","2024-09"
"297570","알로이스","38048718582","1099","34621218","34621218","0","2024-09"
"001780","알루코","221741002280","2290","96830132","96830132","0","2024-09"
"260660","알리코제약","55174211925","3675","15013391","15327021","313630","2024-09"
"354320","알멕","196854534800","30800","6391381","6391381","0","2024-09"
"361570","알비더블유","63570346020","2220","28635291","28635291","0","2024-09"
"131370","알서포트","150794117310","2895","52087778","53267083","1179305","2024-09"
"140670","알에스오토메이션","94879230680","10270","9238484","9303140","64656","2024-09"
"096610","알에프세미","51550708615","2965","17386411","17386411","0","2024-09"
"061040","알에프텍","91478549640","2930","31221348","32089259","867911","2024-09"
"148250","알엔투테크놀로지","28912529750","4030","7174325","7391186","216861","2024-09"
"347860","알체라","48002876240","2180","22019668","22019668","0","2024-09"
"196170","알테오젠","19868682680000","374000","53124820","53148528","23708","2024-09"
"123750","알톤","20535582061","1613","12731297","12746297","15000","2024-09"
"085810","알티캐스트","41938265560","1384","30302215","31081959","779744","2024-09"
"043100","알파녹스","21991944960","2760","7968096","7975920","7824","2024-09"
"117670","알파홀딩스","37743429465","945","39940137","39940137","0","2024-09"
"314140","알피바이오","52245045680","6040","8649842","8666361","16519","2024-09"
"291650","압타머사이언스","42875136300","2525","16980252","16980252","0","2024-09"
"293780","압타바이오","202787640000","8200","24730200","24730200","0","2024-09"
"018250","애경산업","402742003560","15670","25701468","26409935","708467","2024-09"
"161000","애경케미칼","502081070400","10400","48277026","48648709","371683","2024-09"
"196300","애니젠","75522608460","12580","6003387","6003387","0","2024-09"
"310200","애니플러스","118107159930","2655","44484806","45520979","1036173","2024-09"
"299910","애닉","32483121920","6880","4721384","4721384","0","2024-09"
"179530","애드바이오텍","30346274080","3320","9140444","9140444","0","2024-09"
"205500","액션스퀘어","55925039745","1077","51926685","51928120","1435","2024-09"
"052790","액토즈소프트","71883519260","6580","10924547","11330638","406091","2024-09"
"290740","액트로","52167707930","5590","9332327","10065011","732684","2024-09"
"238090","앤디포스","88424721210","3885","22760546","23541303","780757","2024-09"
"092600","앤씨앤","29387282400","1200","24489402","25083517","594115","2024-09"
"129890","앱코","54840379560","1145","47895528","50643410","2747882","2024-09"
"174900","앱클론","271831731600","15600","17425111","17425111","0","2024-09"
"255440","야스","122374275660","10140","12068469","13058000","989531","2024-09"
"030960","양지사","126783926100","9230","13736070","15980000","2243930","2024-09"
"102120","어보브반도체","158883001020","9630","16498754","17780753","1281999","2024-09"
"263540","어스앤에어로스페이스","85022108500","5950","14289430","14294091","4661","2023-12"
"238120","얼라인드","43136688000","3000","14378896","14378896","0","2024-09"
"019990","에너토크","57416502000","6000","9569417","9756088","186671","2024-09"
"011090","에넥스","31667567574","534","59302561","59991641","689080","2024-09"
"270660","에브리봇","188974233900","15450","12231342","12231342","0","2024-09"
"038680","에스넷","66077978735","3635","18178261","19549677","1371416","2024-09"
"137310","에스디바이오센서","1075434226140","8790","122347466","124477353","2129887","2024-09"
"217480","에스디생명공학","54756837359","499","109733141","109733141","0","2024-09"
"121890","에스디시스템","17385211368","1308","13291446","13291446","0","2024-09"
"304360","에스바이오메딕스","374103602600","31850","11745796","11745796","0","2024-09"
"389500","에스비비테크","86151102300","14450","5962014","6174904","212890","2024-09"
"042110","에스씨디","71576084284","1481","48329564","48329564","0","2024-09"
"298060","에스씨엠생명과학","40000492550","1955","20460610","20467248","6638","2024-09"
"065420","에스아이리소스","18036832968","252","71574734","71577299","2565","2024-09"
"103230","에스앤더블류","25272000000","3510","7200000","7200000","0","2024-09"
"260970","에스앤디","99800013000","34500","2892754","2892754","0","2024-09"
"101490","에스앤에스텍","469284480000","22400","20950200","21451447","501247","2024-09"
"095910","에스에너지","28395159244","1523","18644228","19504503","860275","2024-09"
"275630","에스에스알","17395747720","3215","5410808","6017989","607181","2024-09"
"031330","에스에이엠티","299463355690","3070","97545067","99995067","2450000","2024-09"
"060540","에스에이티","37370095620","1430","26132934","26133306","372","2024-09"
"351320","에스에이티이엔지","35445238360","1610","22015676","22015886","210","2024-09"
"056190","에스에프에이","664423316100","21150","31414814","35908760","4493946","2024-09"
"080000","에스엔유","57927732018","1693","34216026","34322870","106844","2024-09"
"005850","에스엘","1526738565300","33150","46055462","46448520","393058","2024-09"
"214310","에스엘에너지","22487615640","6120","3674447","3679130","4683","2024-09"
"246250","에스엘에스바이오","40058817660","2610","15348206","15348206","0","2024-09"
"041510","에스엠","1609496707000","70300","22894690","23353627","458937","2024-09"
"010580","에스엠벡셀","136327390836","1227","111106268","111251760","145492","2024-09"
"007820","에스엠코어","93466026360","4780","19553562","20033946","480384","2024-09"
"464080","에스오에스랩","95128245400","5380","17681830","17681830","0","2024-09"
"109610","에스와이","181241647950","3795","47758010","48907400","1149390","2024-09"
"365330","에스와이스틸텍","185190500000","6050","30610000","30610000","0","2024-09"
"012750","에스원","2126664033100","62900","33810239","37999178","4188939","2024-09"
"031860","에스유홀딩스","16899257250","1125","15021562","15026356","4794","2024-09"
"306040","에스제이그룹","54607556800","5800","9415096","9865828","450732","2024-09"
"457940","에스케이증권제10호스팩","7050300000","2130","3310000","3310000","0","2024-09"
"472230","에스케이증권제11호스팩","8663175000","2085","4155000","4155000","0","2024-09"
"473000","에스케이증권제12호스팩","6934450000","2095","3310000","3310000","0","2024-09"
"473950","에스케이증권제13호스팩","9105200000","2060","4420000","4420000","0","2024-09"
"435870","에스케이증권제8호스팩","7812000000","2100","3720000","3720000","0","2024-09"
"455910","에스케이증권제9호스팩","10692600000","2130","5020000","5020000","0","2024-09"
"096630","에스코넥","55225561140","708","78002205","79052205","1050000","2024-09"
"069510","에스텍","90912100000","10810","8410000","10910000","2500000","2024-09"
"234300","에스트래픽","115172099775","4185","27520215","27809848","289633","2024-09"
"039440","에스티아이","287667157440","19520","14737047","15830000","1092953","2024-09"
"098660","에스티오","34409098080","2835","12137248","12500976","363728","2024-09"
"052020","에스티큐브","255610484520","5480","46644249","46694249","50000","2024-09"
"237690","에스티팜","1956478237000","97300","20107690","20107690","0","2024-09"
"050760","에스폴리텍","23920849181","1549","15442769","16334678","891909","2024-09"
"288620","에스퓨얼셀","72445300080","10380","6979316","6979316","0","2024-09"
"443670","에스피소프트","152457467400","6300","24199598","24201392","1794","2024-09"
"317830","에스피시스템스","52684319240","5180","10170718","10773818","603100","2024-09"
"058610","에스피지","461289088000","20800","22177360","22177360","0","2024-09"
"043340","에쎈테크","44650000000","470","95000000","95000000","0","2024-09"
"023960","에쓰씨엔지니어링","59903753478","1763","33978306","33978308","2","2024-09"
"298690","에어부산","272801842560","2340","116581984","116640000","58016","2024-09"
"054630","에이디칩스","12594094838","158","79709461","79709461","0","2024-09"
"200710","에이디테크놀로지","185251366300","14300","12954641","13440822","486181","2024-09"
"096690","에이루트","42576475584","1272","33472072","33477189","5117","2024-09"
"078520","에이블씨엔씨","181318681260","6970","26014158","26014161","3","2024-09"
"298380","에이비엘바이오","1772963414100","36900","48047789","48047789","0","2024-09"
"203400","에이비온","208608864440","8270","25224772","25224772","0","2024-09"
"195990","에이비프로바이오","149176462744","524","284687906","284689721","1815","2024-09"
"003800","에이스침대","286621056750","27150","10556945","11090000","533055","2024-09"
"088800","에이스테크","125983226866","994","126743689","127068928","325239","2024-09"
"241840","에이스토리","61338717850","6610","9279685","9539994","260309","2024-09"
"453860","에이에스텍","130455227250","23150","5635215","5657215","22000","2024-09"
"312610","에이에프더블류","31398176400","1550","20256888","20256888","0","2024-09"
"015260","에이엔피","31218291496","692","45113138","45116894","3756","2024-09"
"172670","에이엘티","77515593750","8750","8858925","8960259","101334","2024-09"
"445090","에이직랜드","400168134900","37150","10771686","10771686","0","2024-09"
"295310","에이치브이엠","197929112530","16630","11901931","11901931","0","2024-09"
"072990","에이치시티","72211491600","10200","7079558","7287341","207783","2024-09"
"044990","에이치엔에스하이텍","136452366720","16980","8036064","8036064",,"자료 없음"
"239610","에이치엘사이언스","80468625800","15800","5092951","5392115","299164","2024-09"
"462020","에이치엠씨제6호스팩","8820350000","2030","4345000","4345000","0","2024-09"
"477340","에이치엠씨제7호스팩","14959920000","1992","7510000","7510000","0","2024-09"
"148930","에이치와이티씨","42971505200","4420","9722060","10175213","453153","2024-09"
"044780","에이치케이","23131562580","1260","18358383","18505787","147404","2024-09"
"357230","에이치피오","119887057955","2905","41269211","42089487","820276","2024-09"
"355690","에이텀","32970378000","6100","5404980","5404980","0","2024-09"
"071670","에이테크솔루션","62600000000","6260","10000000","10000000","0","2024-09"
"045660","에이텍","111946341360","14840","7543554","8260000","716446","2024-09"
"224110","에이텍모빌리티","64271075900","13100","4906189","5340000","433811","2024-09"
"021080","에이티넘인베스트","113836573125","2475","45994575","48000000","2005425","2024-09"
"200470","에이팩트","117128245185","2765","42361029","42362093","1064","2024-09"
"262260","에이프로","99685720920","6920","14405451","14468152","62701","2024-09"
"007460","에이프로젠","287646630290","1081","266093090","286851768","20758678","2024-09"
"003060","에이프로젠바이오로직스","158058244800","800","197572806","198407845","835039","2024-09"
"397030","에이프릴바이오","481078501200","21950","21917016","21917016","0","2024-09"
"244920","에이플러스에셋","92804579765","4105","22607693","22607693","0","2024-09"
"278470","에이피알","1984308631500","266500","7445811","7622678","176867","2024-09"
"230240","에치에프알","130450313560","9940","13123774","13309000","185226","2024-09"
"230360","에코마케팅","334190467980","10620","31468029","31468029","0","2024-09"
"038870","에코바이오","54299456625","3875","14012763","14014949","2186","2024-09"
"097780","에코볼트","59264045750","875","67730338","67730338","0","2024-09"
"448280","에코아이","185688408400","18800","9877043","9877043","0","2024-09"
"101360","에코앤드림","652772431200","37200","17547646","17786114","238468","2024-09"
"128540","에코캡","32177370532","1238","25991414","26690460","699046","2024-09"
"086520","에코프로","10302388229000","78200","131744095","133138340","1394245","2024-09"
"450080","에코프로머티","7597765780000","110000","69070598","69070598","0","2024-09"
"247540","에코프로비엠","15391228765600","157600","97660081","97801344","141263","2024-09"
"383310","에코프로에이치엔","657868179400","43150","15246076","15304932","58856","2024-09"
"038110","에코플라스틱","110089742120","2740","40178738","41169370","990632","2024-09"
"073540","에프알텍","14694600000","1289","11400000","11400000","0","2024-09"
"064850","에프앤가이드","118096936200","10350","11410332","11410332","0","2024-09"
"036810","에프에스티","344240862000","17250","19955992","21756789","1800797","2024-09"
"173940","에프엔씨엔터","55233196700","3700","14927891","15392808","464917","2024-09"
"083500","에프엔에스테크","76496838000","9570","7993400","8575722","582322","2024-09"
"054940","엑사이엔씨","23520045532","709","33173548","33173548","0","2024-09"
"373110","엑셀세라퓨틱스","62999525740","5770","10918462","10918462","0","2024-09"
"205100","엑셈","121392160792","1687","71957416","71963431","6015","2024-09"
"356680","엑스게이트","158930937740","5570","28533382","28543492","10110","2024-09"
"070300","엑스큐어","37874587630","4535","8351618","8351618","0","2024-09"
"317770","엑스페릭스","75698389800","3300","22938906","22938906","0","2024-09"
"373200","엑스플러스","49510988904","654","75704876","75705657","781","2024-09"
"069920","엑시온그룹","45471255984","1299","35004816","35194116","189300","2024-09"
"092870","엑시콘","143152583050","11450","12502409","13050797","548388","2024-09"
"317870","엔바이오니아","155503390000","18280","8506750","8506750","0","2024-09"
"067570","엔브이에이치코리아","101978680040","2440","41794541","42170000","375459","2024-09"
"236810","엔비티","57898622500","3590","16127750","16975426","847676","2024-09"
"333620","엔시스","95779577430","9270","10332209","10556344","224135","2024-09"
"101400","엔시트론","26542852042","427","62161246","62162413","1167","2024-09"
"036570","엔씨소프트","4265885855000","213500","19980730","21954022","1973292","2024-09"
"078860","엔에스이엔엠","97122767300","9230","10522510","10531054","8544","2024-09"
"422040","엔에이치스팩23호","15036000000","2100","7160000","7160000","0","2024-09"
"437780","엔에이치스팩24호","10663600000","2120","5030000","5030000","0","2024-09"
"438580","엔에이치스팩25호","6613800000","2190","3020000","3020000","0","2024-09"
"439410","엔에이치스팩26호","18348000000","2085","8800000","8800000","0","2024-09"
"440820","엔에이치스팩27호","16341000000","2095","7800000","7800000","0","2024-09"
"451700","엔에이치스팩29호","28771750000","2005","14350000","14350000","0","2024-09"
"466910","엔에이치스팩30호","18118100000","1991","9100000","9100000","0","2024-09"
"481890","엔에이치스팩31호","12848625000","2025","6345000","6345000","0","2024-09"
"265740","엔에프씨","51089896000","5720","8931800","8931800","0","2024-09"
"354200","엔젠바이오","39841603600","2900","13738484","13738484","0","2024-09"
"455900","엔젤로보틱스","373634525000","25000","14945381","14945381","0","2024-09"
"419080","엔젯","93202850910","9230","10097817","10517817","420000","2024-09"
"208860","엔지스테크널러지","41831348265","2205","18971133","18971133","0","2024-09"
"183490","엔지켐생명과학","114885792677","1439","79837243","85065562","5228319","2024-09"
"085310","엔케이","60580087296","768","78880322","79983352","1103030","2024-09"
"182400","엔케이맥스","172744574320","2020","85517116","85518831","1715","2024-09"
"348370","엔켐","3749960909200","180400","20786923","20786923","0","2024-09"
"069410","엔텔스","34953596850","3525","9915914","10244824","328910","2024-09"
"227950","엔투텍","42465967300","410","103575530","103575530","0","2024-09"
"291230","엔피","90837271780","2060","44095763","44095775","12","2024-09"
"198080","엔피디","52653527325","2445","21535185","21535185","0","2024-09"
"048830","엔피케이","21985786872","1176","18695397","18723923","28526","2024-09"
"096870","엘디티","15159968000","2270","6678400","6678400","0","2024-09"
"290650","엘앤씨바이오","420351030230","18530","22684891","22684891","0","2024-09"
"066970","엘앤에프","3392686199700","101100","33557727","36296338","2738611","2024-09"
"156100","엘앤케이바이오","147332456870","7390","19936733","19936743","10","2024-09"
"073110","엘엠에스","36790234080","6360","5784628","8895755","3111127","2024-09"
"083310","엘오티베큠","151121377460","9340","16180019","17810033","1630014","2024-09"
"037950","엘컴텍","101540907621","1203","84406407","84447519","41112","2024-09"
"170920","엘티씨","97410243000","10500","9277166","9805620","528454","2024-09"
"058630","엠게임","117382241940","6310","18602574","19543877","941303","2024-09"
"058970","엠로","552383258800","46600","11853718","11853718","0","2024-09"
"019590","엠벤처투자","104963185182","921","113966542","113966542","0","2024-09"
"169330","엠브레인","38976435010","2195","17756918","18256918","500000","2024-09"
"097520","엠씨넥스","289407188320","16760","17267732","17977732","710000","2024-09"
"373170","엠아이큐브솔루션","39295854000","7800","5037930","5037930","0","2024-09"
"179290","엠아이텍","273166322320","8440","32365678","32365678","0","2024-09"
"009780","엠에스씨","90816000000","5160","17600000","17600000","0","2024-09"
"123040","엠에스오토텍","170519954700","3100","55006437","69172213","14165776","2024-09"
"323230","엠에프엠코리아","6967193212","161","43274492","43274492","0","2024-06"
"032790","엠젠솔루션","59062388160","1380","42798832","42798832","0","2024-09"
"033160","엠케이전자","173288605700","8290","20903330","22066331","1163001","2024-09"
"347890","엠투아이","92426304700","5650","16358638","16913204","554566","2024-09"
"033310","엠투엔","78412845336","1981","39582456","40342231","759775","2024-09"
"259630","엠플러스","114322796470","9470","12072101","12282402","210301","2024-09"
"105550","엣지파운드리","136339133175","2385","57165255","57165255","0","2024-09"
"060850","영림원소프트랩","54721630000","6730","8131000","8131000","0","2024-09"
"014440","영보화학","65715000000","3370","19500000","20000000","500000","2024-09"
"143540","영우디에스피","32284545200","739","43686800","44599895","913095","2024-09"
"111770","영원무역","1714996679700","40100","42767997","44311468","1543471","2024-09"
"009970","영원무역홀딩스","1060687677200","91400","11604898","13635592","2030694","2024-09"
"003520","영진약품","427053880090","2335","182892454","182892731","277","2024-09"
"000670","영풍","634729446000","369000","1720134","1842040","121906","2024-09"
"036560","영풍정밀","357525000000","22700","15750000","15750000","0","2024-09"
"006740","영풍제지","53796069810","1218","44167545","46482148","2314603","2024-09"
"012280","영화금속","38630312315","763","50629505","51664505","1035000","2024-09"
"265560","영화테크","93785151200","8840","10609180","10690180","81000","2024-09"
"012160","영흥","32040042410","470","68170303","101310372","33140069","2024-09"
"036000","예림당","49984381090","2170","23034277","23034277","0","2024-09"
"250930","예선테크","16830389005","515","32680367","33000440","320073","2024-09"
"053280","예스24","153411903280","6140","24985652","25000000","14348","2024-09"
"015360","예스코홀딩스","218331000000","51000","4281000","6000000","1719000","2024-09"
"122640","예스티","394258695000","19560","20156375","20930108","773733","2024-09"
"045060","오공","45828039670","2705","16941974","16941974","0","2024-09"
"080520","오디텍","35498743840","3430","10349488","11746609","1397121","2024-09"
"007310","오뚜기","1411843733500","410500","3439327","4007830","568503","2024-09"
"039830","오로라","54260360100","5490","9883490","10762890","879400","2024-09"
"322310","오로스테크놀로지","145072336500","15750","9210942","9366542","155600","2024-09"
"046120","오르비텍","64818100160","2390","27120544","27449486","328942","2024-09"
"014940","오리엔탈정공","159870984390","3510","45547289","45573661","26372","2024-09"
"002630","오리엔트바이오","53355656700","450","118568126","118583005","14879","2024-09"
"065500","오리엔트정공","36993161964","1166","31726554","31742912","16358","2024-09"
"271560","오리온","3826386678400","96800","39528788","39536132","7344","2024-09"
"001800","오리온홀딩스","988975375320","16440","60156653","62645422","2488769","2024-09"
"010470","오리콤","75662872200","6520","11604735","11975050","370315","2024-09"
"417860","오브젠","43287098780","9770","4430614","4430614","0","2024-09"
"352910","오비고","85557919540","6770","12637802","12637802","0","2024-09"
"053980","오상자이엘","69545892130","3685","18872698","18982783","110085","2024-09"
"036220","오상헬스케어","173451955050","12650","13711617","14489416","777799","2024-09"
"052420","오성첨단소재","137502599850","1650","83334909","86315192","2980283","2024-09"
"039200","오스코텍","1097607851200","28700","38244176","38244176","0","2024-09"
"226400","오스테오닉","108514516120","5480","19801919","20661601","859682","2024-09"
"031510","오스템","34340233053","1311","26193923","28000000","1806077","2024-09"
"368970","오에스피","30188096800","3230","9346160","9346160","0","2024-09"
"138080","오이솔루션","101934800000","10000","10193480","10624095","430615","2024-09"
"080580","오킨스전자","94959373200","5520","17202785","17679298","476513","2024-09"
"067170","오텍","48512427935","3415","14205689","15391605","1185916","2024-09"
"353590","오토앤","60064534050","4665","12875570","12875570","0","2024-09"
"173130","오파스넷","111127075680","8520","13043084","13046473","3389","2024-09"
"440320","오픈놀","43240050000","4410","9805000","9805000","0","2024-09"
"049480","오픈베이스","67044492960","2235","29997536","31422383","1424847","2024-09"
"394280","오픈엣지테크놀로지","255654675900","11700","21850827","21850827","0","2024-09"
"309930","오하임앤컴퍼니","41049518973","1999","20535027","21290990","755963","2024-09"
"244460","올리패스","18290883206","454","40288289","40290730","2441","2024-09"
"226950","올릭스","467155843300","27100","17238223","17238223","0","2024-09"
"057540","옴니시스템","44686102782","753","59344094","61449355","2105261","2024-09"
"131030","옵투스제약","97602540570","6390","15274263","16153162","878899","2024-09"
"082210","옵트론텍","57891045425","2075","27899299","28566538","667239","2024-09"
"109080","옵티시스","33342413070","7010","4756407","5636000","879593","2024-09"
"380540","옵티코어","33187028312","1156","28708502","29779596","1071094","2024-09"
"153710","옵티팜","76430481180","5210","14669958","14669958","0","2024-09"
"432430","와이랩","80551479600","4905","16422320","16422320","0","2024-09"
"338840","와이바이오로직스","166895530800","11300","14769516","14769516","0","2024-09"
"122990","와이솔","168242920640","6080","27671533","28186941","515408","2024-09"
"232140","와이씨","891291906340","11110","80224294","82045350","1821056","2024-09"
"112290","와이씨켐","169553839650","16770","10110545","10110545","0","2024-09"
"065530","와이어블","68457264129","1431","47838759","52860000","5021241","2024-09"
"067900","와이엔텍","114208848290","6310","18099659","18199659","100000","2024-09"
"007530","와이엠","51935287950","2730","19023915","19174452","150537","2024-09"
"155650","와이엠씨","73445172640","4060","18089944","19474358","1384414","2024-09"
"273640","와이엠텍","122783252900","11620","10566545","10966000","399455","2024-09"
"251370","와이엠티","133615460160","8190","16314464","16314464","0","2024-09"
"066430","와이오엠","22195284174","567","39145122","39153476","8354","2024-09"
"209640","와이제이링크","240344583700","16900","14221573","14221573",,"자료 없음"
"273060","와이즈버즈","46170511125","915","50459575","50459582","7","2024-09"
"019210","와이지-원","168540571380","5020","33573819","33573819","0","2024-09"
"122870","와이지엔터테인먼트","740020432200","39900","18546878","18691049","144171","2024-09"
"011690","와이투솔루션","101844002170","2785","36568762","36574394","5632","2024-09"
"332570","와이팜","102111787800","2475","41257288","42233850","976562","2024-09"
"079000","와토스코리아","36102335720","5080","7106759","7200000","93241","2024-09"
"403490","우듬지팜","83685163035","1851","45210785","45212464","1679","2024-09"
"316140","우리금융지주","12682541456480","17080","742537556","742591501","53945","2024-09"
"032820","우리기술","356634997700","2245","158857460","158859048","1588","2024-09"
"041190","우리기술투자","642437037000","8250","77871156","84000000","6128844","2024-09"
"115440","우리넷","84212973950","8050","10461239","10754239","293000","2024-09"
"046970","우리로","51080807789","1177","43399157","43824999","425842","2024-09"
"082850","우리바이오","160977158980","3410","47207378","48456578","1249200","2024-09"
"215360","우리산업","109129347850","11950","9132163","9132163","0","2024-09"
"072470","우리산업홀딩스","56556768355","2995","18883729","18887341","3612","2024-09"
"073560","우리손에프앤지","96932700200","1400","69237643","69237643","0","2024-09"
"037400","우리엔터프라이즈","32132357700","1325","24250836","26223346","1972510","2024-09"
"153490","우리이앤엘","43498026000","860","50579100","51480000","900900","2024-09"
"101170","우림피티에스","66216679020","5010","13216902","13500000","283098","2024-09"
"006980","우성","40811420400","15900","2566756","3090000","523244","2024-09"
"066590","우수AMS","116420590370","3010","38677937","39073104","395167","2024-09"
"017370","우신시스템","125786572180","8090","15548402","18314054","2765652","2024-09"
"103840","우양","60637615740","3705","16366428","16366428","0","2024-09"
"046940","우원개발","40396172250","2235","18074350","18074350","0","2024-09"
"215380","우정바이오","32777317560","2085","15720536","15879576","159040","2024-09"
"065680","우주일렉트로","117281291890","14590","8038471","9530000","1491529","2024-09"
"105840","우진","157352188640","7940","19817656","20323614","505958","2024-09"
"018620","우진비앤지","29089381197","1007","28887171","28889293","2122","2024-09"
"010400","우진아이엔에스","22848867810","3390","6740079","7622000","881921","2024-09"
"457550","우진엔텍","203505891050","21950","9271339","9271339","0","2024-09"
"049800","우진플라임","45200000000","2260","20000000","20000000","0","2024-09"
"016880","웅진","69011316048","888","77715446","79927080","2211634","2024-09"
"095720","웅진씽크빅","195054427059","1731","112683089","115505985","2822896","2024-09"
"396470","워트","143951600000","8930","16120000","16120000","0","2024-09"
"005820","원림","33012121500","16050","2056830","2297970","241140","2024-09"
"307280","원바이오젠","45937377010","1295","35472878","36959013","1486135","2024-09"
"032940","원익","67405735605","3705","18193181","18193230","49","2024-09"
"240810","원익IPS","1323434768000","27200","48655690","49083901","428211","2024-09"
"074600","원익QnC","613824800000","23350","26288000","26288000","0","2024-09"
"104830","원익머트리얼즈","268550400000","21300","12608000","12608000","0","2024-09"
"014190","원익큐브","55287100902","1562","35395071","35399906","4835","2024-09"
"217820","원익피앤이","124541111770","2815","44241958","47454559","3212601","2024-09"
"030530","원익홀딩스","169952186125","2225","76383005","77237981","854976","2024-09"
"012620","원일특강","30844000000","7010","4400000","4400000","0","2024-09"
"382840","원준","212953719620","14020","15189281","15271581","82300","2024-09"
"336570","원텍","533340851220","5970","89336826","89340619","3793","2024-09"
"376980","원티드랩","41301892875","4625","8930139","9754994","824855","2024-09"
"008370","원풍","53735802120","4920","10921911","12000000","1078089","2024-09"
"008290","원풍물산","21416092792","536","39955397","40693679","738282","2024-09"
"101160","월덱스","313543757070","18990","16510993","16510993","0","2024-09"
"336060","웨이버스","62938846400","1307","48155200","48155200","0","2024-09"
"095270","웨이브일렉트로","59083235540","4630","12760958","14971256","2210298","2024-09"
"289930","웨이비스","135255008790","10890","12420111","12420111",,"자료 없음"
"010600","웰바이오텍","49552926545","545","90922801","90923407","606","2024-09"
"065950","웰크론","60759741830","2230","27246521","28231302","984781","2024-09"
"076080","웰크론한텍","32358843546","1466","22072881","22594156","521275","2024-09"
"043590","웰킵스하이텍","19386906528","726","26703728","27136762","433034","2024-09"
"196700","웹스","19176132240","1335","14364144","14364144","0","2024-09"
"069080","웹젠","469111694800","15920","29466815","34950884","5484069","2024-09"
"053580","웹케시","89893713710","7030","12787157","13636248","849091","2024-09"
"071460","위니아","21802751835","613","35567295","35967295","400000","2024-09"
"377460","위니아에이드","26030247855","1691","15393405","15393405","0","2024-09"
"044340","위닉스","89788894720","5680","15807904","17873425","2065521","2024-09"
"330350","위더스제약","92661753600","7020","13199680","13202139","2459","2024-09"
"348350","위드텍","74963512000","7670","9773600","10183600","410000","2024-09"
"112040","위메이드","1127787309550","33550","33615121","33948483","333362","2024-09"
"101730","위메이드맥스","316269895220","9580","33013559","33295292","281733","2024-09"
"123420","위메이드플레이","76135620120","7320","10401041","11469842","1068801","2024-09"
"065370","위세아이텍","30627864540","4410","6945094","7383954","438860","2024-09"
"038620","위즈코프","38145428457","607","62842551","66546465","3703914","2024-09"
"299900","위지윅스튜디오","204843147756","1209","169431884","171048884","1617000","2024-09"
"036090","위지트","81972077325","695","117945435","118392284","446849","2024-09"
"136540","윈스","152553792960","12340","12362544","13644162","1281618","2024-09"
"097800","윈팩","174908243958","1502","116450229","116450229","0","2024-09"
"192390","윈하이텍","40367841745","3695","10924991","10924991","0","2024-09"
"008600","윌비스","29478126720","448","65799390","67236039","1436649","2024-09"
"335870","윙스풋","18416289888","1104","16681422","16681422","0","2024-09"
"033270","유나이티드제약","304523268300","20700","14711269","16333822","1622553","2024-09"
"014830","유니드","432858170800","65200","6638929","6767600","128671","2024-09"
"446070","유니드비티플러스","45399954600","4440","10225215","10611215","386000","2024-09"
"036200","유니셈","193851789270","6590","29416053","30664223","1248170","2024-09"
"018000","유니슨","114506263520","680","168391564","168391564","0","2024-09"
"000910","유니온","68222775030","4370","15611619","15611619","0","2024-09"
"047400","유니온머티리얼","99750000000","2375","42000000","42000000","0","2024-09"
"203450","유니온커뮤니티","32447977605","2635","12314223","14079007","1764784","2024-09"
"011330","유니켐","138365924620","1540","89848003","96997167","7149164","2024-09"
"077500","유니퀘스트","92880438600","4300","21600102","21794015","193913","2024-09"
"011320","유니크","75350710500","3900","19320695","19320695","0","2024-09"
"086390","유니테스트","206581420720","10160","20332817","21134126","801309","2024-09"
"241690","유니테크노","86626299240","3540","24470706","24470706","0","2024-09"
"142210","유니트론텍","88776808330","4690","18928957","19246092","317135","2024-09"
"088340","유라클","48496761600","11200","4330068","4330068","0","2024-09"
"048430","유라테크","74902306080","6540","11452952","11520000","67048","2024-09"
"206650","유바이오로직스","447545260750","12250","36534307","36534307","0","2024-09"
"089850","유비벨록스","99501001200","6840","14546930","14730199","183269","2024-09"
"084440","유비온","15750527200","799","19712800","19712800","0","2024-09"
"032620","유비케어","188001488610","3705","50742642","52197139","1454497","2024-09"
"264450","유비쿼스","139138790110","13990","9945589","10245706","300117","2024-09"
"078070","유비쿼스홀딩스","158523974400","9600","16512914","18150700","1637786","2024-09"
"002920","유성기업","51192410000","1996","25647500","25947500","300000","2024-09"
"024800","유성티엔에스","65495297808","1961","33398928","37051812","3652884","2024-09"
"000700","유수홀딩스","125434449920","5120","24498916","26041812","1542896","2024-09"
"054930","유신","66150000000","22050","3000000","3000000","0","2024-09"
"069330","유아이디","17351967930","1230","14107291","14191091","83800","2024-09"
"049520","유아이엘","105106960440","4915","21384936","21784936","400000","2024-09"
"435380","유안타제10호스팩","11947050000","2085","5730000","5730000","0","2024-09"
"444920","유안타제11호스팩","10794400000","2060","5240000","5240000","0","2024-09"
"446150","유안타제12호스팩","9754650000","2045","4770000","4770000","0","2024-09"
"449020","유안타제13호스팩","19654600000","2020","9730000","9730000","0","2024-09"
"450940","유안타제14호스팩","9624800000","2120","4540000","4540000","0","2024-09"
"473050","유안타제15호스팩","14090100000","2010","7010000","7010000","0","2024-09"
"474490","유안타제16호스팩","11185300000","2030","5510000","5510000","0","2024-09"
"430700","유안타제9호스팩","11056400000","2110","5240000","5240000","0","2024-09"
"003470","유안타증권","558772298700","2900","192680103","199596576","6916473","2024-09"
"263770","유에스티","49729273785","2115","23512659","23700172","187513","2024-09"
"072130","유엔젤","57139565520","4780","11953884","13195454","1241570","2024-09"
"000220","유유제약","69747320630","4310","16182673","17032351","849678","2024-09"
"388720","유일로보틱스","367655231400","32100","11453434","11453434","0","2024-09"
"340930","유일에너테크","76393968000","2240","34104450","34204450","100000","2024-09"
"023410","유진기업","234060060055","3415","68538817","77310863","8772046","2024-09"
"056080","유진로봇","198064162560","5280","37512152","37512152","0","2024-09"
"468760","유진스팩10호","9116000000","2150","4240000","4240000","0","2024-09"
"442130","유진스팩9호","7819600000","2260","3460000","3460000","0","2024-09"
"084370","유진테크","779623809500","35050","22243190","22916042","672852","2024-09"
"240600","유진테크놀로지","42509029000","6200","6856295","6928151","71856","2024-09"
"001200","유진투자증권","361387035575","3935","91839145","96866418","5027273","2024-09"
"221800","유투바이오","35046743580","3105","11287196","11287196","0","2024-09"
"179900","유티아이","375762833750","23750","15821593","16286895","465302","2024-09"
"263050","유틸렉스","78741043200","2140","36794880","36798858","3978","2024-09"
"000100","유한양행","10877226019000","147400","73793935","80209064","6415129","2024-09"
"003460","유화증권","102493451200","2240","45756005","56702415","10946410","2024-09"
"191410","육일씨엔에쓰","18755922870","1674","11204255","11204255","0","2024-09"
"372170","윤성에프앤씨","410920972000","51500","7979048","7979048","0","2024-09"
"146060","율촌","29513131031","1229","24013939","24015595","1656","2024-09"
"008730","율촌화학","683240000000","27550","24800000","24800000","0","2024-09"
"072770","율호","142232444100","2025","70238244","70238244","0","2024-09"
"008250","이건산업","51070698180","4995","10224364","10952635","728271","2024-09"
"039020","이건홀딩스","72125205930","3330","21659221","22584709","925488","2024-09"
"025820","이구산업","147473879490","4410","33440789","33442000","1211","2024-09"
"067920","이글루","52301491155","4995","10470769","10996119","525350","2024-09"
"044960","이글벳","60883489120","4960","12274897","12641883","366986","2024-09"
"303530","이노뎁","53338425000","7500","7111790","7339299","227509","2024-09"
"296640","이노룰스","28359402720","5610","5055152","5178252","123100","2024-09"
"302430","이노메트리","88447725000","9000","9827525","9833208","5683","2024-09"
"214320","이노션","781200000000","19530","40000000","40000000","0","2024-09"
"462350","이노스페이스","174481665340","18610","9375694","9375694","0","2024-09"
"274400","이노시뮬레이션","39568319560","5060","7819826","7819826","0","2024-09"
"056090","이노시스","121087041075","1287","94084725","94084725","0","2024-09"
"073490","이노와이어리스","125843651300","16550","7603846","7603846","0","2024-09"
"215790","이노인스트루먼트","18449352024","458","40282428","40283149","721","2024-09"
"344860","이노진","22289712000","1864","11958000","12030000","72000","2024-09"
"088390","이녹스","94233773360","10040","9385834","9385844","10","2024-09"
"272290","이녹스첨단소재","441360653900","22900","19273391","20227658","954267","2024-09"
"053350","이니텍","67168371645","4005","16771129","19790916","3019787","2024-09"
"452400","이닉스","105954279040","11680","9071428","9071428","0","2024-09"
"264850","이랜시스","159046713000","5250","30294612","30294612","0","2024-09"
"054210","이랜텍","138371058360","5560","24886881","25291210","404329","2024-09"
"009730","이렘","63449292062","1378","46044479","46056774","12295","2024-09"
"065440","이루온","35450780598","1341","26436078","27275020","838942","2024-09"
"139480","이마트","1658199050700","61900","26788353","27875819","1087466","2024-09"
"115610","이미지스","59884181000","3800","15758995","15758995","0","2024-09"
"478110","이베스트스팩6호","10140400000","2020","5020000","5020000","0","2024-09"
"131400","이브이첨단소재","123938201920","2080","59585674","59589882","4208","2024-09"
"351330","이삭엔지니어링","64981996800","7840","8288520","8288520","0","2024-09"
"080010","이상네트웍스","50845672880","5360","9486133","9835071","348938","2024-09"
"457190","이수스페셜티케미컬","1231967834750","41150","29938465","30208280","269815","2024-09"
"086890","이수앱지스","225465395240","6280","35902133","35902133","0","2024-09"
"007660","이수페타시스","2770193152200","43800","63246419","63246419","0","2024-09"
"005950","이수화학","166254162180","7530","22078906","22722739","643833","2024-09"
"015020","이스타코","25745814858","662","38890959","42851600","3960641","2024-09"
"047560","이스트소프트","124974509440","12160","10277509","11603992","1326483","2024-09"
"239340","이스트에이드","45595459780","1690","26979562","26979634","72","2024-09"
"067010","이씨에스","33312971250","2925","11389050","12294000","904950","2024-09"
"093230","이아이디","354065768064","1392","254357592","254384360","26768","2024-09"
"418620","이에이트","132887068290","13770","9650477","9650477","0","2024-09"
"456070","이엔셀","225849006000","21200","10653255","10653255","0","2024-09"
"102710","이엔에프테크놀로지","234034753680","16380","14287836","14287836","0","2024-09"
"074610","이엔플러스","104558988825","1425","73374729","73374729","0","2024-09"
"041520","이엘씨","63988721870","5470","11698121","12188730","490609","2024-09"
"063760","이엘피","21278516600","2410","8829260","9325130","495870","2024-09"
"123570","이엠넷","55945197980","2620","21353129","22276078","922949","2024-09"
"083470","이엠앤아이","28764866856","1348","21338922","21340329","1407","2024-09"
"095190","이엠코리아","100156696120","2210","45319772","45319772","0","2024-09"
"091120","이엠텍","443802186000","27000","16437118","17132936","695818","2024-09"
"102460","이연제약","290704707350","15850","18340991","18586811","245820","2024-09"
"039030","이오테크닉스","2040422995800","168600","12102153","12319550","217397","2024-09"
"294090","이오플로우","177439891970","5830","30435659","30435659","0","2024-09"
"088290","이원컴포텍","36344241880","1160","31331243","31331669","426","2024-09"
"084680","이월드","259921192674","1833","141800978","141806193","5215","2024-09"
"353810","이지바이오","115392564000","3450","33447120","34191720","744600","2024-09"
"099750","이지케어텍","110693453580","16470","6720914","6834776","113862","2024-09"
"377330","이지트로닉스","43816524800","5540","7909120","8139954","230834","2024-09"
"035810","이지홀딩스","165804112830","2570","64515219","65145845","630626","2024-09"
"160600","이큐셀","106346383500","3100","34305285","34482552","177267","2024-09"
"092130","이크레더블","152592412000","12670","12043600","12043600","0","2024-09"
"096040","이트론","245561522409","271","906131079","906131295","216","2024-09"
"134060","이퓨쳐","15905641380","4135","3846588","4769250","922662","2024-09"
"001840","이화공영","47033944250","2375","19803766","19805760","1994","2024-09"
"000760","이화산업","32368000000","11560","2800000","2800000","0","2024-09"
"024810","이화전기","196810080587","899","218921113","218948640","27527","2024-09"
"014990","인디에프","54079192800","720","75109990","75112995","3005","2024-09"
"041830","인바디","302874192750","23250","13026847","13683782","656935","2024-09"
"352940","인바이오","24398053850","2245","10867730","10867730","0","2024-09"
"101140","인바이오젠","93257770480","9340","9984772","10044216","59444","2024-09"
"079950","인베니아","16843670000","773","21790000","23200000","1410000","2024-09"
"389470","인벤티지랩","182182463840","18160","10032074","10032074","0","2024-09"
"277410","인산가","51639659340","1370","37693182","38356789","663607","2024-09"
"060150","인선이엔티","243388841130","5430","44822991","46563612","1740621","2024-09"
"033230","인성정보","100715273010","2010","50107101","50515380","408279","2024-09"
"450520","인스웨이브시스템즈","46319420700","3150","14704578","14704578","0","2024-09"
"006490","인스코비","193335064416","1632","118465113","119368998","903885","2024-09"
"465480","인스피언","106953494600","10550","10137772","10137772",,"자료 없음"
"037330","인지디스플레","62386444484","1547","40327372","43885224","3557852","2024-09"
"100030","인지소프트","46288803500","16850","2747110","3283714","536604","2024-09"
"023800","인지컨트롤스","93135799580","6140","15168697","15809197","640500","2024-09"
"034590","인천도시가스","105523174400","25600","4121999","4374754","252755","2024-09"
"211050","인카금융서비스","256418247750","5250","48841571","51379800","2538229","2024-09"
"083640","인콘","25678021608","333","77111176","77720351","609175","2024-09"
"064090","인크레더블버즈","189014568800","3800","49740676","49742745","2069","2024-09"
"216050","인크로스","87991685100","7290","12070190","12843222","773032","2024-09"
"049070","인탑스","306681233840","19280","15906703","17200000","1293297","2024-09"
"119610","인터로조","312050211300","24900","12532137","13216478","684341","2024-09"
"017250","인터엠","20893321944","1032","20245467","21045467","800000","2024-09"
"129260","인터지스","61930019740","2195","28214132","29747874","1533742","2024-09"
"051370","인터플렉스","227442852000","9750","23327472","23327472","0","2024-09"
"064290","인텍플러스","160107534080","12920","12392224","12863962","471738","2024-09"
"189300","인텔리안테크","508894012800","48800","10428156","10733334","305178","2024-09"
"150840","인트로메딕","251537720850","5850","42997901","42997901","0","2024-09"
"048530","인트론바이오","189122611500","5780","32720175","34150762","1430587","2024-09"
"023810","인팩","71200000000","7120","10000000","10000000","0","2024-09"
"115310","인포바인","42529637350","19850","2142551","3192883","1050332","2024-09"
"039290","인포뱅크","48377863800","5800","8341011","8693978","352967","2024-09"
"071200","인피니트헬스케어","104331218840","4280","24376453","24396458","20005","2024-09"
"101930","인화정공","217163155300","22850","9503858","9615733","111875","2024-09"
"249420","일동제약","378204235640","13540","27932366","28062501","130135","2024-09"
"000230","일동홀딩스","87400776600","7740","11292090","11540400","248310","2024-09"
"013360","일성건설","63641308640","1178","54024880","54024880","0","2024-09"
"003120","일성아이에스","108096573780","15860","6815673","13300000","6484327","2024-09"
"333430","일승","87133128360","2840","30680679","30726747","46068","2024-09"
"068330","일신바이오","50012109600","1200","41676758","44216140","2539382","2024-09"
"003200","일신방직","166998350400","7840","21300810","23280000","1979190","2024-09"
"007110","일신석재","99418848840","1284","77429010","77456610","27600","2024-09"
"007570","일양약품","227895408320","12680","17972824","19085664","1112840","2024-09"
"178780","일월지엠엘","124101377000","8650","14346980","14349195","2215","2024-09"
"008500","일정실업","14427543570","12210","1181617","1200000","18383","2024-09"
"019540","일지테크","55627260460","4210","13213126","13513500","300374","2024-09"
"081000","일진다이아","170235578700","11990","14198130","14202975","4845","2024-09"
"020760","일진디스플","46974678091","913","51450907","51513741","62834","2024-09"
"103590","일진전기","1153789909800","24200","47677269","47685390","8121","2024-09"
"094820","일진파워","152445747990","10110","15078709","15078709","0","2024-09"
"271940","일진하이솔루스","731710778500","20150","36313190","36313190","0","2024-09"
"015860","일진홀딩스","185321714110","4030","45985537","49347483","3361946","2024-09"
"226320","잇츠한불","204177379150","11590","17616685","21929315","4312630","2024-09"
"049550","잉크테크","75190072295","3835","19606277","19606277","0","2024-09"
"389020","자람테크놀로지","197169455700","32150","6132798","6197730","64932","2024-09"
"254120","자비스","58230274320","1896","30712170","30754270","42100","2024-09"
"043910","자연과환경","67126556768","592","113389454","113391457","2003","2024-09"
"234920","자이글","43968581275","3275","13425521","13530910","105389","2024-09"
"289220","자이언트스텝","145782299550","6590","22121745","22121745","0","2024-09"
"317400","자이에스앤디","150353891400","3945","38112520","38782520","670000","2024-09"
"033240","자화전자","324943273200","15410","21086520","22155870","1069350","2024-09"
"174880","장원테크","11454988050","2650","4322637","4381265","58628","2024-09"
"049630","재영솔루텍","57721406970","690","83654213","83654213","0","2024-09"
"417840","저스템","56170667520","7920","7092256","7249175","156919","2024-09"
"000950","전방","22219665000","19500","1139470","1680000","540530","2024-09"
"079900","전진건설로봇","334017960000","23000","14522520","15360574","838054","2024-09"
"110020","전진바이오팜","19612219730","2165","9058762","9058762","0","2024-09"
"208140","정다운","86286383040","2640","32684236","32684246","10","2024-09"
"040420","정상제이엘에스","97251210420","6510","14938742","15677552","738810","2024-09"
"045510","정원엔시스","27009803106","858","31479957","32209292","729335","2024-09"
"217190","제너셈","73047219420","8330","8769174","8769174","0","2024-09"
"095700","제넥신","382029295200","8400","45479678","45540494","60816","2024-09"
"072520","제넨바이오","28838655818","389","74135362","74163194","27832","2024-09"
"122310","제노레이","80754676180","5990","13481582","14553844","1072262","2024-09"
"361390","제노코","115512150600","15400","7500789","7500789","0","2024-09"
"187420","제노포커스","73511995905","3105","23675361","23675361","0","2024-09"
"225220","제놀루션","53536114125","2965","18056025","19190021","1133996","2024-09"
"123330","제닉","172925560600","22100","7824686","7968680","143994","2024-09"
"381620","제닉스","118498544000","27100","4372640","4372640","0","2024-09"
"159580","제로투세븐","82734786680","4130","20032636","20032636","0","2024-09"
"147830","제룡산업","117401631270","6130","19151979","20000000","848021","2024-09"
"033100","제룡전기","878613772300","54700","16062409","16062409","0","2024-09"
"079370","제우스","355922347600","11600","30682961","31016990","334029","2024-09"
"054950","제이브이엠","230359360000","20000","11517968","12089892","571924","2024-09"
"023440","제이스코홀딩스","99710079490","1699","58687510","58687510","0","2024-09"
"090470","제이스텍","95599607510","5510","17350201","17476594","126393","2024-09"
"287410","제이시스메디칼","960860460300","12900","74485307","75692193","1206886","2024-06"
"137950","제이씨케미칼","96911850190","4490","21583931","22267814","683883","2024-09"
"033320","제이씨현시스템","80385251505","4255","18891951","19114432","222481","2024-09"
"417500","제이아이테크","108082068480","3420","31602944","32784744","1181800","2024-09"
"204270","제이앤티씨","1241242506750","21750","57068621","57848466","779845","2024-09"
"194370","제이에스코퍼레이션","221754523500","16650","13318590","13335601","17011","2024-09"
"026040","제이에스티나","25211153440","1760","14324519","16503790","2179271","2024-09"
"452160","제이엔비","55296007750","5750","9616697","9617527","830","2024-09"
"126880","제이엔케이글로벌","88502229860","3820","23168123","23204903","36780","2024-09"
"322510","제이엘케이","160540765440","10120","15863712","16195712","332000","2024-09"
"033050","제이엠아이","29769771680","935","31839328","32579342","740014","2024-09"
"094970","제이엠티","52392540090","3135","16712134","16748240","36106","2024-09"
"418550","제이오","519931541340","17580","29575173","31772273","2197100","2024-09"
"025620","제이준코스메틱","22729738640","5080","4474358","4484846","10488","2024-09"
"420570","제이투케이바이오","82736634880","14480","5713856","5732807","18951","2024-09"
"089790","제이티","41857169600","4580","9139120","10315513","1176393","2024-09"
"030000","제일기획","1859477391000","18360","101278725","115041225","13762500","2024-09"
"052670","제일바이오","56184286080","2080","27011676","29129064","2117388","2024-09"
"271980","제일약품","205021244190","14070","14571517","14704872","133355","2024-09"
"412540","제일엠앤에스","209920776350","10190","20600665","20600665","0","2024-09"
"001560","제일연마","56966220000","8370","6806000","9900000","3094000","2024-09"
"199820","제일일렉트릭","195758200000","8810","22220000","22220000","0","2024-09"
"038010","제일테크노스","53388720000","6420","8316000","9000000","684000","2024-09"
"002620","제일파마홀딩스","133247765000","8680","15351125","15973355","622230","2024-09"
"276730","제주맥주","29916898200","2520","11871785","11886605","14820","2024-09"
"080220","제주반도체","406555065280","12070","33683104","34442833","759729","2024-09"
"006220","제주은행","263455946800","8200","32128774","32128774","0","2024-09"
"089590","제주항공","712248621240","8840","80571111","80640985","69874","2024-09"
"216080","제테마","333958793300","18700","17858759","17858759","0","2024-09"
"229000","젠큐릭스","33155710875","2175","15244005","15244005","0","2024-09"
"082270","젬백스","527346083640","13290","39679916","39994174","314258","2024-09"
"044060","조광ILI","70075958688","732","95732184","95732184","0","2024-09"
"004910","조광페인트","61714384740","6030","10234558","12800000","2565442","2024-09"
"004700","조광피혁","182975534500","51500","3552923","6649138","3096215","2024-09"
"001550","조비","52177871400","10050","5191828","5192239","411","2024-09"
"462520","조선내화","202501700060","17090","11849134","11855168","6034","2024-09"
"120030","조선선재","89303537000","92200","968585","1257651","289066","2024-09"
"034940","조아제약","41451008526","1338","30979827","30979827","0","2024-09"
"067000","조이시티","108420244746","1551","69903446","69903446","0","2024-09"
"018470","조일알미늄","205523283183","1623","126631721","126631721","0","2024-09"
"002600","조흥","103080000000","171800","600000","600000","0","2024-09"
"185750","종근당","1315867886900","104300","12616183","13174420","558237","2024-09"
"063160","종근당바이오","155801235600","28400","5485959","5485962","3","2024-09"
"001630","종근당홀딩스","264210969000","55500","4760558","5009861","249303","2024-09"
"033340","좋은사람들","62339208794","643","96950558","96950558","0","2024-09"
"036930","주성엔지니어링","1273881250950","26950","47268321","47268321","0","2024-09"
"109070","주성코퍼레이션","216476814300","4100","52799223","52810230","11007","2024-09"
"044380","주연테크","21858468801","339","64479259","66403852","1924593","2024-09"
"072020","중앙백신","99686246400","10400","9585216","9658687","73471","2024-09"
"000440","중앙에너비스","97544370000","22000","4433835","6227130","1793295","2024-09"
"051980","중앙첨단소재","1162907185000","11660","99734750","99961003","226253","2024-09"
"228760","지노믹트리","414309234240","17270","23990112","24362333","372221","2024-09"
"314130","지놈앤컴퍼니","113663030510","3670","30970853","30970853","0","2024-09"
"013890","지누스","476615973650","23350","20411819","20735204","323385","2024-09"
"389030","지니너스","50628100710","1518","33351845","33351845","0","2024-09"
"043610","지니뮤직","149066098470","2565","58115438","58115438","0","2024-09"
"263860","지니언스","82300330260","9540","8626869","9444600","817731","2024-09"
"303030","지니틱스","40417587912","1131","35736152","35745668","9516","2024-09"
"036180","지더블유바이텍","53929030348","577","93464524","93464524","0","2024-09"
"208350","지란지교시큐리티","23865725400","3050","7824828","8838549","1013721","2024-09"
"144510","지씨셀","509420079900","33900","15027141","15800344","773203","2024-09"
"358570","지아이이노베이션","646022218710","14610","44217811","44217811","0","2024-09"
"382480","지아이텍","89465557410","2290","39067929","39357140","289211","2024-09"
"382800","지앤비에스 에코","104224280095","3295","31631041","31631041","0","2024-09"
"051160","지어소프트","136262603400","9380","14526930","15474430","947500","2024-09"
"053050","지에스이","116951628300","3900","29987597","29987597","0","2024-09"
"119850","지엔씨에너지","76066229700","5100","14914947","16448909","1533962","2024-09"
"065060","지엔코","34623566538","321","107861578","108008044","146466","2024-09"
"204840","지엘팜텍","82860670508","1078","76865186","76865206","20","2024-09"
"013870","지엠비코리아","71807134200","3765","19072280","19072280","0","2024-09"
"071320","지역난방공사","554621837600","47900","11578744","11578744","0","2024-09"
"270520","지오릿에너지","157679250498","993","158790786","158790786","0","2024-09"
"311320","지오엘리먼트","83760678400","6640","12614560","12614560","0","2024-09"
"388050","지투파워","128161780470","6870","18655281","18709437","54156","2024-09"
"088790","진도","22654894080","1820","12447744","12447744","0","2024-09"
"018120","진로발효","117399133360","17740","6617764","6621120","3356","2024-09"
"109820","진매트릭스","64883529750","3250","19964163","20393640","429477","2024-09"
"086060","진바이오텍","29448207540","3420","8610587","8610587","0","2024-09"
"036890","진성티이씨","166279293440","8320","19985492","22482268","2496776","2024-09"
"363250","진시스템","68180968800","10050","6784176","7006491","222315","2024-09"
"003780","진양산업","83720000000","6440","13000000","13000000","0","2024-09"
"007370","진양제약","67081313160","5910","11350476","12574867","1224391","2024-09"
"010640","진양폴리","66800000000","6680","10000000","10000000","0","2024-09"
"100250","진양홀딩스","177467552100","3175","55895292","55895292","0","2024-09"
"051630","진양화학","41633000000","2635","15800000","15800000","0","2024-09"
"272450","진에어","546256520400","10600","51533634","52200000","666366","2024-09"
"285800","진영","45965172760","2630","17477252","17477270","18","2024-09"
"011000","진원생명과학","180015682605","2255","79829571","80039035","209464","2024-09"
"002780","진흥기업","105715697378","727","145413614","145471745","58131","2024-09"
"085660","차바이오텍","960724397580","17060","56314443","56314443","0","2024-09"
"261780","차백신연구소","104884764680","3910","26824748","26824748","0","2024-09"
"351870","차이커뮤니케이션","95493169200","8580","11129740","11131089","1349","2024-09"
"009310","참엔지니어링","30973480268","367","84396404","84867419","471015","2024-09"
"094850","참좋은여행","62175261965","4645","13385417","14000000","614583","2024-09"
"004650","창해에탄올","70941731850","9350","7587351","9190885","1603534","2024-09"
"278280","천보","531255000000","53500","9930000","10000000","70000","2024-09"
"000650","천일고속","57795687000","40500","1427054","1429220","2166","2024-09"
"362320","청담글로벌","127583218240","6340","20123536","20551290","427754","2024-09"
"012600","청호ICT","116119947330","2490","46634517","46634517","0","2024-09"
"066360","체리부로","34813162890","726","47952015","47952015","0","2024-09"
"033250","체시스","46240000000","1445","32000000","32000000","0","2024-09"
"047820","초록뱀미디어","131865872400","5400","24419606","24453930","34324","2024-09"
"094360","칩스앤미디어","271047830000","13400","20227450","20823124","595674","2024-09"
"016920","카스","28334189807","1153","24574319","26493538","1919219","2024-09"
"284620","카이노스메드","131101555720","4715","27805208","28180793","375585","2024-09"
"035720","카카오","16019028677000","36500","438877498","443530908","4653410","2024-09"
"293490","카카오게임즈","1356464795860","16580","81813317","82667326","854009","2024-09"
"323410","카카오뱅크","10314737709950","21650","476431303","476963637","532334","2024-09"
"377300","카카오페이","3102898477300","23050","134615986","134615986","0","2024-09"
"140430","카티스","51978511000","3250","15993388","17922947","1929559","2024-09"
"042000","카페24","597200774300","24700","24178169","24253054","74885","2024-09"
"006380","카프로","618528628380","3660","168996893","168999996","3103","2024-09"
"313760","캐리","47566974000","6500","7317996","7417913","99917","2024-09"
"317530","캐리소프트","28635081420","4170","6866926","6971196","104270","2024-09"
"071850","캐스텍코리아","49734922900","2050","24260938","24529188","268250","2024-09"
"050110","캠시스","78219146268","1068","73238901","73824118","585217","2024-09"
"452300","캡스톤파트너스","36509624200","2590","14096380","14096380","0","2024-09"
"451760","컨텍","127202696220","8630","14739594","14940476","200882","2024-09"
"078340","컴투스","426603146850","37350","11421771","12737755","1315984","2024-09"
"063080","컴투스홀딩스","135196475000","20500","6594950","6595192","242","2024-09"
"307930","컴퍼니케이","77815850000","4985","15610000","15610000","0","2024-09"
"079190","케스피온","22298161888","592","37665814","38355514","689700","2024-09"
"263700","케어랩스","56841938470","2930","19399979","19414200","14221","2024-09"
"214370","케어젠","810364084540","16540","48994201","53715000","4720799","2024-09"
"221980","케이디켐","46998256550","12550","3744881","4034800","289919","2024-09"
"038530","케이바이오","29220700773","253","115496841","115714347","217506","2024-09"
"001620","케이비아이동국실업","62546683422","562","111293031","111293031","0","2024-09"
"424140","케이비제21호스팩","16692150000","2165","7710000","7710000","0","2024-09"
"192250","케이사인","65517422949","957","68461257","70671257","2210000","2024-09"
"431190","케이쓰리아이","41175431000","5500","7486442","7486442","0","2024-09"
"029460","케이씨","219462074330","18890","11617897","13554044","1936147","2024-09"
"115500","케이씨에스","87120000000","7260","12000000","12000000","0","2024-09"
"281820","케이씨텍","704041705400","35150","20029636","20861556","831920","2024-09"
"089150","케이씨티","36786750000","2145","17150000","17150000","0","2024-09"
"025880","케이씨피드","44514083520","2820","15785136","16715858","930722","2024-09"
"093320","케이아이엔엑스","342931743300","70900","4836837","4880000","43163","2024-09"
"093640","케이알엠","133595712000","4100","32584320","32584320","0","2024-09"
"073010","케이에스피","161078963880","4020","40069394","40191250","121856","2024-09"
"105330","케이엔더블유","62211979760","3920","15870403","16060028","189625","2024-09"
"053080","케이엔솔","199560838400","15400","12958496","12999807","41311","2024-09"
"199430","케이엔알시스템","77704147950","7150","10867713","10867713","0","2024-09"
"432470","케이엔에스","135236328040","15590","8674556","8674556","0","2024-09"
"272110","케이엔제이","125364485700","15660","8005395","8005395","0","2024-09"
"039420","케이엘넷","55675013430","2605","21372366","24154730","2782364","2024-09"
"083550","케이엠","35983696320","3120","11533236","12374226","840990","2024-09"
"032500","케이엠더블유","300249457820","7540","39820883","39820883","0","2024-09"
"225430","케이엠제약","18740071392","672","27887011","27887050","39","2024-09"
"102370","케이옥션","115850097750","4475","25888290","27229210","1340920","2024-09"
"068100","케이웨더","34215382590","3515","9734106","9939614","205508","2024-09"
"381970","케이카","619139638050","12850","48182073","48182073","0","2024-09"
"036030","케이티알파","196076564000","4000","49019141","49019283","142","2024-09"
"064820","케이프","136160432640","4880","27901728","30901728","3000000","2024-09"
"256940","케이피에스","100492806880","5360","18748658","18748658","0","2024-09"
"024880","케이피에프","76821032420","3970","19350386","20682798","1332412","2024-09"
"042040","케이피엠테크","53380546992","306","174446232","174460917","14685","2024-09"
"054410","케이피티유","22504924920","3930","5726444","5726444","0","2024-09"
"258610","케일럼","40164120234","1514","26528481","26787133","258652","2024-09"
"274090","켄코아에어로스페이스","113119859760","8760","12913226","12913226","0","2024-09"
"089010","켐트로닉스","285140895030","19130","14905431","15334346","428915","2024-09"
"220260","켐트로스","122832100500","4625","26558292","26558307","15","2024-09"
"052400","코나아이","195265962080","13370","14604784","14899999","295215","2024-09"
"402030","코난테크놀로지","160569489760","14020","11452888","11452888","0","2024-09"
"391710","코닉오토메이션","84245950040","2030","41500468","41503222","2754","2024-09"
"046070","코다코","144219271360","10280","14029112","14064588","35476","2024-09"
"047770","코데즈컴바인","54774174809","1451","37749259","37842602","93343","2024-09"
"080530","코디","63866315680","1480","43152916","43300427","147511","2024-09"
"104540","코렌텍","79527302800","6220","12785740","12785740","0","2024-09"
"027050","코리아나","73899000000","2415","30600000","40000000","9400000","2024-09"
"007810","코리아써키트","238097170080","10080","23620751","23620751","0","2024-09"
"190650","코리아에셋투자증권","35517280000","5560","6388000","6388000","0","2024-09"
"123410","코리아에프티","140597347950","5050","27841059","27841064","5","2024-09"
"003690","코리안리","1354861239200","9200","147267526","165367526","18100000","2024-09"
"036690","코맥스","45885746130","2885","15904938","15904938","0","2024-09"
"049430","코메론","95503853100","10630","8984370","9048000","63630","2024-09"
"183300","코미코","525523380000","51000","10304380","10460684","156304","2024-09"
"041960","코미팜","297570742700","4295","69283060","70622233","1339173","2024-09"
"089890","코세스","141365379520","8620","16399696","16584962","185266","2024-09"
"360350","코셈","40668024900","7170","5671970","5671970","0","2024-09"
"082660","코스나인","47827116000","480","99639825","99640869","1044","2024-09"
"192820","코스맥스","1508973046000","133000","11345662","11349509","3847","2024-09"
"044820","코스맥스비티아이","82936002520","8680","9554839","9603921","49082","2024-09"
"222040","코스맥스엔비티","68961474780","3355","20554836","20628000","73164","2024-09"
"241710","코스메카코리아","774300000000","72500","10680000","10680000","0","2024-09"
"005070","코스모신소재","3282398596000","101000","32498996","32510756","11760","2024-09"
"005420","코스모화학","815242628750","21250","38364359","38408228","43869","2024-09"
"355150","코스텍시스","56871010230","7530","7552591","7797350","244759","2024-09"
"071950","코아스","32216148800","9790","3290720","3290720","0","2024-09"
"166480","코아스템켐온","350542256310","14390","24360129","32870376","8510247","2024-09"
"045970","코아시아","105657853380","4260","24802313","26314876","1512563","2024-09"
"196450","코아시아씨엠","36291925071","801","45308271","45319582","11311","2024-09"
"384470","코어라인소프트","95082934050","7410","12831705","12832064","359","2024-09"
"029960","코엔텍","353181834400","7270","48580720","50000000","1419280","2024-09"
"002020","코오롱","181820534400","14400","12626426","12626426","0","2024-09"
"138490","코오롱ENP","213560000000","5620","38000000","38000000","0","2024-09"
"003070","코오롱글로벌","169346842540","8980","18858223","18932713","74490","2024-09"
"450140","코오롱모빌리티그룹","144128512700","2350","61331282","62777250","1445968","2024-09"
"102940","코오롱생명과학","232690038510","18730","12423387","12423387","0","2024-09"
"120110","코오롱인더","855627274100","31100","27512131","27519091","6960","2024-09"
"021240","코웨이","4710048211500","65500","71909133","73799619","1890486","2024-09"
"033290","코웰패션","120286900480","2270","52989824","56156301","3166477","2024-09"
"056360","코위버","47307705480","5110","9257868","9796800","538932","2024-09"
"282880","코윈테크","147021143740","13460","10922819","11141807","218988","2024-09"
"121850","코이즈","27725450808","913","30367416","30614175","246759","2024-09"
"448710","코츠테크놀로지","98974513700","22300","4438319","5166069","727750","2024-09"
"126730","코칩","100560760360","12280","8188987","8503460","314473","2024-09"
"015710","코콤","79504118230","4790","16597937","17530500","932563","2024-09"
"052330","코텍","98441398710","7830","12572337","15574552","3002215","2024-09"
"322780","코퍼스코리아","38333645250","1039","36894750","37932613","1037863","2024-09"
"036420","콘텐트리중앙","202890395340","10620","19104557","19262308","157751","2024-09"
"200130","콜마비앤에이치","411421683960","14130","29116892","29415558","298666","2024-09"
"024720","콜마홀딩스","231499748250","6750","34296259","34296259","0","2024-09"
"031820","콤텍시스템","67667769494","559","121051466","121051466","0","2024-09"
"294570","쿠콘","135732491730","13310","10197783","10254685","56902","2024-09"
"192400","쿠쿠홀딩스","752096917000","24200","31078385","35562185","4483800","2024-09"
"284740","쿠쿠홈시스","502261312000","22400","22422380","22437330","14950","2024-09"
"317690","퀀타매트릭스","116423373440","7040","16537411","16537411","0","2024-09"
"078940","퀀타피아","151577916950","2855","53092090","53094278","2188","2024-09"
"227100","퀀텀온","17091869260","1090","15680614","15680614","0","2024-09"
"432720","퀄리타스반도체","134655222000","9750","13810792","13810792","0","2024-09"
"365270","큐라클","76306824000","5500","13873968","13873968","0","2024-09"
"348080","큐라티스","34480344180","818","42152010","42152010","0","2024-09"
"060280","큐렉소","272426633700","6630","41089990","41089990","0","2024-09"
"372320","큐로셀","421982407600","29900","14113124","14113124","0","2024-09"
"051780","큐로홀딩스","17785125658","131","135764318","136422450","658132","2024-09"
"115180","큐리언트","157400499750","4875","32287282","32292671","5389","2024-09"
"445680","큐리옥스바이오시스템즈","366200789500","22750","16096738","16096738","0","2024-09"
"182360","큐브엔터","180277896040","12980","13888898","14571557","682659","2024-09"
"405100","큐알티","163787060250","13890","11791725","12289301","497576","2024-09"
"066310","큐에스아이","60613166100","6780","8939995","9271621","331626","2024-09"
"016600","큐캐피탈","48516566116","278","174520022","178247112","3727090","2024-09"
"355390","크라우드웍스","43228272640","10240","4221511","4224606","3095","2024-09"
"264900","크라운제과","100575334530","8370","12016169","12523850","507681","2024-09"
"005740","크라운해태홀딩스","85577273250","5950","14382735","14847347","464612","2024-09"
"259960","크래프톤","15659433874500","344500","45455541","47900115","2444574","2024-09"
"096240","크레버스","133029522390","15770","8435607","11138180","2702573","2024-09"
"040350","크레오에스지","106477698366","702","151677633","152074086","396453","2024-09"
"110790","크리스에프앤씨","129013629290","6370","20253317","23430960","3177643","2024-09"
"045520","크린앤사이언스","31686060000","5180","6117000","6500000","383000","2024-09"
"036170","클라우드에어","53281073872","884","60272708","61365626","1092918","2024-09"
"214150","클래시스","3471799927000","53000","65505659","65505659","0","2024-09"
"352770","클리노믹스","22068656064","574","38447136","38886113","438977","2024-09"
"237880","클리오","389046630600","22200","17524623","18071353","546730","2024-09"
"139670","키네마스터","37061876250","2625","14118810","14118810","0","2024-09"
"020120","키다리스튜디오","125644220880","3390","37063192","37063766","574","2024-09"
"413600","키움제6호스팩","9226700000","2690","3430000","3430000","0","2024-09"
"433530","키움제7호스팩","9256775000","2255","4105000","4105000","0","2024-09"
"446840","키움제8호스팩","13494600000","2295","5880000","5880000","0","2024-09"
"039490","키움증권","3250494326700","134700","24131361","25526706","1395345","2024-09"
"054780","키이스트","84018839500","4300","19539265","19547793","8528","2024-09"
"219130","타이거일렉","118645509100","18790","6314290","6314290","0","2024-09"
"360070","탑머티리얼","268626261200","33550","8006744","8076743","69999","2024-09"
"065130","탑엔지니어링","61285024200","3950","15515196","17189982","1674786","2024-09"
"134580","탑코미디어","41018885750","1895","21645850","22025767","379917","2024-09"
"014580","태경비케이","120400231500","4365","27583100","27583100","0","2024-09"
"015890","태경산업","147897475000","5060","29228750","29228750","0","2024-09"
"006890","태경케미컬","121839414250","10750","11333899","11600000","266101","2024-09"
"023160","태광","321012473220","12410","25867242","26500000","632758","2024-09"
"003240","태광산업","542010364000","644000","841631","1113400","271769","2024-09"
"011280","태림포장","137678242000","2000","68839121","70805940","1966819","2024-09"
"323280","태성","744928060500","28850","25820730","25820730","0","2024-09"
"053620","태양","50154495300","6300","7961031","8600000","638969","2024-09"
"004100","태양금속","118741783600","3260","36423860","36700000","276140","2024-09"
"009410","태영건설","1330097939940","4620","287899987","287905337","5350","2024-09"
"044490","태웅","281903998290","14090","20007381","20007381","0","2024-09"
"124560","태웅로직스","100718366440","2785","36164584","38416584","2252000","2024-09"
"001420","태원물산","27865806600","3800","7333107","7600000","266893","2024-09"
"191420","테고사이언스","138513591800","17300","8006566","8108834","102268","2024-09"
"073640","테라사이언스","59577565530","654","91097195","95587404","4490209","2024-09"
"066700","테라젠이텍스","107218019650","3350","32005379","32474435","469056","2024-09"
"095610","테스","278379256620","15870","17541226","19768226","2227000","2024-09"
"055490","테이팩스","80034727000","16780","4769650","4769650","0","2024-09"
"064520","테크엘","43752532076","1958","22345522","22351062","5540","2024-09"
"089030","테크윙","1515396097600","42400","35740474","37353645","1613171","2024-09"
"054450","텔레칩스","187173233280","12680","14761296","15144233","382937","2024-09"
"078000","텔코웨어","51123629700","9900","5164003","9240077","4076074","2024-09"
"200230","텔콘RF제약","68542633950","570","120250235","120250235","0","2024-09"
"214420","토니모리","177357670420","7420","23902651","24054799","152148","2024-09"
"393210","토마토시스템","98742521100","6420","15380455","15614544","234089","2024-09"
"215480","토박스코리아","23386831920","2610","8960472","9400000","439528","2024-09"
"051360","토비스","301340354380","19730","15273206","16167058","893852","2024-09"
"045340","토탈소프트","43046941200","5030","8558040","8558040","0","2024-09"
"108230","톱텍","187278922320","5140","36435588","38023245","1587657","2024-09"
"079970","투비소프트","9922126998","1186","8366043","9290500","924457","2024-09"
"199800","툴젠","445676800800","56100","7944328","7946828","2500","2024-09"
"417790","트루엔","91075001700","8700","10468391","10999650","531259","2024-09"
"290090","트윔","61612856800","8800","7001461","7432268","430807","2024-09"
"026150","특수건설","105277986000","6000","17546331","17546331","0","2024-09"
"464280","티디에스팜","75414010000","14260","5288500","5530000","241500","2024-09"
"322180","티라유텍","93995812750","5690","16519475","16519475","0","2024-09"
"117730","티로보틱스","126999867200","7120","17837060","17837060","0","2024-09"
"033830","티비씨","79220874700","838","94535650","100000000","5464350","2024-09"
"057680","티사이언티픽","61629953365","865","71248501","71248501","0","2024-09"
"204610","티쓰리","82348543515","1405","58611063","63851720","5240657","2024-09"
"064760","티씨케이","984202500000","84300","11675000","11675000","0","2024-09"
"246710","티앤알바이오팹","149104049760","6920","21546828","21546828","0","2024-09"
"340570","티앤엘","588449601900","72900","8072011","8128000","55989","2024-09"
"043220","티에스넥스젠","82774464030","582","142224165","142224165","0","2024-09"
"277880","티에스아이","121569816960","6030","20160832","20160832","0","2024-09"
"131290","티에스이","575946768000","53400","10785520","11061429","275909","2024-09"
"019180","티에이치엔","56700000000","3150","18000000","18000000","0","2024-09"
"425420","티에프이","173510740000","15340","11311000","11381000","70000","2024-09"
"131100","티엔엔터테인먼트","43187010020","1540","28043513","28048252","4739","2024-09"
"356860","티엘비","122939685400","12580","9772630","9832630","60000","2024-09"
"062860","티엘아이","42843237000","5800","7386765","9872720","2485955","2024-09"
"363280","티와이홀딩스","120199075325","3395","35404735","50429268","15024533","2024-09"
"321550","티움바이오","158755507300","6100","26025493","26025493","0","2024-09"
"091810","티웨이항공","715452170125","3325","215173585","215378976","205391","2024-09"
"004870","티웨이홀딩스","82480664976","739","111611184","111611693","509","2024-09"
"425040","티이엠씨","184031909100","8700","21153093","21316062","162969","2024-09"
"241790","티이엠씨씨엔에스","54589515940","5620","9713437","10002634","289197","2024-09"
"104480","티케이케미칼","131434797564","1446","90895434","90895434","0","2024-09"
"081150","티플랙스","72077153940","2970","24268402","24268402","0","2024-09"
"130740","티피씨글로벌","21786543828","1932","11276679","11276679","0","2024-09"
"084730","팅크웨어","103849327860","9910","10479246","11109424","630178","2024-09"
"440110","파두","1108224810000","22500","49254436","49334436","80000","2024-09"
"034230","파라다이스","872239282500","10100","86360325","91771623","5411298","2024-09"
"033540","파라텍","48910542237","1307","37421991","37751063","329072","2024-09"
"388870","파로스아이바이오","118447611920","9160","12930962","12930962","0","2024-09"
"043200","파루","22108355228","529","41792732","41804315","11583","2024-09"
"214450","파마리서치","2418140638000","233000","10378286","10498238","119952","2024-09"
"208340","파멥신","233760977175","2915","80192445","80201108","8663","2024-09"
"005690","파미셀","294319688670","4905","60004014","60016964","12950","2024-09"
"177830","파버나인","36648541160","3080","11898877","14288753","2389876","2024-09"
"037070","파세코","113042567100","5660","19972185","20000000","27815","2024-09"
"150900","파수","54542576825","4825","11304161","11685422","381261","2024-09"
"037030","파워넷","53370952040","2440","21873341","21878974","5633","2024-09"
"047310","파워로직스","184518205200","5040","36610755","36610755","0","2024-09"
"368770","파이버프로","153826328625","4705","32694225","32854225","160000","2024-09"
"170790","파이오링크","53975280720","8080","6680109","6856330","176221","2024-09"
"049120","파인디앤씨","54817900100","1175","46653532","46653532","0","2024-09"
"038950","파인디지털","30876588045","3765","8200953","10210765","2009812","2024-09"
"441270","파인엠텍","213332784810","5770","36972753","36987901","15148","2024-09"
"106240","파인테크닉스","16078196206","1013","15871862","15923057","51195","2024-09"
"131760","파인텍","34745266400","800","43431583","43431583","0","2024-09"
"065690","파커스","14037223941","1053","13330697","14049331","718634","2024-09"
"140860","파크시스템스","1491674730000","215000","6938022","6983609","45587","2024-09"
"091700","파트론","354687757700","6980","50814865","58918214","8103349","2024-09"
"032800","판타지오","37249153971","163","228522417","229785294","1262877","2024-09"
"318010","팜스빌","44359397320","5740","7728118","7929338","201220","2024-09"
"036580","팜스코","73539555600","2100","35018836","36727943","1709107","2024-09"
"027710","팜스토리","143893541561","1301","110602261","111416600","814339","2024-09"
"004720","팜젠사이언스","83972527450","4630","18136615","18178525","41910","2024-09"
"225590","패션플랫폼","21970704756","858","25606882","26636713","1029831","2024-09"
"054300","팬스타엔터프라이즈","32879214998","491","66963778","66985895","22117","2024-09"
"068050","팬엔터테인먼트","58951623220","2180","27042029","27694076","652047","2024-09"
"028670","팬오션","1820209188360","3405","534569512","534569512","0","2024-09"
"222110","팬젠","57377980000","5000","11475596","11475596","0","2024-09"
"271830","팸텍","58829057050","2050","28697101","29490202","793101","2024-09"
"010820","퍼스텍","170567877870","3510","48594837","48771938","177101","2024-09"
"016800","퍼시스","398675811600","44550","8948952","11500000","2551048","2024-09"
"263750","펄어비스","2303227875000","37500","61419410","64247855","2828445","2024-09"
"251970","펌텍코리아","417825608200","33700","12398386","12400000","1614","2024-09"
"001020","페이퍼코리아","133441111500","750","177921482","177983313","61831","2024-09"
"168360","펨트론","158810598640","7460","21288284","21288284","0","2024-09"
"087010","펩트론","1848388332200","89800","20583389","20657350","73961","2024-09"
"090080","평화산업","54188529633","987","54902259","54902259","0","2024-09"
"010770","평화홀딩스","39641587555","2755","14388961","14625466","236505","2024-09"
"064800","포니링크","166636989520","1322","126049160","127807298","1758138","2024-09"
"119500","포메탈","33527666560","2830","11847232","11847232","0","2024-09"
"389140","포바이포","57606865560","5220","11035798","11112735","76937","2024-09"
"105760","포스뱅크","60638503850","6410","9459985","9459985","0","2024-09"
"022100","포스코DX","4015705627550","26450","151822519","152034729","212210","2024-09"
"058430","포스코스틸리온","221651830000","37000","5990590","6000000","9410","2024-09"
"009520","포스코엠텍","652075493940","15660","41639559","41642703","3144","2024-09"
"047050","포스코인터내셔널","8454046555200","49600","170444487","175922788","5478301","2024-09"
"003670","포스코퓨처엠","17577804928000","227000","77435264","77463220","27956","2024-09"
"189690","포시에스","61322258250","2250","27254337","27321969","67632","2024-09"
"318020","포인트모바일","50975191480","4090","12463372","12662272","198900","2024-09"
"256630","포인트엔지니어링","69837247344","1227","56917072","57997072","1080000","2024-09"
"331380","포커스에이치엔에스","74752862360","3355","22281032","22725452","444420","2024-09"
"472850","폰드그룹","200159697630","6190","32335977","32343933","7956","2024-09"
"039980","폴라리스AI","164747968770","2310","71319467","72152777","833310","2024-09"
"041910","폴라리스AI파마","86740275500","6530","13283350","13501607","218257","2024-09"
"234100","폴라리스세원","68832714445","1265","54413213","54413213","0","2024-09"
"041020","폴라리스오피스","247425289140","4980","49683793","49725498","41705","2024-09"
"114630","폴라리스우노","39440258529","519","75992791","77757548","1764757","2024-09"
"290720","푸드나무","40965891280","3280","12489601","13403058","913457","2024-09"
"005670","푸드웰","46669872150","4950","9428257","10000000","571743","2024-09"
"094940","푸른기술","48852053340","6180","7904863","8361386","456523","2024-09"
"057880","푸른소나무","215672327790","8790","24536101","24580368","44267","2024-09"
"007330","푸른저축은행","101830462800","8690","11718120","15082800","3364680","2024-09"
"017810","풀무원","376743488100","10220","36863355","38120542","1257187","2024-09"
"093380","풍강","25936140510","2705","9588222","9879313","291091","2024-08"
"023900","풍국주정","126756000000","10060","12600000","12600000","0","2024-09"
"103140","풍산","1936582310200","70900","27314278","28024278","710000","2024-09"
"005810","풍산홀딩스","390706466400","27900","14003816","14417292","413476","2024-09"
"371950","풍원정밀","215033787360","10220","21040488","21040488","0","2024-09"
"370090","퓨런티어","128291094400","15680","8181830","8181830","0","2024-09"
"445180","퓨릿","103801273720","6190","16769188","16769188","0","2024-09"
"151910","퓨처코어","121645902080","640","190071722","190071722","0","2024-09"
"220100","퓨쳐켐","561261971200","25400","22096928","22102155","5227","2024-09"
"035200","프럼파스트","23362042080","2760","8464508","9730590","1266082","2024-09"
"334970","프레스티지바이오로직스","561277868250","7250","77417637","77417637","0","2024-09"
"321260","프로이천","57229867590","2030","28192053","28192084","31","2024-09"
"053610","프로텍","286200000000","31800","9000000","11000000","2000000","2024-09"
"303360","프로티아","35154796950","2730","12877215","12877215","0","2024-09"
"377220","프롬바이오","60583400000","2140","28310000","28310000","0","2024-09"
"335810","프리시젼바이오","38327935800","3300","11614526","11614526","0","2024-09"
"053160","프리엠스","69622295160","12990","5359684","6000000","640316","2024-09"
"405000","플라즈맵","47746701364","1831","26076844","26076844","0","2024-09"
"041590","플래스크","103917099150","789","131707350","131707350","0","2024-09"
"367000","플래티어","37557400365","4635","8102999","8388207","285208","2024-09"
"075130","플랜티넷","31108344516","1998","15569742","16622320","1052578","2024-09"
"009810","플레이그램","54827916485","361","151877885","151887500","9615","2024-09"
"237820","플레이디","80682710600","6290","12827140","12827140","0","2024-09"
"023770","플레이위드","34935777700","3985","8766820","8766820","0","2024-09"
"019570","플루토스","19726756528","376","52464778","52470042","5264","2024-09"
"300080","플리토","80309197650","14610","5496865","5501817","4952","2024-09"
"033790","피노","184119708000","8110","22702800","22822800","120000","2024-09"
"032580","피델릭스","46790642961","1413","33114397","33132064","17667","2024-09"
"051380","피씨디렉트","40654330750","2750","14783393","15340072","556679","2024-09"
"241820","피씨엘","54911585376","928","59171967","59171967","0","2024-09"
"237750","피앤씨테크","29202217000","4495","6496600","6496600","0","2024-09"
"460940","피앤에스미캐닉스","80702597800","12470","6471740","6471740","0","2024-09"
"319660","피에스케이","586575958500","20250","28966714","28966714","0","2024-09"
"031980","피에스케이홀딩스","1091057187000","50600","21562395","21562395","0","2024-09"
"002230","피에스텍","61072641225","3695","16528455","19370673","2842218","2024-09"
"043370","피에이치에이","199629436860","10220","19533213","21000000","1466787","2024-09"
"239890","피엔에이치테크","67463776450","6790","9935755","9935755","0","2024-09"
"347740","피엔케이피부임상연구센타","68594253625","2375","28881791","30010576","1128785","2024-09"
"137400","피엔티","1180964668800","50800","23247336","23743086","495750","2024-09"
"257370","피엔티엠에스","56388833910","4590","12285149","12504861","219712","2024-09"
"147760","피엠티","36787544400","3400","10819866","10819866","0","2024-09"
"128660","피제이메탈","80858982940","3260","24803369","24803369","0","2024-09"
"006140","피제이전자","74325000000","5000","14865000","15000000","135000","2024-09"
"376180","피코그램","59052373380","3210","18396378","18491378","95000","2024-09"
"304840","피플바이오","88017321330","4185","21031618","21089464","57846","2024-09"
"087600","픽셀플러스","44906961330","6930","6480081","8166558","1686477","2024-09"
"291810","핀텔","22510985184","1982","11357712","11357712","0","2024-09"
"378340","필에너지","320352524100","15050","21285882","21285882","0","2024-09"
"161580","필옵틱스","468285190000","20500","22843180","22843180","0","2024-09"
"347770","핌스","51885485340","2270","22857042","22857042","0","2024-09"
"163730","핑거","97378691400","10600","9186669","9360608","173939","2024-09"
"417180","핑거스토리","41029280760","2440","16815279","16816209","930","2024-09"
"446750","하나26호스팩","12874050000","2135","6030000","6030000","0","2024-09"
"448370","하나27호스팩","11998700000","2135","5620000","5620000","0","2024-09"
"454750","하나28호스팩","14872130000","2065","7202000","7202000","0","2024-09"
"454640","하나29호스팩","11531135000","2135","5401000","5401000","0","2024-09"
"469880","하나30호스팩","15011775000","2055","7305000","7305000","0","2024-09"
"469900","하나31호스팩","11602350000","2070","5605000","5605000","0","2024-09"
"475240","하나32호스팩","6912000000","2160","3200000","3200000","0","2024-09"
"475250","하나33호스팩","7899500000","2135","3700000","3700000","0","2024-09"
"406760","하나금융21호스팩","15375750000","2075","7410000","7410000","0","2024-09"
"418170","하나금융22호스팩","14033350000","2335","6010000","6010000","0","2024-09"
"435620","하나금융25호스팩","44654760000","10380","4302000","4302000","0","2024-09"
"086790","하나금융지주","18472713273000","66500","277785162","287240880","9455718","2024-09"
"299030","하나기술","217861297500","27250","7994910","7994910","0","2024-09"
"067310","하나마이크론","683089469440","10390","65744896","65744896","0","2024-09"
"166090","하나머티리얼즈","558329882100","28650","19487954","19777674","289720","2024-09"
"293480","하나제약","190986325440","11040","17299486","17772946","473460","2024-09"
"039130","하나투어","726477810800","46900","15489932","16039185","549253","2024-09"
"136480","하림","299978789150","2825","106187182","106209702","22520","2024-09"
"003380","하림지주","502840305770","5170","97261181","112005621","14744440","2024-09"
"450330","하스","62296271550","7950","7836009","7836009","0","2024-09"
"101670","하이드로리튬","79107583104","1584","49941656","51691656","1750000","2024-09"
"365590","하이딥","122214757357","847","144291331","144447309","155978","2024-09"
"149980","하이로닉","115965491500","6940","16709725","18594363","1884638","2024-09"
"013030","하이록코리아","274128759750","22650","12102815","12856050","753235","2024-09"
"352820","하이브","7997454091900","192700","41502097","41652097","150000","2024-09"
"126700","하이비젼시스템","226449461490","17790","12729031","14942112","2213081","2024-09"
"106080","하이소닉","95979589900","6100","15734359","15735465","1106","2024-09"
"071090","하이스틸","61963501570","3070","20183551","20191471","7920","2024-09"
"450050","하이제8호스팩","10479260000","2090","5014000","5014000","0","2024-09"
"160190","하이젠알앤엠","200514720000","7190","27888000","30888000","3000000","2024-09"
"221840","하이즈항공","33754512605","1805","18700561","18700561","0","2024-09"
"106190","하이텍팜","161296511660","15170","10632598","10633173","575","2024-09"
"019490","하이트론","90390194650","3010","30029965","30044269","14304","2024-09"
"000080","하이트진로","1445070438350","21050","68649427","70133611","1484184","2024-09"
"000140","하이트진로홀딩스","198921398130","9310","21366423","23206765","1840342","2024-09"
"065650","하이퍼코퍼레이션","129411533250","1215","106511550","106681728","170178","2024-09"
"066130","하츠","60624295550","5050","12004811","12800000","795189","2024-09"
"004590","한국가구","55350000000","3690","15000000","15000000","0","2024-09"
"036460","한국가스공사","3521563761900","40350","87275434","92313000","5037566","2024-09"
"039340","한국경제TV","116534161840","5480","21265358","23000000","1734642","2024-09"
"005430","한국공항","170953994900","55900","3058211","3166355","108144","2024-09"
"071050","한국금융지주","4176890229600","79200","52738513","55725992","2987479","2024-09"
"034950","한국기업평가","381850557600","85600","4460871","4540514","79643","2024-09"
"010040","한국내화","78315995420","2210","35437102","41067062","5629960","2024-09"
"025540","한국단자","758152500000","73500","10315000","10415000","100000","2024-09"
"222980","한국맥널티","41165524640","3790","10861616","11031483","169867","2024-09"
"010100","한국무브넥스","108251243100","3555","30450420","30450420","0","2024-09"
"256840","한국비엔씨","324579682520","4885","66444152","67912443","1468291","2024-09"
"219750","한국비티비","63245329550","967","65403650","65426885","23235","2024-09"
"004090","한국석유","211721512800","16800","12602471","12694120","91649","2024-09"
"025550","한국선재","62165247840","2810","22122864","23300000","1177136","2024-09"
"002200","한국수출포장","98494450050","2650","37167717","40000000","2832283","2024-09"
"002960","한국쉘석유","419250000000","322500","1300000","1300000","0","2024-09"
"017890","한국알콜","184196307350","8950","20580593","21605760","1025167","2024-09"
"000240","한국앤컴퍼니","1563796557440","16510","94718144","94935240","217096","2024-09"
"080720","한국유니온제약","15410411825","2725","5655197","7912828","2257631","2024-09"
"123890","한국자산신탁","357923635875","2925","122367055","123977752","1610697","2024-09"
"015760","한국전력","14636780955600","22800","641964077","641964077","0","2024-09"
"063570","한국전자금융","150893580800","4975","30330368","34147728","3817360","2024-09"
"041460","한국전자인증","63879890625","3375","18927375","19000000","72625","2024-09"
"006200","한국전자홀딩스","32014797510","730","43855887","46803136","2947249","2024-09"
"101680","한국정밀기계","19452410235","2315","8402769","8404000","1231","2024-09"
"039740","한국정보공학","21489303960","2680","8018397","8018397","0","2024-09"
"053300","한국정보인증","155869162185","3795","41072243","42441361","1369118","2024-09"
"025770","한국정보통신","288164294370","8070","35708091","37444271","1736180","2024-09"
"458610","한국제12호스팩","9242550000","2185","4230000","4230000","0","2024-09"
"464440","한국제13호스팩","9266400000","2145","4320000","4320000","0","2024-09"
"477530","한국제14호스팩","10942750000","2275","4810000","4810000","0","2024-09"
"479880","한국제15호스팩","13980450000","2035","6870000","6870000","0","2024-09"
"027970","한국제지","185587102720","976","190150720","190178237","27517","2024-09"
"023350","한국종합기술","45621167275","4385","10403915","10950000","546085","2024-09"
"025890","한국주강","21977182752","1972","11144616","11309259","164643","2024-09"
"000970","한국주철관","137024878900","6370","21510970","22800500","1289530","2024-09"
"104700","한국철강","267812655330","7810","34290993","42450000","8159007","2024-09"
"062970","한국첨단소재","19648002319","1991","9868409","9868409","0","2024-09"
"017960","한국카본","530075124420","10770","49217746","51908452","2690706","2024-09"
"023760","한국캐피탈","175447462575","561","312740575","315609576","2869001","2024-09"
"054040","한국컴퓨터","64390595360","4760","13527436","16071290","2543854","2024-09"
"161890","한국콜마","1567377112800","66400","23605077","23605077","0","2024-09"
"021650","한국큐빅","39812718050","2450","16250089","16350563","100474","2024-09"
"161390","한국타이어앤테크놀로지","4336700169150","35550","121988753","123875069","1886316","2024-09"
"034830","한국토지신탁","224065111920","1040","215447223","252489230","37042007","2024-09"
"007280","한국특강","93348432385","1535","60813311","60813311","0","2024-09"
"032300","한국파마","231767396250","21250","10906701","10906701","0","2024-09"
"037230","한국팩키지","59392051711","1993","29800327","29800327","0","2024-09"
"047810","한국항공우주","5575576120400","57200","97475107","97475107","0","2024-09"
"123690","한국화장품","102347242270","6370","16067071","16068000","929","2024-09"
"003350","한국화장품제조","266800515200","73600","3625007","4532000","906993","2024-09"
"030520","한글과컴퓨터","412787723250","17150","24069255","24179744","110489","2024-09"
"052600","한네트","44520245000","3850","11563700","11563700","0","2024-09"
"011500","한농화성","285386413200","18660","15294020","15637042","343022","2024-09"
"002390","한독","199708863830","14510","13763533","13763533","0","2024-09"
"256150","한독크린텍","52158823300","6700","7784899","8395000","610101","2024-09"
"092460","한라IMS","104436115200","6390","16343680","17109680","766000","2024-09"
"053690","한미글로벌","142605131000","14020","10171550","10957550","786000","2024-09"
"042700","한미반도체","9357152115600","97800","95676402","96993634","1317232","2024-09"
"008930","한미사이언스","2755947834200","40700","67713706","68391550","677844","2024-09"
"128940","한미약품","4190810727000","330500","12680214","12810991","130777","2024-09"
"452190","한빛레이저","96580907130","4170","23160889","23162757","1868","2024-09"
"047080","한빛소프트","32939274374","1327","24822362","24822362","0","2024-09"
"009240","한샘","841636325400","50700","16600322","23533928","6933606","2024-09"
"452280","한선엔지니어링","148261800000","8720","17002500","17002500","0","2024-09"
"020000","한섬","337188805800","15700","21476994","23398500","1921506","2024-09"
"003680","한성기업","28635638850","5070","5648055","6209515","561460","2024-09"
"066980","한성크린텍","108538402500","2090","51932250","51935125","2875","2024-09"
"105630","한세실업","600588294750","15250","39382839","40000000","617161","2024-09"
"069640","한세엠케이","40469670875","1475","27437065","30106502","2669437","2024-09"
"016450","한세예스24홀딩스","199935846430","5090","39280127","40000000","719873","2024-09"
"010420","한솔PNS","21312732480","1040","20493012","20493012","0","2024-09"
"009180","한솔로지스틱스","62271741480","2220","28050334","28057025","6691","2024-09"
"114810","한솔아이원스","188461990860","6820","27633723","29113174","1479451","2024-09"
"070590","한솔인티큐브","14359262276","1051","13662476","13879521","217045","2024-09"
"213500","한솔제지","222313715800","9350","23776868","23800576","23708","2024-09"
"014680","한솔케미칼","1352288763500","119300","11335195","11335195","0","2024-09"
"004710","한솔테크닉스","136666198950","4350","31417517","32109878","692361","2024-09"
"004150","한솔홀딩스","93745824415","2285","41026619","42008577","981958","2024-09"
"025750","한솔홈데코","55348257363","687","80565149","80565149","0","2024-09"
"226440","한송네오텍","100580954580","1530","65739186","65739186","0","2024-09"
"042520","한스바이오메드","110778930870","8530","12986979","13526367","539388","2024-09"
"004960","한신공영","78565066580","6790","11570702","11570702","0","2024-09"
"011700","한신기계","107712682830","3330","32346151","32446151","100000","2024-09"
"430690","한싹","50172874920","4605","10895304","10895327","23","2024-09"
"078350","한양디지텍","173006497620","11660","14837607","15244382","406775","2024-09"
"045100","한양이엔지","277169582820","16510","16787982","18000000","1212018","2024-09"
"001750","한양증권","156942824220","12330","12728534","12728534","0","2024-09"
"018880","한온시스템","2019935007550","3785","533668430","533800000","131570","2024-09"
"009420","한올바이오파마","2396060730000","47250","50710280","52240638","1530358","2024-09"
"320000","한울반도체","75507182100","2700","27965623","27965627","4","2024-09"
"091440","한울소재과학","70540989800","5020","14051990","14606671","554681","2024-09"
"014130","한익스프레스","39589000000","3355","11800000","12000000","200000","2024-09"
"024740","한일단조","110563942080","3540","31232752","31532546","299794","2024-09"
"005860","한일사료","159978961100","4060","39403685","39403685","0","2024-09"
"300720","한일시멘트","982128637200","14180","69261540","69261540","0","2024-09"
"002220","한일철강","49559860900","2035","24353740","26697460","2343720","2024-09"
"006390","한일현대시멘트","272133621760","14080","19327672","19327672","0","2024-09"
"003300","한일홀딩스","431023587120","13980","30831444","30832884","1440","2024-09"
"007770","한일화학","41102100000","11710","3510000","3510000","0","2024-09"
"051600","한전KPS","2007000000000","44600","45000000","45000000","0","2024-09"
"052690","한전기술","2655436649000","69800","38043505","38220000","176495","2024-09"
"130660","한전산업","425430000000","13050","32600000","32600000","0","2024-09"
"198940","한주라이트메탈","37751379560","970","38918948","38922978","4030","2024-09"
"058450","한주에이알티","34365138920","2380","14439134","14452469","13335","2024-09"
"107640","한중엔시에스","350798683200","39200","8948946","8948946","0","2024-09"
"002320","한진","275494082080","19040","14469227","14947628","478401","2024-09"
"003480","한진중공업홀딩스","89486998720","3430","26089504","29529812","3440308","2024-09"
"180640","한진칼","5836357032000","88000","66322239","66762279","440040","2024-09"
"005110","한창","22551214950","1254","17983425","18606407","622982","2024-09"
"079170","한창산업","39962917310","7730","5169847","5200000","30153","2024-09"
"009460","한창제지","43258927350","725","59667486","59667486","0","2024-09"
"372910","한컴라이프케어","115540645050","4175","27674406","27674406","0","2024-09"
"054920","한컴위드","61698960240","2480","24878613","28217081","3338468","2024-09"
"457370","한켐","128995963030","16070","8027129","8027134","5","2024-09"
"002680","한탑","21742776099","701","31016799","32316799","1300000","2024-09"
"000880","한화","1935591292800","27900","69376032","74958735","5582703","2024-09"
"452260","한화갤러리아","248228630349","1281","193777229","193859610","82381","2024-09"
"088350","한화생명","2171517822500","2890","751390250","868530000","117139750","2024-09"
"000370","한화손해보험","545728410720","4720","115620426","116738915","1118489","2024-09"
"009830","한화솔루션","3463172305550","20450","169348279","171892536","2544257","2024-09"
"272210","한화시스템","3565961487270","19070","186993261","188919389","1926128","2024-09"
"012450","한화에어로스페이스","17186355144000","378000","45466548","45581161","114613","2024-09"
"082740","한화엔진","1270570898050","15230","83425535","83447142","21607","2024-09"
"042660","한화오션","9115316313250","29750","306397187","306413394","16207","2024-09"
"489790","한화인더스트리얼솔루션즈","2178828691500","43250","50377542","50488390","110848","2024-09"
"003530","한화투자증권","723951263380","3385","213870388","214547775","677387","2024-09"
"430460","한화플러스제3호스팩","12757600000","2155","5920000","5920000","0","2024-09"
"455310","한화플러스제4호스팩","11030800000","2180","5060000","5060000","0","2024-09"
"195870","해성디에스","454750000000","26750","17000000","17000000","0","2024-09"
"034810","해성산업","198548604000","6700","29634120","32556857","2922737","2024-09"
"059270","해성에어로보틱스","66844794000","6000","11140799","11140799","0","2024-09"
"076610","해성옵틱스","27709039330","1090","25421137","25453198","32061","2024-09"
"101530","해태제과식품","149559613680","5640","26517662","29116822","2599160","2024-09"
"220180","핸디소프트","58224000000","3000","19408000","19408000","0","2024-09"
"143210","핸즈코퍼레이션","41074470255","1911","21493705","21875747","382042","2024-09"
"214180","헥토이노베이션","153842853340","12430","12376738","13257185","880447","2024-09"
"234340","헥토파이낸셜","131297273200","15800","8309954","9453000","1143046","2024-09"
"084990","헬릭스미스","162315280200","3525","46046888","46092797","45909","2024-09"
"187660","현대ADM","80381130200","3800","21152929","21836250","683321","2024-09"
"000720","현대건설","3123529208250","28050","111355765","111355765","0","2024-09"
"170030","현대공업","78287592060","5220","14997623","15340000","342377","2024-09"
"453340","현대그린푸드","392666786000","11600","33850585","33880914","30329","2024-09"
"086280","현대글로비스","9337500000000","124500","75000000","75000000","0","2024-09"
"064350","현대로템","7017849439900","64300","109142293","109142293","0","2024-09"
"079430","현대리바트","155482781460","7730","20114202","20535282","421080","2024-09"
"012330","현대모비스","23087216929500","256500","90008643","92995094","2986451","2024-09"
"319400","현대무벡스","356788031760","3060","116597396","117741058","1143662","2024-09"
"048410","현대바이오","681309112720","17110","39819352","39821608","2256","2024-09"
"052260","현대바이오랜드","155400000000","5180","30000000","30000000","0","2024-09"
"069960","현대백화점","981297851400","44900","21855186","23402441","1547255","2024-09"
"004560","현대비앤지스틸","186977256400","12400","15078811","15078811","0","2024-09"
"016790","현대사료","187340898626","994","188471729","188471729","0","2024-09"
"004310","현대약품","100883794280","3860","26135698","32000000","5864302","2024-08"
"041440","현대에버다임","146302038400","8200","17841712","17915944","74232","2024-09"
"039010","현대에이치티","46303240000","5960","7769000","8625000","856000","2024-09"
"017800","현대엘리베이","1610285765200","44600","36105062","39092385","2987323","2024-09"
"307950","현대오토에버","3902309406800","142300","27423116","27423982","866","2024-09"
"011210","현대위아","1233698826900","46300","26645763","27195083","549320","2024-09"
"090850","현대이지웰","119444195830","5030","23746361","23746361","0","2024-09"
"004020","현대제철","3360993631450","25550","131545739","133445785","1900046","2024-09"
"005440","현대지에프홀딩스","682860838380","4380","155904301","155904301","0","2024-09"
"005380","현대차","45964991165500","225500","203835881","209416191","5580310","2024-09"
"001500","현대차증권","280021922460","8830","31712562","31712562","0","2024-09"
"011760","현대코퍼레이션","226526818760","18860","12010966","13228966","1218000","2024-09"
"227840","현대코퍼레이션홀딩스","92627860500","10500","8821701","9100836","279135","2024-09"
"126560","현대퓨처넷","420235049325","3815","110153355","110202945","49590","2024-09"
"001450","현대해상","2379880075000","30350","78414500","89400000","10985500","2024-09"
"057050","현대홈쇼핑","533465150000","46600","11447750","12000000","552250","2024-09"
"460930","현대힘스","347685290640","9840","35333871","35333871","0","2024-09"
"092300","현우산업","52056640705","2845","18297589","18672816","375227","2024-09"
"138360","협진","39523261828","818","48316946","48348248","31302","2024-09"
"011080","형지I&C","15399702988","604","25496197","25503364","7167","2024-09"
"093240","형지엘리트","47065279070","1390","33859913","34164255","304342","2024-09"
"003010","혜인","51968141705","4835","10748323","12712747","1964424","2024-09"
"111110","호전실업","77895551520","8460","9207512","9749984","542472","2024-09"
"008770","호텔신라","1595864203000","43000","37113121","39248121","2135000","2024-09"
"060560","홈센타홀딩스","93173965872","734","126940008","127669525","729517","2024-09"
"064240","홈캐스트","92774011500","2700","34360745","35038012","677267","2024-09"
"039610","화성밸브","101501400000","9750","10410400","10410400","0","2024-09"
"378850","화승알앤에이","71310401430","3755","18990786","18993623","2837","2024-09"
"241590","화승엔터프라이즈","532579736040","8790","60589276","60589276","0","2024-09"
"006060","화승인더","200593725365","4055","49468243","55320000","5851757","2024-09"
"013520","화승코퍼레이션","83082207782","1871","44405242","50051252","5646010","2024-09"
"010690","화신","308566156080","8880","34748441","34920410","171969","2024-09"
"126640","화신정공","45888186190","1309","35055910","36373887","1317977","2024-09"
"133820","화인베스틸","25832286884","838","30826118","30826118","0","2024-09"
"127980","화인써키트","78733566100","6650","11839634","11840684","1050","2024-09"
"061250","화일약품","100104066636","1343","74537652","76877652","2340000","2024-09"
"010660","화천기계","60720000000","2760","22000000","22000000","0","2024-09"
"000850","화천기공","58190000000","26450","2200000","2200000","0","2024-09"
"016580","환인제약","200609299800","13140","15267070","18600070","3333000","2024-09"
"032560","황금에스티","90210432420","5310","16988782","17000000","11218","2024-09"
"004800","효성","834244367600","49900","16718324","16740407","22083","2024-09"
"094280","효성ITX","136875726000","12400","11038365","11558200","519835","2024-09"
"097870","효성오앤비","48602400000","6160","7890000","8490000","600000","2024-09"
"298040","효성중공업","3650202472000","392000","9311741","9324548","12807","2024-09"
"298020","효성티앤씨","1281759930000","297000","4315690","4327682","11992","2024-09"
"298000","효성화학","149478434000","39550","3779480","3791811","12331","2024-09"
"093370","후성","628515682960","5860","107255236","107255330","94","2024-09"
"081660","휠라홀딩스","2354091224100","39550","59521902","60095839","573937","2024-09"
"290270","휴네시온","33617956375","3625","9273919","9607672","333753","2024-09"
"005870","휴니드","107472922900","8210","13090490","14116015","1025525","2024-09"
"353190","휴럼","30478191966","774","39377509","39378420","911","2024-09"
"192410","휴림네트웍스","33916083300","2385","14220580","14235530","14950","2024-09"
"090710","휴림로봇","117685062192","1074","109576408","109623165","46757","2024-09"
"078590","휴림에이텍","29158525506","543","53698942","54210339","511397","2024-09"
"205470","휴마시스","170296529200","1505","113153840","129375009","16221169","2024-09"
"115160","휴맥스","74298211829","1723","43121423","43970124","848701","2024-09"
"028080","휴맥스홀딩스","32481222550","2975","10918058","12577506","1659448","2024-09"
"175140","휴먼테크놀로지","101121872400","4700","21515292","21515292","0","2024-09"
"200670","휴메딕스","317508545200","30800","10308719","11229930","921211","2024-09"
"079980","휴비스","85731383600","2605","32910320","34500000","1589680","2024-09"
"065510","휴비츠","95399139150","8770","10877895","12159371","1281476","2024-09"
"215090","휴센텍","149904424845","1505","99604269","99649272","45003","2024-09"
"005010","휴스틸","221100075125","3935","56188075","56188075","0","2024-09"
"263920","휴엠앤씨","49682720742","1013","49045134","49045134","0","2024-09"
"243070","휴온스","324203769900","27450","11810702","11979665","168963","2024-09"
"084110","휴온스글로벌","436712478700","35900","12164693","12621492","456799","2024-09"
"145020","휴젤","2953291107000","268500","10999222","12604033","1604811","2024-09"
"024060","흥구석유","247193889000","17000","14540817","15000000","459183","2024-09"
"010240","흥국","54191056920","4895","11070696","12322696","1252000","2024-09"
"189980","흥국에프엔비","69802617588","1804","38693247","40137827","1444580","2024-09"
"000540","흥국화재","220352272350","3430","64242645","64242645","0","2024-09"
"003280","흥아해운","457704524010","1905","240264842","240424899","160057","2024-09"
"037440","희림","57189075600","4530","12624520","13922475","1297955","2024-09"
"238490","힘스","47840741400","4310","11099940","11312236","212296","2024-09"