종목코드,종목명,자기주식 제외 시가총액(A*B),종가,자기주식 제외 발행주식수(B=C-D),총발행주식수(C),자기주식수(D),자기주식수 반영시점
"060310","3S","108299441040","2120","51084642","51084642","0","2024-09"
"095570","AJ네트웍스","218832634500","4890","44751050","45252759","501709","2024-09"
"006840","AK홀딩스","163068687500","12500","13045495","13247561","202066","2024-09"
"054620","APS","113559025000","6250","18169444","19894221","1724777","2024-09"
"265520","AP시스템","268259593240","17860","15020134","15281421","261287","2024-09"
"211270","AP위성","165816325650","11650","14233161","15082304","849143","2024-09"
"109960","AP헬스케어","60140143313","527","114117919","114153169","35250","2024-09"
"139050","BF랩스","24234697905","2805","8639821","8644551","4730","2024-09"
"027410","BGF","345030101430","3605","95708766","95716791","8025","2024-09"
"282330","BGF리테일","1998719235500","115700","17275015","17283906","8891","2024-09"
"126600","BGF에코머티리얼즈","210232659000","3395","61924200","62766899","842699","2024-09"
"138930","BNK금융지주","3005540419360","9440","318383519","320436727","2053208","2024-09"
"001460","BYC","202275468000","32400","6243070","6246150","3080","2024-09"
"013720","CBI","48716785032","1093","44571624","44628136","56512","2024-09"
"083790","CG인바이츠","191850984090","2495","76894182","76894182","0","2024-09"
"001040","CJ","2781609174000","102800","27058455","29176998","2118543","2024-09"
"079160","CJ CGV","932215799730","5630","165580071","165580071","0","2024-09"
"035760","CJ ENM","1303893035100","62900","20729619","21929154","1199535","2024-09"
"311690","CJ 바이오사이언스","99326271800","10900","9112502","9112502","0","2024-09"
"000120","CJ대한통운","1751182326200","87800","19945129","22812344","2867215","2024-09"
"011150","CJ씨푸드","114798819735","3195","35930773","35930773","0","2024-09"
"097950","CJ제일제당","4034293285500","274500","14696879","15054186","357307","2024-09"
"051500","CJ프레시웨이","210483219780","17730","11871586","11871586","0","2024-09"
"058820","CMG제약","290979251180","2095","138892244","138892244","0","2024-09"
"023460","CNH","4317555509","131","32958439","37200000","4241561","2024-09"
"056730","CNT85","55492478306","797","69626698","74111186","4484488","2024-09"
"000480","CR홀딩스","234749780880","5690","41256552","46890490","5633938","2024-09"
"065770","CS","20051697290","1033","19411130","19411130","0","2024-09"
"083660","CSA 코스믹","49408239996","834","59242494","61247181","2004687","2024-09"
"000590","CS홀딩스","72468494400","69600","1041214","1154482","113268","2024-09"
"012030","DB","306795035998","1606","191030533","201173933","10143400","2024-09"
"456440","DB금융스팩11호","12091625000","2275","5315000","5315000","0","2024-09"
"477760","DB금융스팩12호","12322400000","2110","5840000","5840000","0","2024-09"
"016610","DB금융투자","219944100600","5400","40730389","42446389","1716000","2024-09"
"005830","DB손해보험","6562751161700","109300","60043469","70800000","10756531","2024-09"
"000990","DB하이텍","1622084841000","39000","41591919","44398588","2806669","2024-09"
"139130","DGB금융지주","1359429437440","8170","166392832","169145833","2753001","2024-09"
"099520","DGI","58000622016","1284","45171824","45281824","110000","2024-09"
"060900","DGP","30026516132","1189","25253588","25258229","4641","2024-09"
"290120","DH오토리드","39641177590","2555","15515138","15515138","0","2024-09"
"025440","DH오토웨어","36167937025","235","153906115","153906120","5","2024-09"
"001530","DI동일","749650695300","38700","19370819","25215672","5844853","2024-09"
"000210","DL","857113270650","40950","20930727","20955884","25157","2024-09"
"375500","DL이앤씨","1188443911200","30900","38460968","38693623","232655","2024-09"
"068790","DMS","129646420960","5510","23529296","24573061","1043765","2024-09"
"007340","DN오토모티브","967567466250","19250","50263245","59065865","8802620","2024-09"
"004840","DRB동일","88749236220","4605","19272364","19930000","657636","2024-09"
"241520","DSC인베스트먼트","74262592000","2840","26148800","27496125","1347325","2024-09"
"155660","DSR","60640000000","3790","16000000","16000000","0","2024-09"
"069730","DSR제강","50400000000","3500","14400000","14400000","0","2024-09"
"017860","DS단석","512872850000","87500","5861404","5861404","0","2024-09"
"180400","DXVX","118370963880","2405","49218696","49219432","736","2024-09"
"017940","E1","430162274400","74400","5781751","6860000","1078249","2024-09"
"245620","EDGC","57441040175","415","138412145","138493951","81806","2024-09"
"037370","EG","60288554280","6990","8624972","8624972","0","2024-09"
"050120","ES큐브","23640598855","1765","13394107","13564086","169979","2024-09"
"383220","F&F","2363774562500","62500","37820393","38307075","486682","2024-09"
"007700","F&F홀딩스","529006351220","13540","39069893","39114367","44474","2024-09"
"214270","FSN","74474431360","2240","33247514","33250463","2949","2024-09"
"130500","GH신소재","45816853950","3150","14545033","14545052","19","2024-09"
"114090","GKL","708865978200","11460","61855670","61855670","0","2024-09"
"078930","GS","3827294394000","41200","92895495","92915378","19883","2024-09"
"083450","GST","286269851700","15390","18601030","18618260","17230","2024-09"
"006360","GS건설","1508475664150","17770","84888895","85581490","692595","2024-09"
"001250","GS글로벌","257797506250","3125","82495202","82533764","38562","2024-09"
"007070","GS리테일","2234266329600","21600","103438256","104717922","1279666","2024-09"
"297890","HB솔루션","274644132070","3755","73140914","73140914","0","2024-09"
"440290","HB인베스트먼트","50744322720","1872","27107010","27107010","0","2024-09"
"078150","HB테크놀러지","202588529040","2280","88854618","92715916","3861298","2024-09"
"012630","HDC","562848592500","11250","50030986","59741721","9710735","2024-09"
"039570","HDC랩스","185173285180","8060","22974353","25957601","2983248","2024-09"
"089470","HDC현대EP","99921071865","3855","25919863","31900000","5980137","2024-09"
"294870","HDC현대산업개발","1271836120600","19820","64169330","65907330","1738000","2024-09"
"009540","HD한국조선해양","12969063142000","183400","70714630","70773116","58486","2024-09"
"267250","HD현대","5639340714000","79800","70668430","78993085","8324655","2024-09"
"267270","HD현대건설기계","909582133500","51500","17661789","18305586","643797","2024-09"
"443060","HD현대마린솔루션","6102985000000","137300","44450000","44450000","0","2024-09"
"071970","HD현대마린엔진","648917778490","19130","33921473","33921495","22","2024-09"
"010620","HD현대미포","4379295920400","109800","39884298","39942149","57851","2024-09"
"322000","HD현대에너지솔루션","258720000000","23100","11200000","11200000","0","2024-09"
"042670","HD현대인프라코어","1280730362800","6650","192591032","192655867","64835","2024-09"
"267260","HD현대일렉트릭","11787610560000","327500","35992704","36047135","54431","2024-09"
"329180","HD현대중공업","16209970981600","182600","88773116","88773116","0","2024-09"
"097230","HJ중공업","190684498600","2290","83268340","83274281","5941","2024-09"
"195940","HK이노엔","1405162593600","49600","28329891","28329891","0","2024-09"
"014790","HL D&I","89346298360","2360","37858601","37858601","0","2024-09"
"028300","HLB","8654673258000","66000","131131413","131387433","256020","2024-09"
"003580","HLB글로벌","192309110550","4050","47483731","47489591","5860","2024-09"
"278650","HLB바이오스텝","178494506640","2120","84195522","86730589","2535067","2024-09"
"067630","HLB생명과학","1053251036880","8880","118609351","118679271","69920","2024-09"
"024850","HLB이노베이션","306496659840","3360","91219244","91226268","7024","2024-09"
"047920","HLB제약","621360530020","19540","31799413","31799994","581","2024-09"
"115450","HLB테라퓨틱스","741370213730","9290","79803037","80139933","336896","2024-09"
"046210","HLB파나진","122881929100","2900","42373079","42373079","0","2024-09"
"204320","HL만도","1706891312000","36350","46957120","46957120","0","2024-09"
"060980","HL홀딩스","331966318950","34950","9498321","10169410","671089","2024-09"
"011200","HMM","12823556171520","17120","749039496","749039496","0","2024-09"
"403870","HPSP","2462527557750","30750","80082197","82934144","2851947","2024-09"
"036640","HRS","81027548550","5070","15981765","16354800","373035","2024-09"
"035000","HS애드","104215150920","6430","16207644","16567409","359765","2024-09"
"002460","HS화성","84236088100","8900","9464729","10150000","685271","2024-09"
"487570","HS효성","147693145950","39850","3706227","3725927","19700","2024-09"
"298050","HS효성첨단소재","1188493852000","266000","4468022","4479948","11926","2024-09"
"439730","IBKS제20호스팩","9374250000","2175","4310000","4310000","0","2024-09"
"442770","IBKS제21호스팩","9219900000","2190","4210000","4210000","0","2024-09"
"448760","IBKS제22호스팩","9746000000","2200","4430000","4430000","0","2024-09"
"467930","IBKS제23호스팩","9221400000","2180","4230000","4230000","0","2024-09"
"469480","IBKS제24호스팩","9369450000","2215","4230000","4230000","0","2024-09"
"003560","IHQ","63786625000","10760","5928125","6010174","82049","2024-09"
"095340","ISC","1336311737600","65300","20464192","21197058","732866","2024-09"
"175330","JB금융지주","3434539053780","17910","191766558","195083198","3316640","2024-09"
"234080","JW생명과학","168781638600","10900","15484554","15834554","350000","2024-09"
"067290","JW신약","70969490200","1400","50692493","50841502","149009","2024-09"
"001060","JW중외제약","620652213000","27000","22987119","23285930","298811","2024-09"
"096760","JW홀딩스","215852357480","2995","72070904","73924942","1854038","2024-09"
"035900","JYP Ent.","1618549932150","48850","33133059","35532492","2399433","2024-09"
"318000","KBG","49151389650","5650","8699361","8740223","40862","2024-09"
"024840","KBI메탈","93366057080","2680","34838081","34909199","71118","2024-09"
"105560","KB금융","34062576807000","90300","377215690","393528423","16312733","2024-09"
"024120","KB오토시스","42032500000","3655","11500000","11500000","0","2024-09"
"455250","KB제25호스팩","11365200000","2640","4305000","4305000","0","2024-09"
"458320","KB제26호스팩","12523875000","2275","5505000","5505000","0","2024-09"
"464680","KB제27호스팩","25526090000","1978","12905000","12905000","0","2024-09"
"476470","KB제28호스팩","11532975000","2095","5505000","5505000","0","2024-09"
"478390","KB제29호스팩","12657700000","2035","6220000","6220000","0","2024-09"
"486630","KB제30호스팩","10726200000","2020","5310000","5310000","0","2024-09"
"002380","KCC","1930469887500","262500","7354171","8886471","1532300","2024-09"
"021320","KCC건설","86264010700","4325","19945436","21400000","1454564","2024-09"
"344820","KCC글라스","624978653600","39200","15943333","15970512","27179","2024-09"
"036670","KCI","82100326000","7630","10760200","11270000","509800","2024-09"
"009070","KCTC","135173990000","4520","29905750","30000000","94250","2024-09"
"009440","KC그린홀딩스","18673483120","844","22124980","22434980","310000","2024-09"
"119650","KC코트렐","27804804457","433","64214329","64214329","0","2024-09"
"044180","KD","12500837388","468","26711191","26717799","6608","2024-09"
"092220","KEC","181690642605","905","200763141","200763141","0","2024-09"
"046440","KG모빌리언스","166221538560","4480","37103022","38825568","1722546","2024-09"
"003620","KG모빌리티","884801164270","4505","196404254","196404254","0","2024-09"
"016380","KG스틸","680766603660","6830","99673002","100008897","335895","2024-09"
"151860","KG에코솔루션","218615444980","5210","41960738","49603002","7642264","2024-09"
"035600","KG이니시스","243825350080","9160","26618488","27904434","1285946","2024-09"
"001390","KG케미칼","272164434000","3975","68469040","68469040","0","2024-09"
"226360","KH 건설","60474013950","2555","23668890","23756732","87842","2024-09"
"111870","KH 미래물산","43747975260","8910","4909986","4930249","20263","2024-09"
"033180","KH 필룩스","125157155370","6630","18877399","18903579","26180","2024-09"
"060720","KH바텍","204287087340","9270","22037442","23677442","1640000","2024-09"
"015590","KIB플러그에너지","96214505646","406","236981541","236981544","3","2024-09"
"001940","KISCO홀딩스","270270401200","21400","12629458","16176380","3546922","2024-09"
"058400","KNN","109784237880","829","132429720","132429720","0","2024-09"
"025000","KPX케미칼","224208670150","47150","4755221","4840000","84779","2024-09"
"092230","KPX홀딩스","219754583100","55900","3931209","4224646","293437","2024-09"
"000040","KR모터스","31503540240","524","60121260","60132868","11608","2024-09"
"044450","KSS해운","217421565750","9630","22577525","23085880","508355","2024-09"
"101000","KS인더스트리","66291808000","2200","30132640","30149619","16979","2024-09"
"030200","KT","10902373121250","44350","245825775","252021685","6195910","2024-09"
"033780","KT&G","12035849917100","109700","109716043","130322497","20606454","2024-09"
"058850","KTcs","108125377650","2850","37938729","42685000","4746271","2024-09"
"058860","KTis","81142422300","2650","30619782","34802000","4182218","2024-09"
"122450","KX","146146337920","3520","41518846","45335964","3817118","2024-09"
"052900","KX하이텍","51410105120","946","54344720","55107517","762797","2024-09"
"376190","LB루셈","113652000000","4620","24600000","24600000","0","2024-09"
"061970","LB세미콘","195717126240","4470","43784592","43784592","0","2024-09"
"309960","LB인베스트먼트","89107341625","3875","22995443","23217239","221796","2024-09"
"093050","LF","414439899120","14970","27684696","29240000","1555304","2024-09"
"003550","LG","11445234702800","75700","151192004","157300993","6108989","2024-09"
"034220","LG디스플레이","5320000000000","10640","500000000","500000000","0","2024-09"
"051900","LG생활건강","4859718727500","331500","14659785","15618197","958412","2024-09"
"373220","LG에너지솔루션","95355000000000","407500","234000000","234000000","0","2024-09"
"032640","LG유플러스","4302581803520","10010","429828352","436611361","6783009","2024-09"
"011070","LG이노텍","4202816443200","177600","23664507","23667107","2600","2024-09"
"066570","LG전자","14578175101000","89500","162884638","163647814","763176","2024-09"
"037560","LG헬로비전","202523551975","2615","77446865","77446865","0","2024-09"
"051910","LG화학","22130699530500","313500","70592343","70592343","0","2024-09"
"079550","LIG넥스원","5405001280000","248000","21794360","22000000","205640","2024-09"
"225190","LK삼양","115960185400","2285","50748440","50748440","0","2024-09"
"006260","LS","2860552474800","104600","27347538","32200000","4852462","2024-09"
"010120","LS ELECTRIC","4338533229800","146300","29655046","30000000","344954","2024-09"
"000680","LS네트웍스","252563659870","3205","78803014","78803016","2","2024-09"
"060370","LS마린솔루션","398922009480","14580","27360906","28706781","1345875","2024-09"
"417200","LS머트리얼즈","1049292741090","15510","67652659","67652659","0","2024-09"
"229640","LS에코에너지","829459203600","27350","30327576","30624879","297303","2024-09"
"078020","LS증권","222541130180","4415","50405692","55481190","5075498","2024-09"
"108320","LX세미콘","1001880880000","61600","16264300","16264300","0","2024-09"
"001120","LX인터내셔널","1097021011000","30500","35967902","38760000","2792098","2024-09"
"108670","LX하우시스","354859371750","39650","8949795","8967670","17875","2024-09"
"383800","LX홀딩스","543555043770","7130","76234929","76280690","45761","2024-09"
"476080","M83","101049300000","12980","7785000","7785000","0","2024-09"
"086960","MDS테크","97834164552","1054","92821788","92821788","0","2024-09"
"023150","MH에탄올","36115937670","5630","6414909","7378526","963617","2024-09"
"038340","MIT","39924432729","1233","32379913","32424892","44979","2024-09"
"035420","NAVER","25711640480000","170000","151244944","160784508","9539564","2024-09"
"160550","NEW","65718879630","2355","27906106","27906106","0","2024-09"
"053290","NE능률","58833652920","3560","16526307","16526307","0","2024-09"
"181710","NHN","553685469600","16820","32918280","33766123","847843","2024-09"
"060250","NHN KCP","281490787760","7280","38666317","40160611","1494294","2024-09"
"104200","NHN벅스","47389611870","3505","13520574","14827550","1306976","2024-09"
"005940","NH투자증권","4369431356360","13370","326808628","327492299","683671","2024-09"
"034310","NICE","394353156890","11270","34991407","37503477","2512070","2024-09"
"030190","NICE평가정보","652121102220","11130","58591294","60107670","1516376","2024-09"
"008260","NI스틸","112112458640","3920","28600117","28600117","0","2024-09"
"004250","NPC","165467941200","4880","33907365","36720000","2812635","2024-09"
"222160","NPX","79551289560","8040","9894439","9894439","0","2024-09"
"456040","OCI","647265388500","72300","8952495","8952495","0","2024-09"
"010060","OCI홀딩스","1283616942400","68800","18657223","19127353","470130","2024-09"
"178920","PI첨단소재","606414549300","20650","29366322","29366322","0","2024-09"
"024940","PN풍년","59587631200","6340","9398680","10000000","601320","2024-09"
"005490","POSCO홀딩스","25370771354500","335500","75620779","82624377","7003598","2024-09"
"218410","RFHIC","332905348420","12940","25726843","26484442","757599","2024-09"
"327260","RF머트리얼즈","52085797990","6290","8280731","8433231","152500","2024-09"
"091340","S&K폴리텍","28700878440","2680","10709283","11703721","994438","2024-09"
"010950","S-Oil","6450993981600","57300","112582792","112582792","0","2024-09"
"419530","SAMG엔터","102243784500","12870","7944350","8590930","646580","2024-09"
"019550","SBI인베스트먼트","110543688458","686","161142403","162066575","924172","2024-09"
"034120","SBS","288427526700","15550","18548394","18551238","2844","2024-09"
"036120","SCI평가정보","78615677910","2310","34032761","35500000","1467239","2024-09"
"246960","SCL사이언스","59796722210","8210","7283401","7283401","0","2024-09"
"099220","SDN","65710406743","1213","54171811","56171811","2000000","2024-09"
"036540","SFA반도체","603391196320","3680","163964999","164460303","495304","2024-09"
"255220","SG","247922487450","2970","83475585","94073791","10598206","2024-09"
"040610","SG&G","56085994932","1662","33746086","34087196","341110","2024-09"
"049470","SGA","17896842990","306","58486415","58862249","375834","2024-09"
"184230","SGA솔루션즈","31430073528","504","62361257","62599161","237904","2024-09"
"016250","SGC E&C","49168686400","15200","3234782","3243585","8803","2024-09"
"005090","SGC에너지","383232637200","26600","14407242","14409333","2091","2024-09"
"001380","SG글로벌","130396014700","2900","44964143","44964143","0","2024-09"
"004060","SG세계물산","71361027724","359","198777236","202424960","3647724","2024-09"
"001770","SHD","21867804000","18000","1214878","1214878","0","2024-09"
"002360","SH에너지화학","55426209204","509","108892356","111133730","2241374","2024-09"
"009160","SIMPAC","214907283360","3960","54269516","65429516","11160000","2024-09"
"033530","SJG세종","120653253540","4460","27052299","27820961","768662","2024-09"
"123700","SJM","51106040950","3275","15604898","15604898","0","2024-09"
"025530","SJM홀딩스","48245087960","3560","13551991","14934008","1382017","2024-09"
"034730","SK","8079915721800","148200","54520349","72502703","17982354","2024-09"
"011790","SKC","5168003342000","151700","34067260","37868298","3801038","2024-09"
"018670","SK가스","1792316686200","199700","8975046","9230244","255198","2024-09"
"001740","SK네트웍스","1020064383400","5260","193928590","221277902","27349312","2024-09"
"006120","SK디스커버리","598588468400","33800","17709718","18785855","1076137","2024-09"
"210980","SK디앤디","148848728000","8000","18606091","18617382","11291","2024-09"
"302440","SK바이오사이언스","4238588551300","54100","78347293","78347293","0","2024-09"
"326030","SK바이오팜","9233132175000","117900","78313250","78313250","0","2024-09"
"402340","SK스퀘어","11306310563200","84800","133329134","134749960","1420826","2024-09"
"361610","SK아이이테크놀로지","2452511536000","34400","71293940","71297592","3652","2024-09"
"100090","SK오션플랜트","793812566880","13410","59195568","59195568","0","2024-09"
"096770","SK이노베이션","11178756855600","117400","95219394","95735590","516196","2024-09"
"475150","SK이터닉스","514126729440","15270","33669072","33691895","22823","2024-09"
"001510","SK증권","211506069733","511","413906203","472590171","58683968","2024-09"
"285130","SK케미칼","861146300000","50000","17222926","17253783","30857","2024-09"
"017670","SK텔레콤","12070655591400","56700","212886342","214790053","1903711","2024-09"
"000660","SK하이닉스","128367915585300","186300","689038731","728002365","38963634","2024-09"
"048550","SM C&C","162290895957","1691","95973327","96714620","741293","2024-09"
"063440","SM Life Design","64716990524","1406","46029154","46029154","0","2024-09"
"003570","SNT다이내믹스","562085660100","25100","22393851","33252697","10858846","2024-09"
"064960","SNT모티브","547109249200","45700","11971756","14623136","2651380","2024-09"
"100840","SNT에너지","259265736960","13120","19761108","20680783","919675","2024-09"
"036530","SNT홀딩스","328957310500","22750","14459662","16303886","1844224","2024-09"
"067160","SOOP","1023010560000","96000","10656360","11494767","838407","2024-09"
"005610","SPC삼립","402424321950","49650","8105223","8629009","523786","2024-09"
"011810","STX","153970848500","4970","30980050","31017927","37877","2024-09"
"465770","STX그린로지스","72017467200","10080","7144590","7171032","26442","2024-09"
"077970","STX엔진","438602505490","19070","22999607","23008904","9297","2024-09"
"002820","SUN&L","35707083840","2960","12063204","12607989","544785","2024-09"
"289080","SV인베스트먼트","83737082000","1573","53234000","53234000","0","2024-09"
"084870","TBH글로벌","29428971609","1411","20856819","20856819","0","2024-09"
"002710","TCC스틸","1146849243750","43750","26213697","26213697","0","2024-09"
"089230","THE E&M","27999028480","1280","21874241","21882953","8712","2024-09"
"032540","TJ미디어","72583682890","5210","13931609","13931609","0","2024-09"
"022220","TKG애강","53037648896","1024","51794579","51794579","0","2024-09"
"069260","TKG휴켐스","762429325990","19870","38370877","40878588","2507711","2024-09"
"007980","TP","67726805088","1392","48654314","51175130","2520816","2024-09"
"048770","TPC","37832158310","2410","15697991","15697991","0","2024-09"
"246690","TS인베스트먼트","40837116320","1001","40796320","41477862","681542","2024-09"
"317240","TS트릴리온","29786621715","279","106762085","107240922","478837","2024-09"
"002900","TYM","133932012240","3120","42926927","45050956","2124029","2024-09"
"024070","WISCOM","31955623230","2085","15326438","15326438","0","2024-09"
"057030","YBM넷","57049823175","3525","16184347","16312697","128350","2024-09"
"037270","YG PLUS","362181931100","5710","63429410","63429410","0","2024-09"
"040300","YTN","133560000000","3180","42000000","42000000","0","2024-09"
"051390","YW","30439779240","3770","8074212","11355368","3281156","2024-09"
"052220","iMBC","59110000000","2570","23000000","23000000","0","2024-09"
"079940","가비아","174998529000","13500","12962854","13535684","572830","2024-09"
"078890","가온그룹","56398722120","3510","16068012","17410157","1342145","2024-09"
"000500","가온전선","268393597200","37650","7128648","7357946","229298","2024-09"
"399720","가온칩스","453788640000","39500","11488320","11488320","0","2024-09"
"036620","감성코퍼레이션","329857682420","3635","90744892","90744892","0","2024-09"
"000860","강남제비스코","162500000000","25000","6500000","6500000","0","2024-09"
"198440","강동씨앤엘","89037337312","1463","60859424","60931896","72472","2024-09"
"217730","강스템바이오텍","119675608115","2135","56054149","56054149","0","2024-09"
"035250","강원랜드","3620918504280","17860","202738998","213940500","11201502","2024-09"
"114190","강원에너지","327060435760","12520","26123038","26123038","0","2024-09"
"094480","갤럭시아머니트리","333845921380","8510","39229838","39229838","0","2024-09"
"011420","갤럭시아에스엠","59507231040","2160","27549644","27549644","0","2024-09"
"039240","경남스틸","77161667440","2860","26979604","26979604","0","2024-09"
"053950","경남제약","24310097545","683","35593115","35593402","287","2024-09"
"002100","경농","165605305500","9270","17864650","19522575","1657925","2024-09"
"009450","경동나비엔","1253069204400","86700","14452932","14568592","115660","2024-09"
"267290","경동도시가스","110916740410","18830","5890427","5895406","4979","2024-09"
"012320","경동인베스트","166360857600","76300","2180352","2365023","184671","2024-09"
"011040","경동제약","170271986400","6320","26941770","30768766","3826996","2024-09"
"000050","경방","154723826700","6210","24915270","27415270","2500000","2024-09"
"214390","경보제약","177867038400","7440","23906860","23906860","0","2024-09"
"012610","경인양행","124304355210","3005","41365842","41616365","250523","2024-09"
"009140","경인전자","26506627950","20350","1302537","1570797","268260","2024-09"
"024910","경창산업","79707891200","2240","35583880","35819005","235125","2024-09"
"013580","계룡건설","117542966190","13270","8857797","8930907","73110","2024-09"
"012200","계양전기","39868828764","1466","27195654","27222829","27175","2024-09"
"002140","고려산업","72287260600","2930","24671420","24939425","268005","2024-09"
"049720","고려신용정보","135078475200","9700","13925616","14300000","374384","2024-09"
"010130","고려아연","20512272242000","998000","20553379","20703283","149904","2024-09"
"002240","고려제강","481268167380","19260","24987963","25000000","12037","2024-09"
"014570","고려제약","52868496100","4900","10789489","11000000","210511","2024-09"
"348150","고바이오랩","132517134000","6840","19373850","19373850","0","2024-09"
"098460","고영","722410082640","10980","65793268","68654755","2861487","2024-09"
"035290","골드앤에스","21502092480","451","47676480","47676480","0","2024-09"
"215000","골프존","387929460000","64600","6005100","6275415","270315","2024-09"
"121440","골프존뉴딘홀딩스","154187811470","3785","40736542","42836818","2100276","2024-09"
"366030","공구우먼","97864632000","4320","22653850","22653850","0","2024-09"
"009290","광동제약","222046590480","5540","40080612","52420851","12340239","2024-09"
"014200","광림","87868591200","30200","2909556","3023556","114000","2024-09"
"017040","광명전기","59285857320","1368","43337615","43337615","0","2024-09"
"029480","광무","204218386930","3715","54971302","55009083","37781","2024-09"
"017900","광전자","92266413816","1832","50363763","57943763","7580000","2024-09"
"037710","광주신세계","226527008400","29700","7627172","7957190","330018","2024-09"
"026910","광진실업","14187972075","2215","6405405","6405405","0","2024-09"
"421800","교보12호스팩","16205800000","2710","5980000","5980000","0","2024-06"
"440790","교보13호스팩","8889750000","2195","4050000","4050000","0","2024-09"
"456490","교보14호스팩","9009000000","2145","4200000","4200000","0","2024-09"
"465320","교보15호스팩","8305800000","2180","3810000","3810000","0","2024-09"
"482520","교보16호스팩","12566000000","2060","6100000","6100000","0","2024-09"
"030610","교보증권","603851092050","5350","112869363","113962961","1093598","2024-09"
"339770","교촌에프앤비","264065447800","10570","24982540","24982540","0","2024-09"
"053270","구영테크","58036045600","2225","26083616","27410405","1326789","2024-09"
"007690","국도화학","276488702100","33150","8340534","9010616","670082","2024-09"
"005320","국동","29200829994","441","66215034","67327897","1112863","2024-09"
"001140","국보","33448047050","2110","15852155","15856388","4233","2024-09"
"066620","국보디자인","110578005720","16730","6609564","7500000","890436","2024-09"
"043650","국순당","82007827860","5210","15740466","17858304","2117838","2024-09"
"006050","국영지앤엠","69485248150","2050","33895243","34895243","1000000","2024-09"
"060480","국일신동","21769670000","1963","11090000","11090000","0","2024-09"
"078130","국일제지","901924696800","800","1127405871","1127405871","0","2024-09"
"307750","국전약품","203146289280","4140","49069152","49069269","117","2024-09"
"002720","국제약품","109957510800","5400","20362502","21159832","797330","2024-09"
"035080","그래디언트","165403604340","12090","13681026","14527584","846558","2024-09"
"453450","그리드위즈","146305455000","18420","7942750","7942750","0","2024-09"
"204020","그리티","56160747885","2805","20021657","20147430","125773","2024-09"
"402490","그린리소스","138537221440","16760","8265944","8265944","0","2024-09"
"114450","그린생명과학","39511062900","2070","19087470","20000000","912530","2024-09"
"083420","그린케미칼","133659836520","5730","23326324","24000000","673676","2024-09"
"186230","그린플러스","98809729600","9200","10740188","10820188","80000","2024-09"
"014530","극동유화","125250242400","3720","33669420","34869420","1200000","2024-09"
"204620","글로벌텍스프리","244461212000","4000","61115303","61116035","732","2024-09"
"019660","글로본","16838721064","484","34790746","34790746","0","2024-09"
"014280","금강공업","110041319115","4095","26872117","29329357","2457240","2024-09"
"053260","금강철강","73920082800","4650","15896792","18720000","2823208","2024-09"
"008870","금비","45590450000","55700","818500","1000000","181500","2024-09"
"001570","금양","2403904556500","41500","57925411","58050037","124626","2024-09"
"282720","금양그린파워","124892415000","10350","12066900","12119500","52600","2024-09"
"002990","금호건설","103737601960","2890","35895364","36953595","1058231","2024-09"
"011780","금호석유","3274203377800","142600","22960753","27334587","4373834","2024-09"
"214330","금호에이치티","131416933035","645","203747183","213914131","10166948","2024-09"
"001210","금호전기","32685095908","766","42669838","43535722","865884","2024-09"
"073240","금호타이어","1273999372845","4435","287260287","287260287","0","2024-09"
"036190","금화피에스시","162409225000","27500","5905790","6000000","94210","2024-09"
"049080","기가레인","58821838614","693","84879998","84883347","3349","2024-09"
"420770","기가비스","472805773400","37300","12675758","12675758","0","2024-09"
"035460","기산텔레콤","25699850420","1763","14577340","14577340","0","2024-09"
"092440","기신정기","75190000000","2575","29200000","29200000","0","2024-09"
"000270","기아","36009659383100","91900","391835249","399858417","8023168","2024-09"
"024110","기업은행","11243704724700","14100","797425867","797425869","2","2024-09"
"013700","까뮤이앤씨","78154085640","1308","59750830","59750830","0","2024-09"
"308100","까스텔바작","19672082150","3050","6449863","6624733","174870","2024-09"
"004540","깨끗한나라","77830026230","2090","37239247","37240693","1446","2024-09"
"407400","꿈비","73126675000","6200","11794625","12259474","464849","2024-09"
"187790","나노","31435070025","1025","30668361","30840830","172469","2024-09"
"286750","나노브릭","48009323680","2320","20693674","20694559","885","2024-09"
"121600","나노신소재","1040917764000","87000","11964572","12196078","231506","2024-09"
"247660","나노씨엠에스","34212328020","8010","4271202","4343920","72718","2024-09"
"039860","나노엔텍","123623815700","3850","32110082","32110082","0","2024-09"
"091970","나노캠텍","21358539651","591","36139661","37417493","1277832","2024-09"
"417010","나노팀","182252790720","9240","19724328","19724328","0","2024-09"
"405920","나라셀라","45813368205","3685","12432393","12878076","445683","2024-09"
"051490","나라엠앤디","61282127200","4640","13207355","14200000","992645","2024-09"
"137080","나래나노텍","34947773520","3160","11059422","11059422","0","2024-09"
"190510","나무가","193774547280","12260","15805428","16264384","458956","2024-09"
"242040","나무기술","53317606772","1609","33137108","34606264","1469156","2024-09"
"089600","나스미디어","173662755840","15360","11306169","11568163","261994","2024-09"
"293580","나우IB","91414401750","965","94729950","94929950","200000","2024-09"
"138610","나이벡","199590807240","18360","10870959","10870959","0","2024-09"
"130580","나이스디앤비","78540000000","5100","15400000","15400000","0","2024-09"
"036800","나이스정보통신","164192184000","18720","8770950","10000000","1229050","2024-09"
"267320","나인테크","91795790475","2115","43402265","43664104","261839","2024-09"
"001260","남광토건","62773532460","6390","9823714","9832572","8858","2024-09"
"008350","남선알미늄","176967432390","1371","129079090","129079090","0","2024-09"
"004270","남성","40656588126","1298","31322487","36212160","4889673","2024-09"
"003920","남양유업","454067847000","691000","657117","679731","22614","2024-09"
"025860","남해화학","313104978350","6530","47948695","49678843","1730148","2024-09"
"111710","남화산업","112204600000","5450","20588000","20588000","0","2024-09"
"091590","남화토건","46725200000","3980","11740000","11740000","0","2024-09"
"168330","내츄럴엔도텍","48212491707","1527","31573341","31754900","181559","2024-09"
"094860","네오리진","27884832496","1304","21384074","21399569","15495","2024-09"
"253590","네오셈","484489306800","11400","42499062","43869164","1370102","2024-09"
"212560","네오오토","67091225640","8520","7874557","7874963","406","2024-09"
"095660","네오위즈","416098162700","20900","19909003","22033719","2124716","2024-09"
"042420","네오위즈홀딩스","134266072850","20650","6501989","8856866","2354877","2024-09"
"311390","네오크레마","79390440090","7290","10890321","10979147","88826","2024-09"
"085910","네오티스","47957527290","3585","13377274","13934818","557544","2024-09"
"092730","네오팜","101042513760","12920","7820628","8207361","386733","2024-09"
"290660","네오펙트","39728130759","943","42129513","42129513","0","2024-09"
"306620","네온테크","105487345440","2580","40886568","42608149","1721581","2024-09"
"153460","네이블","40974950400","6400","6402336","6530014","127678","2024-09"
"007390","네이처셀","1406203858600","21850","64357156","64357156","0","2024-09"
"033640","네패스","178959754820","7870","22739486","23059202","319716","2024-09"
"330860","네패스아크","160342032200","13160","12184045","12184045","0","2024-09"
"005720","넥센","220671575550","4555","48446010","53543977","5097967","2024-09"
"002350","넥센타이어","649103125500","6750","96163426","97667877","1504451","2024-09"
"089140","넥스턴바이오","60891172200","5400","11276143","11282627","6484","2024-09"
"389650","넥스트바이오메디컬","264434632200","32700","8086686","8086686","0","2024-09"
"137940","넥스트아이","31237207056","408","76561782","78320992","1759210","2024-09"
"396270","넥스트칩","237869561000","13150","18088940","18088940","0","2024-09"
"348210","넥스틴","669813364800","64800","10336626","10437250","100624","2024-09"
"092790","넥스틸","231937840000","8920","26002000","26002000","0","2024-09"
"225570","넥슨게임즈","910282669410","14230","63969267","65860174","1890907","2024-09"
"217270","넵튠","231963687670","5170","44867251","46676150","1808899","2024-09"
"251270","넷마블","4752205118000","58000","81934571","85953502","4018931","2024-09"
"104620","노랑풍선","71527198890","4515","15842126","15842126","0","2024-09"
"090350","노루페인트","168600000000","8430","20000000","20000000","0","2024-09"
"000320","노루홀딩스","135077773740","13180","10248693","13291151","3042458","2024-09"
"194700","노바렉스","174366827600","9850","17702216","18754848","1052632","2024-09"
"285490","노바텍","117137573400","11800","9926913","10575831","648918","2024-09"
"145170","노브랜드","106973301600","12900","8292504","9079834","787330","2024-09"
"106520","노블엠앤비","15902299386","411","38691726","38695952","4226","2024-09"
"376930","노을","116567974300","3155","36947060","36947060","0","2024-09"
"006280","녹십자","1853500107200","162400","11413178","11686538","273360","2024-09"
"142280","녹십자엠에스","89975208270","4145","21706926","21741926","35000","2024-09"
"234690","녹십자웰빙","196084084300","11050","17745166","17752276","7110","2024-09"
"005250","녹십자홀딩스","736022032200","16380","44934190","47028210","2094020","2024-09"
"004370","농심","2165592313500","374500","5782623","6082642","300019","2024-09"
"072710","농심홀딩스","313978383000","67700","4637790","4637790","0","2024-09"
"054050","농우바이오","116061261640","7240","16030561","16030561","0","2024-09"
"069140","누리플랜","18004741803","1377","13075339","13102743","27404","2024-09"
"040160","누리플렉스","28753371825","2545","11297985","12055535","757550","2024-09"
"332290","누보","37018564875","1125","32905391","33384803","479412","2024-09"
"348340","뉴로메카","214148151000","20300","10549170","10549170","0","2024-09"
"060260","뉴보텍","14676591600","1100","13342356","13512009","169653","2024-09"
"123840","뉴온","55623159698","214","259921307","292370108","32448801","2024-09"
"012340","뉴인텍","27284325848","536","50903593","50907162","3569","2024-09"
"270870","뉴트리","78884799420","8770","8994846","9200224","205378","2024-09"
"144960","뉴파워프라즈마","196663705380","4860","40465783","43692624","3226841","2024-09"
"085670","뉴프렉스","128119488160","5240","24450284","24450761","477","2024-09"
"064260","다날","211733794150","3170","66792995","68949040","2156045","2024-09"
"340360","다보링크","119317583000","2750","43388212","43388212","0","2024-09"
"039560","다산네트웍스","132296776560","3420","38683268","39505981","822713","2024-09"
"154040","다산솔루에타","31233163560","1740","17950094","17950094","0","2024-09"
"058730","다스코","60088998200","3305","18181240","18796941","615701","2024-09"
"030210","다올투자증권","165871750800","2800","59239911","60911106","1671195","2024-09"
"023590","다우기술","792681096130","18370","43150849","44866617","1715768","2024-09"
"032190","다우데이타","419385000000","10950","38300000","38300000","0","2024-09"
"323350","다원넥스뷰","50332573200","6630","7591640","7596111","4471","2024-09"
"068240","다원시스","424377419440","11120","38163437","38163437","0","2024-09"
"145210","다이나믹디자인","96771326400","2800","34561188","34581687","20499","2024-09"
"019680","대교","152622671670","2265","67383078","84702850","17319772","2024-09"
"006370","대구백화점","59665950870","7170","8321611","10821611","2500000","2024-09"
"008060","대덕","210796733000","6220","33890150","33890150","0","2024-09"
"353200","대덕전자","851453617750","17230","49416925","49416925","0","2024-09"
"000490","대동","196091475840","8320","23568687","25640788","2072101","2024-09"
"020400","대동금속","19836612520","6220","3189166","3189166","0","2024-09"
"008830","대동기어","69024153600","7680","8987520","8987520","0","2024-09"
"048470","대동스틸","34609395360","3680","9404727","10000000","595273","2024-09"
"008110","대동전자","105136322880","15040","6990447","10490447","3500000","2024-09"
"004780","대륙제관","64964567915","4085","15903199","15903199","0","2024-09"
"005750","대림B&Co","58602923600","3515","16672240","16672240","0","2024-09"
"017650","대림제지","57928250000","6950","8335000","9000000","665000","2024-09"
"006570","대림통상","40297462600","2675","15064472","15225000","160528","2024-09"
"007720","대명소노시즌","123883753050","1229","100800450","100800450","0","2024-09"
"389260","대명에너지","201190000000","11800","17050000","17050000","0","2024-09"
"317850","대모","81329583400","9770","8324420","8324420","0","2024-09"
"290670","대보마그네틱","121784993600","16300","7471472","7857660","386188","2024-09"
"078140","대봉엘에스","186885244830","17070","10948169","11086579","138410","2024-09"
"065150","대산F&B","18113400725","145","124920005","125282405","362400","2024-09"
"001680","대상","713749315000","20600","34648025","34648025","0","2024-09"
"084690","대상홀딩스","317946083640","8780","36212538","36212538","0","2024-09"
"036480","대성미생물","38532000000","10140","3800000","3800000","0","2024-09"
"128820","대성산업","129051815230","3445","37460614","45235478","7774864","2024-09"
"117580","대성에너지","248830095900","9150","27194546","27500000","305454","2024-09"
"027830","대성창투","80406000000","1489","54000000","54000000","0","2024-09"
"104040","대성파인텍","44960738635","965","46591439","47224987","633548","2024-09"
"129920","대성하이텍","55271663590","4030","13715053","13715053","0","2024-09"
"016710","대성홀딩스","124523550360","7740","16088314","16089459","1145","2024-09"
"438220","대신밸런스제13호스팩","14692200000","2605","5640000","5640000","0","2024-09"
"442310","대신밸런스제14호스팩","14996850000","2235","6710000","6710000","0","2024-09"
"457390","대신밸런스제15호스팩","16778475000","2385","7035000","7035000","0","2024-09"
"457630","대신밸런스제16호스팩","15789600000","2160","7310000","7310000","0","2024-09"
"471050","대신밸런스제17호스팩","12907800000","2130","6060000","6060000","0","2024-09"
"478780","대신밸런스제18호스팩","16294600000","2060","7910000","7910000","0","2024-09"
"020180","대신정보통신","33548442795","873","38428915","38428915","0","2024-09"
"003540","대신증권","645589392400","17200","37534267","50773400","13239133","2024-09"
"045390","대아티아이","188163916590","2670","70473377","70473377","0","2024-09"
"009190","대양금속","70436902149","1663","42355323","42359986","4663","2024-09"
"108380","대양전기공업","105748065280","11440","9243712","9567333","323621","2024-09"
"014160","대영포장","98116865790","1030","95259093","108394549","13135456","2024-09"
"047040","대우건설","1452481020200","3535","410885720","415622638","4736918","2024-09"
"003090","대웅","1061113924500","25950","40890710","58141980","17251270","2024-09"
"069620","대웅제약","1829496930000","159000","11506270","11586575","80305","2024-09"
"007680","대원","58761091380","4370","13446474","13446474","0","2024-09"
"000430","대원강업","245210000000","3955","62000000","62000000","0","2024-09"
"048910","대원미디어","97158688560","8040","12084414","12578946","494532","2024-09"
"005710","대원산업","119023344000","5940","20037600","20037600","0","2024-09"
"006340","대원전선","205442939500","2740","74979175","74979175","0","2024-09"
"003220","대원제약","307569849650","14350","21433439","22427583","994144","2024-09"
"024890","대원화성","43001369560","1055","40759592","41249152","489560","2024-09"
"290380","대유","56838037000","2300","24712190","24713612","1422","2024-09"
"002880","대유에이텍","49769741880","1065","46732152","46744020","11868","2024-09"
"000300","대유플러스","156936737152","1984","79101178","79101178","0","2024-09"
"120240","대정화금","101572384560","14160","7173191","7190391","17200","2024-09"
"003310","대주산업","51283515150","1449","35392350","35392350","0","2024-09"
"078600","대주전자재료","1620253884000","108200","14974620","15480593","505973","2024-09"
"012800","대창","95018556870","1245","76320126","91140499","14820373","2024-09"
"015230","대창단조","128338954600","5090","25213940","28572230","3358290","2024-09"
"096350","대창솔루션","52839552628","332","159155279","163761009","4605730","2024-09"
"140520","대창스틸","47387091820","2245","21107836","21109243","1407","2024-09"
"131220","대한과학","35920553540","4820","7452397","7454490","2093","2024-09"
"010170","대한광통신","76150411652","1022","74511166","74511166","0","2024-09"
"054670","대한뉴팜","109475254200","7800","14035289","14354920","319631","2024-09"
"001070","대한방직","21059796450","5830","3612315","5300000","1687685","2024-09"
"023910","대한약품","147882000000","25150","5880000","6000000","120000","2024-09"
"006650","대한유화","664548360000","107600","6176100","6500000","323900","2024-09"
"001440","대한전선","2178930712620","11730","185757094","186447300","690206","2024-09"
"084010","대한제강","232561538410","13330","17446477","23414397","5967920","2024-09"
"001790","대한제당","256560622000","2900","88469180","89696580","1227400","2024-09"
"001130","대한제분","218811201000","133000","1645197","1690000","44803","2024-09"
"003490","대한항공","8800472650700","23900","368220613","368220661","48","2024-09"
"005880","대한해운","574838605460","1801","319177460","319177460","0","2024-09"
"003830","대한화섬","131790792000","117600","1120670","1328000","207330","2024-09"
"016090","대현","89893089300","2030","44282310","44282310","0","2024-09"
"069460","대호에이엘","76514903640","1134","67473460","67544896","71436","2024-09"
"021040","대호특수강","27914690424","1524","18316726","21704774","3388048","2024-09"
"067080","대화제약","297783050000","17000","17516650","18616650","1100000","2024-09"
"298540","더네이쳐홀딩스","145449734520","9960","14603387","14765856","162469","2024-09"
"032860","더라미","63858485025","1585","40289265","40395863","106598","2024-09"
"192080","더블유게임즈","1054719632400","53200","19825557","21495906","1670349","2024-09"
"393890","더블유씨피","580254039960","17220","33696518","33696518","0","2024-09"
"299170","더블유에스아이","44531446884","1483","30027948","30027963","15","2024-09"
"012510","더존비즈온","1664913868200","59400","28028853","30382784","2353931","2024-09"
"224060","더코디","21835184625","4625","4721121","4748398","27277","2024-09"
"043090","더테크놀로지","27830368874","374","74412751","74412751","0","2024-09"
"213420","덕산네오룩스","675480162500","27500","24562915","24831179","268264","2024-09"
"317330","덕산테코피아","774014875200","37800","20476584","20476584","0","2024-09"
"077360","덕산하이메탈","210373319260","4630","45437002","45437002","0","2024-09"
"004830","덕성","92452369000","6680","13840175","15680000","1839825","2024-09"
"090410","덕신이피씨","67789615485","1471","46084035","46084095","60","2024-09"
"024900","덕양산업","109118806700","3365","32427580","32564980","137400","2024-09"
"263600","덕우전자","93988829000","5900","15930310","15930310","0","2024-09"
"194480","데브시스터즈","391934875200","36300","10797104","12035480","1238376","2024-09"
"263800","데이타솔루션","71365272000","4400","16219380","16219380","0","2024-09"
"206560","덱스터","188663497500","7500","25155133","25411736","256603","2024-09"
"261200","덴티스","108319779250","7090","15277825","15809700","531875","2024-09"
"145720","덴티움","678700221700","78700","8623891","11068830","2444939","2024-09"
"067990","도이치모터스","137859224410","4645","29679058","30181550","502492","2024-09"
"002150","도화엔지니어링","222083152750","6670","33295825","33720000","424175","2024-09"
"006620","동구바이오제약","146430709200","5400","27116798","28464992","1348194","2024-09"
"100130","동국S&C","140448981960","2520","55733723","57143000","1409277","2024-09"
"005160","동국산업","349335506580","6780","51524411","54244482","2720071","2024-09"
"460850","동국씨엠","191626830720","6420","29848416","29898656","50240","2024-09"
"075970","동국알앤에스","47380000000","2575","18400000","18400000","0","2024-09"
"460860","동국제강","432571866660","8730","49550042","49608017","57975","2024-09"
"086450","동국제약","791429760000","18000","43968320","44460000","491680","2024-09"
"001230","동국홀딩스","245391174270","7890","31101543","31800483","698940","2024-09"
"023450","동남합성","106403130000","30700","3465900","3500000","34100","2024-09"
"004140","동방","110644975890","2315","47794806","47971766","176960","2024-09"
"099410","동방선기","40443559500","2900","13946055","14000000","53945","2024-09"
"007590","동방아그로","77411511840","6240","12405691","13617577","1211886","2024-09"
"005960","동부건설","91997636540","4010","22942054","22946345","4291","2024-09"
"026960","동서","2629622737950","26650","98672523","99700000","1027477","2024-09"
"002210","동성제약","101753646600","4450","22865988","26100970","3234982","2024-09"
"102260","동성케미컬","209924316780","4310","48706338","49689728","983390","2024-09"
"033500","동성화인텍","319945081580","11020","29033129","29989494","956365","2024-09"
"025950","동신건설","199080000000","23700","8400000","8400000","0","2024-09"
"000640","동아쏘시오홀딩스","777589941200","124400","6250723","6348913","98190","2024-09"
"170900","동아에스티","689503334400","76800","8977908","9167344","189436","2024-09"
"088130","동아엘텍","82006122660","9380","8742657","8742657","0","2024-09"
"028100","동아지질","172635512400","13030","13249080","14052646","803566","2024-09"
"041930","동아화성","98288874440","6620","14847262","15800000","952738","2024-09"
"001520","동양","144630696006","762","189804063","238684063","48880000","2024-09"
"084670","동양고속","21576430000","8270","2609000","2895569","286569","2024-09"
"082640","동양생명","952825556930","6110","155945263","161358585","5413322","2024-09"
"060380","동양에스텍","27907800000","1446","19300000","19700000","400000","2024-09"
"079960","동양이엔피","145148013200","18800","7720639","7860000","139361","2024-09"
"008970","동양철관","115265582986","734","157037579","157052160","14581","2024-09"
"228340","동양파일","39980000000","1999","20000000","20000000","0","2024-09"
"092780","동양피스톤","69919963280","5540","12620932","13168460","547528","2024-09"
"088910","동우팜투테이블","51700745640","2010","25721764","25831764","110000","2024-09"
"094170","동운아나텍","409922598000","21750","18847016","19067208","220192","2024-09"
"049770","동원F&B","614565497000","31850","19295620","19295620","0","2024-09"
"013120","동원개발","230652574000","2540","90808100","90808100","0","2024-09"
"018500","동원금속","60067074425","1285","46744805","46754933","10128","2024-09"
"006040","동원산업","1215738956250","33750","36021895","36021895","0","2024-09"
"030720","동원수산","26387074350","5670","4653805","4653805","0","2024-09"
"014820","동원시스템즈","1478555382000","51000","28991282","28991282","0","2024-09"
"111380","동인기연","111592081200","18800","5935749","6128000","192251","2024-09"
"163560","동일고무벨트","108003000000","7770","13900000","13900000","0","2024-09"
"109860","동일금속","73426073000","8680","8459225","9100000","640775","2024-09"
"032960","동일기연","42138213800","11150","3779212","3986323","207111","2024-09"
"004890","동일산업","86101322250","39750","2166071","2425215","259144","2024-09"
"002690","동일제강","28004679360","1476","18973360","20300360","1327000","2024-09"
"023790","동일철강","25925941005","1245","20824049","20841335","17286","2024-09"
"005290","동진쎄미켐","1390762062700","27050","51414494","51414494","0","2024-09"
"025900","동화기업","502694447220","10990","45741078","50557285","4816207","2024-09"
"000020","동화약품","208438833600","7520","27717930","27931470","213540","2024-09"
"000150","두산","2711355284500","200500","13522969","16523835","3000866","2024-09"
"454910","두산로보틱스","4550362596000","70200","64819980","64819980","0","2024-09"
"241560","두산밥캣","3753457837500","37500","100092209","100249166","156957","2024-09"
"034020","두산에너빌리티","12841326618400","20050","640465168","640561146","95978","2024-09"
"131970","두산테스나","507535830000","30000","16917861","17006566","88705","2024-09"
"336260","두산퓨얼셀","1142672748550","17450","65482679","65493726","11047","2024-09"
"016740","두올","111054163470","3565","31151238","32066680","915442","2024-09"
"073190","듀오백","27437326240","2480","11063438","11968040","904602","2024-09"
"030350","드래곤플라이","17832966061","257","69388973","69388973","0","2024-09"
"203650","드림시큐리티","166966006575","3425","48749199","50605754","1856555","2024-09"
"223250","드림씨아이에스","94483316280","3970","23799324","23799324","0","2024-09"
"060570","드림어스컴퍼니","161452058355","2135","75621573","75621573","0","2024-09"
"362990","드림인사이트","34023957600","2075","16397088","16800574","403486","2024-09"
"192650","드림텍","571197178620","8460","67517397","68883113","1365716","2024-09"
"217620","디딤이앤에프","21715711458","381","56996618","57747210","750592","2024-09"
"016670","디모아","19470003090","3945","4935362","4941846","6484","2024-09"
"187870","디바이스이엔지","88391485900","13150","6721786","7036609","314823","2024-09"
"024090","디씨엠","101809878120","11730","8679444","11400000","2720556","2024-09"
"003160","디아이","478968717290","18410","26016769","28300000","2283231","2024-09"
"092200","디아이씨","142584820000","3680","38745875","38888569","142694","2024-09"
"110990","디아이티","260687995260","14140","18436209","18900000","463791","2024-09"
"263690","디알젬","73983051000","6750","10960452","11325610","365158","2024-09"
"214680","디알텍","227079110720","3080","73726984","73727108","124","2024-09"
"347850","디앤디파마텍","435414707700","41300","10542729","10542729","0","2024-09"
"263720","디앤씨미디어","224295519370","18070","12412591","12524473","111882","2024-09"
"376300","디어유","783367398000","33000","23738406","23738406","0","2024-09"
"109740","디에스케이","123873875450","4915","25203230","25710390","507160","2024-09"
"196490","디에이테크놀로지","36209568780","203","178372260","178549360","177100","2024-09"
"066900","디에이피","42945202920","2440","17600493","22744503","5144010","2024-09"
"127120","디엔에이링크","79817642650","3550","22483843","22483843","0","2024-09"
"092070","디엔에프","122430257640","10580","11571858","11571858","0","2024-09"
"039840","디오","241348199600","16700","14451988","14981755","529767","2024-09"
"013570","디와이","114218354330","4630","24669191","26319633","1650442","2024-09"
"219550","디와이디","54087044999","689","78500791","78500791","0","2024-09"
"310870","디와이씨","27181781118","1314","20686287","20687271","984","2024-09"
"210540","디와이파워","135740967300","12300","11035851","11041708","5857","2024-09"
"104460","디와이피엔에프","97820142640","10120","9666022","10713625","1047603","2024-09"
"079810","디이엔티","162146729780","7420","21852659","22028094","175435","2024-09"
"113810","디젠스","28843197084","884","32628051","32628051","0","2024-09"
"043360","디지아이","19753301335","2215","8917969","9000000","82031","2024-09"
"197140","디지캡","32800222290","2585","12688674","13013154","324480","2024-09"
"068930","디지털대성","193644604000","7390","26203600","27675342","1471742","2024-09"
"033130","디지틀조선","87220877450","2350","37115267","37115267","0","2024-09"
"105740","디케이락","72908238210","7170","10168513","10168513","0","2024-09"
"263020","디케이앤디","64876063160","4360","14879831","15069831","190000","2024-09"
"290550","디케이티","165010147500","8250","20001230","20001230","0","2024-09"
"066670","디티씨","50624869650","3225","15697634","18691918","2994284","2024-09"
"187220","디티앤씨","40279640835","3495","11524933","11698021","173088","2024-09"
"383930","디티앤씨알오","96161955360","7530","12770512","12770512","0","2024-09"
"131180","딜리","29759728131","1071","27786861","29350000","1563139","2024-09"
"315640","딥노이드","151567771680","6760","22421268","22421268","0","2024-09"
"223310","딥마인드","50463378680","2210","22834108","22839375","5267","2024-09"
"317120","라닉스","33816357900","3510","9634290","9660000","25710","2024-09"
"462510","라메디텍","90313673400","10440","8650735","8650735","0","2024-09"
"042510","라온시큐어","103305869940","1911","54058540","56025871","1967331","2024-09"
"232680","라온테크","88916917320","7290","12197108","12534234","337126","2024-09"
"418420","라온텍","97303044960","3240","30031804","30108433","76629","2024-09"
"300120","라온피플","98146356460","4705","20860012","20860012","0","2024-09"
"171120","라이온켐텍","93710083500","2655","35295700","35901760","606060","2024-09"
"388790","라이콤","85569116010","2870","29815023","29913930","98907","2024-09"
"347700","라이프시맨틱스","68177833485","3345","20382013","20382013","0","2024-09"
"214260","라파스","146132769000","17400","8398435","8912435","514000","2024-09"
"115390","락앤락","374666722800","8650","43314072","43326411","12339","2024-09"
"200350","래몽래인","141443753750","14150","9996025","9996025","0","2024-09"
"171010","램테크놀러지","53620320000","3750","14298752","14298752","0","2024-09"
"084650","랩지노믹스","256499165450","3455","74239990","74239990","0","2024-09"
"217500","러셀","49835527532","1718","29007874","31812000","2804126","2024-09"
"038390","레드캡투어","132010889690","15790","8360411","8589480","229069","2024-09"
"294140","레몬","106860900470","5090","20994283","21000000","5717","2024-09"
"443250","레뷰코퍼레이션","106356751200","9870","10775760","11279386","503626","2024-09"
"228670","레이","128455655660","8290","15495254","15495254","0","2024-09"
"228850","레이언스","110155080000","7000","15736440","16591014","854574","2024-09"
"412350","레이저쎌","46252951600","5300","8726972","8726972","0","2024-09"
"199550","레이저옵텍","74028141420","6340","11676363","11677947","1584","2024-09"
"281740","레이크머티리얼즈","976098073500","14850","65730510","65730548","38","2024-09"
"277810","레인보우로보틱스","2376482605000","122500","19399858","19399858","0","2024-09"
"215100","로보로보","82409298950","4070","20247985","20348454","100469","2024-09"
"090360","로보스타","213525000000","21900","9750000","9750000","0","2024-09"
"108490","로보티즈","231513086750","17950","12897665","13053665","156000","2024-09"
"067730","로지시스","25781002130","2665","9673922","9673922","0","2024-09"
"071280","로체시스템즈","280422097200","18800","14916069","15296603","380534","2024-09"
"032350","롯데관광개발","740626898760","9720","76196183","76196183","0","2024-09"
"089860","롯데렌탈","1046133014400","28800","36324063","36634063","310000","2024-09"
"000400","롯데손해보험","701679768100","2270","309110030","310336320","1226290","2024-09"
"023530","롯데쇼핑","1865862240000","66000","28270640","28288755","18115","2024-09"
"020150","롯데에너지머티리얼즈","1756822813500","38100","46110835","46110835","0","2024-09"
"280360","롯데웰푸드","1153785343500","130500","8841267","9434574","593307","2024-09"
"286940","롯데이노베이트","344949567600","22800","15129367","15129367","0","2024-09"
"004000","롯데정밀화학","1177987500000","46250","25470000","25800000","330000","2024-09"
"004990","롯데지주","1695786935000","23950","70805300","104909237","34103937","2024-09"
"005300","롯데칠성","1132023848000","122000","9278884","9278884","0","2024-09"
"011170","롯데케미칼","4022745823800","95400","42167147","42775419","608272","2024-09"
"071840","롯데하이마트","185085696000","8000","23135712","23607712","472000","2024-09"
"328130","루닛","1147707792000","39750","28873152","28873152","0","2024-09"
"038060","루멘스","58589538042","1218","48103069","48103069","0","2024-09"
"474170","루미르","140153866320","8170","17154696","17154696",,"자료 없음"
"141080","리가켐바이오","4704673602000","129000","36470338","36610338","140000","2024-09"
"058470","리노공업","2771707312000","182600","15179120","15242370","63250","2024-09"
"016100","리더스코스메틱","47673150200","2600","18335827","19100894","765067","2024-09"
"012700","리드코프","110185837860","4305","25594852","26446135","851283","2024-09"
"302550","리메드","101105664000","3300","30638080","30638080","0","2024-09"
"073570","리튬포어스","60610087725","1675","36185127","36189497","4370","2024-09"
"377450","리파인","208310418000","13700","15205140","17330000","2124860","2024-09"
"277070","린드먼아시아","47953868250","3785","12669450","13692000","1022550","2024-09"
"042500","링네트","73987844520","4595","16101816","19070134","2968318","2024-09"
"193250","링크드","26279201455","415","63323377","63323377","0","2024-09"
"219420","링크제니시스","49858573510","4430","11254757","11469507","214750","2024-09"
"439090","마녀공장","300377288400","18340","16378260","16378260","0","2024-09"
"027740","마니커","58865629086","927","63501218","63511228","10010","2024-09"
"195500","마니커에프앤지","47774220000","2990","15978000","15978000","0","2024-09"
"377480","마음AI","68382136160","10960","6239246","6239246","0","2024-09"
"305090","마이크로디지탈","190339603900","11510","16536890","16536890","0","2024-09"
"098120","마이크로컨텍솔","45304574700","5450","8312766","8312766","0","2024-09"
"424980","마이크로투나노","49245164800","8320","5918890","5918890","0","2024-09"
"038290","마크로젠","176928680610","17730","9979057","10841400","862343","2024-09"
"001080","만호제강","90163246000","30500","2956172","4150000","1193828","2024-09"
"267980","매일유업","277481807400","38450","7216692","7843638","626946","2024-09"
"005990","매일홀딩스","104955690000","8400","12494725","13718304","1223579","2024-09"
"093520","매커스","86366561600","8800","9814382","16163092","6348710","2024-09"
"377030","맥스트","42860231580","2190","19570882","19570882","0","2024-09"
"100590","머큐리","58096184410","3670","15830023","15830023","0","2024-09"
"067280","멀티캠퍼스","175136319450","29550","5926779","5926779","0","2024-09"
"072870","메가스터디","127986562440","11220","11407002","11920959","513957","2024-09"
"215200","메가스터디교육","464785646400","43200","10758927","11461955","703028","2024-09"
"133750","메가엠디","46467843425","2105","22074985","23407077","1332092","2024-09"
"446540","메가터치","84122550000","4050","20771000","20771000","0","2024-09"
"235980","메드팩토","179320911300","5340","33580695","33580695","0","2024-09"
"041920","메디아나","86396101750","4655","18559850","18598223","38373","2024-09"
"014100","메디앙스","24692057905","2185","11300713","11800000","499287","2024-09"
"054180","메디콕스","19957346292","339","58871228","58878283","7055","2024-09"
"086900","메디톡스","1158456041600","172100","6731296","7298497","567201","2024-09"
"078160","메디포스트","225733956700","6620","34098785","34217785","119000","2024-09"
"138040","메리츠금융지주","19000631856700","102700","185011021","190720114","5709093","2024-09"
"408920","메쎄이상","94684299600","2200","43038318","43232455","194137","2024-09"
"021880","메이슨캐피탈","47177166480","310","152184408","152184408","0","2024-09"
"140410","메지온","1072687464600","35800","29963337","29963337","0","2024-09"
"241770","메카로","75330697500","7650","9847150","10192640","345490","2024-09"
"090370","메타랩스","39643393368","1592","24901629","24904689","3060","2024-09"
"059210","메타바이오메드","95029453740","4155","22871108","23862351","991243","2024-09"
"118000","메타케어","56353121820","342","164775210","164777364","2154","2024-09"
"058110","멕아이씨에스","39441213850","2545","15497530","16050530","553000","2024-09"
"017180","명문제약","76550877990","2290","33428331","33953454","525123","2024-09"
"009900","명신산업","713069107470","13590","52470133","52470133","0","2024-09"
"012690","모나리자","143135434125","3915","36560775","36571255","10480","2024-09"
"005360","모나미","42046508075","2225","18897307","18897307","0","2024-09"
"070960","모나용평","178337900910","3770","47304483","48133333","828850","2024-09"
"434480","모니터랩","45880770000","3900","11764300","12253300","489000","2024-09"
"080420","모다이노칩","149796927738","1879","79721622","79721622","0","2024-09"
"417970","모델솔루션","60320881000","9430","6396700","6396700","0","2024-09"
"080160","모두투어","172776644220","9980","17312289","18900000","1587711","2024-09"
"087260","모바일어플라이언스","68035479490","2090","32552861","32552861","0","2024-09"
"101330","모베이스","74070492800","3200","23147029","23147029","0","2024-09"
"012860","모베이스전자","129734057040","1785","72680144","73233457","553313","2024-09"
"363260","모비데이즈","73605572800","2320","31726540","32163769","437229","2024-09"
"348030","모비릭스","50804102000","5290","9603800","9603800","0","2024-09"
"250060","모비스","99328299700","3100","32041387","32171314","129927","2024-09"
"288980","모아데이타","56016187002","1621","34556562","34556562","0","2024-09"
"142760","모아라이프플러스","52413652479","1389","37734811","37734811","0","2024-09"
"033200","모아텍","30052787185","3265","9204529","14331185","5126656","2024-09"
"333050","모코엠시스","29076055360","1265","22985024","24444326","1459302","2024-09"
"009680","모토닉","187511500080","8670","21627624","33000000","11372376","2024-09"
"118990","모트렉스","249933821760","10080","24795022","24861990","66968","2024-09"
"006920","모헨즈","28064400000","2570","10920000","10920000","0","2024-09"
"009580","무림P&P","171500389500","2750","62363778","62368324","4546","2024-09"
"001810","무림SP","39183375000","1770","22137500","22137500","0","2024-09"
"009200","무림페이퍼","86963457900","2090","41609310","41609310","0","2024-09"
"033920","무학","152829228360","5770","26486868","28500000","2013132","2024-09"
"008420","문배철강","44904651225","2345","19149105","20503505","1354400","2024-09"
"279600","미디어젠","52938025300","11300","4684781","4684781","0","2024-09"
"095500","미래나노텍","289965754260","10220","28372383","31009999","2637616","2024-09"
"254490","미래반도체","222778340000","15430","14438000","14438000","0","2024-09"
"025560","미래산업","40645092825","1305","31145665","31166865","21200","2024-09"
"218150","미래생명자원","86560326360","4440","19495569","20415802","920233","2024-09"
"007120","미래아이앤지","31585519784","1156","27323114","28878608","1555494","2024-09"
"442900","미래에셋드림스팩1호","76723200000","9990","7680000","7680000","0","2024-09"
"100790","미래에셋벤처투자","248604305040","4680","53120578","53124634","4056","2024-09"
"412930","미래에셋비전스팩1호","18713280000","3030","6176000","6176000","0","2024-09"
"446190","미래에셋비전스팩2호","10939500000","2210","4950000","4950000","0","2024-09"
"448830","미래에셋비전스팩3호","10578000000","2150","4920000","4920000","0","2024-09"
"477380","미래에셋비전스팩4호","16362000000","2020","8100000","8100000","0","2024-09"
"477470","미래에셋비전스팩5호","11261400000","2055","5480000","5480000","0","2024-09"
"478440","미래에셋비전스팩6호","13998600000","2020","6930000","6930000","0","2024-09"
"482680","미래에셋비전스팩7호","16290345000","1983","8215000","8215000","0","2024-09"
"085620","미래에셋생명","687629600000","5270","130480000","177016189","46536189","2024-09"
"006800","미래에셋증권","4069320028260","9060","449152321","595316408","146164087","2024-09"
"049950","미래컴퍼니","145453642150","18350","7926629","8817884","891255","2024-09"
"207760","미스터블루","112865689550","1370","82383715","83079783","696068","2024-09"
"002840","미원상사","935805292500","201500","4644195","4750000","105805","2024-09"
"268280","미원에스씨","692913167100","141900","4883109","5000000","116891","2024-09"
"107590","미원홀딩스","185236000000","80000","2315450","2320000","4550","2024-09"
"134380","미원화학","160003105800","79900","2002542","2199268","196726","2024-09"
"003650","미창석유","147212856700","97300","1512979","1739672","226693","2024-09"
"059090","미코","302362531200","9600","31496097","33416778","1920681","2024-09"
"214610","미코바이오메드","69564654051","1597","43559583","43568945","9362","2024-09"
"201490","미투온","65489782280","2140","30602702","31257770","655068","2024-09"
"452200","민테크","134963595000","6150","21945300","21945300","0","2024-09"
"418470","밀리의서재","118310102880","13920","8499289","8499289","0","2024-09"
"206640","바디텍메드","344370125320","15670","21976396","23486560","1510164","2024-09"
"018700","바른손","38455593456","1117","34427568","35119757","692189","2024-09"
"035620","바른손이앤에이","34905598570","470","74267231","74439675","172444","2024-09"
"053030","바이넥스","646507822800","20300","31847676","32684188","836512","2024-09"
"301300","바이브컴퍼니","52582381250","4250","12372325","12394861","22536","2024-09"
"377740","바이오노트","478039162000","4700","101710460","102056048","345588","2024-09"
"064550","바이오니아","615575440350","23850","25810291","25810291","0","2024-09"
"314930","바이오다인","608695094000","20650","29476760","29764103","287343","2024-09"
"208710","바이오로그디바이스","29128093488","442","65900664","65900664","0","2024-09"
"086820","바이오솔루션","136481742180","17010","8023618","8143426","119808","2024-09"
"038460","바이오스마트","92883941850","3675","25274542","26164438","889896","2024-09"
"251120","바이오에프디엔씨","143030474730","16770","8528949","8695700","166751","2024-09"
"199730","바이오인프라","38720361320","7960","4864367","4864367","0","2024-09"
"086040","바이오톡스텍","67442184810","4290","15720789","15958247","237458","2024-09"
"099430","바이오플러스","300089537410","5330","56301977","57930864","1628887","2024-09"
"032980","바이온","27755546200","620","44767010","44777990","10980","2024-09"
"308080","바이젠셀","58658088300","3045","19263740","19263740","0","2024-09"
"043150","바텍","337934324000","22750","14854256","14854256","0","2024-09"
"323990","박셀바이오","296242630500","12900","22964545","22993200","28655","2024-09"
"003610","방림","113792381935","3215","35394209","42314090","6919881","2024-09"
"267790","배럴","35656020000","4520","7888500","7888500","0","2024-09"
"001340","백광산업","421623971850","9550","44149107","44918407","769300","2024-09"
"046310","백금T&A","38355672555","2385","16082043","16418641","336598","2024-09"
"035150","백산","282080000000","13120","21500000","21500000","0","2024-09"
"331520","밸로프","33555989376","684","49058464","50864390","1805926","2024-09"
"199480","뱅크웨어글로벌","69701302200","6900","10101638","10101638","0","2024-09"
"438700","버넥트","39118563900","3510","11144890","11144890","0","2024-09"
"066410","버킷스튜디오","97025536877","1153","84150509","84151767","1258","2024-09"
"002410","범양건영","25078251520","1010","24829952","24831982","2030","2024-09"
"382900","범한퓨얼셀","122472275000","14270","8582500","8761000","178500","2024-09"
"206400","베노티앤알","124490611200","3840","32419430","32420452","1022","2024-09"
"019010","베뉴지","88239000000","2195","40200000","48200000","8000000","2024-09"
"177350","베셀","22122383928","248","89203161","89372043","168882","2024-09"
"424760","벨로크","19820255112","1022","19393596","19665002","271406","2024-09"
"007210","벽산","111683860575","1995","55981885","67560000","11578115","2024-09"
"225530","보광산업","141538656145","3895","36338551","36338727","176","2024-09"
"250000","보라티알","64182218800","9800","6549206","6750733","201527","2024-09"
"002760","보락","76073000000","1270","59900000","59900000","0","2024-09"
"003850","보령","733085352300","11130","65865710","68690000","2824290","2024-09"
"310210","보로노이","1985622924600","110600","17953191","18356592","403401","2024-09"
"006910","보성파워텍","148746664960","3040","48929824","49129824","200000","2024-09"
"000890","보해양조","58828975416","423","139075592","139120129","44537","2024-09"
"226340","본느","71235141240","1698","41952380","41952420","40","2024-09"
"003000","부광약품","333031974415","4865","68454671","68454671","0","2024-09"
"001270","부국증권","165998459900","27950","5939122","10369886","4430764","2024-09"
"026940","부국철강","49800000000","2490","20000000","20000000","0","2024-09"
"014470","부방","94238340636","1756","53666481","60052260","6385779","2024-09"
"011390","부산산업","59136000000","56000","1056000","1056000","0","2024-09"
"005030","부산주공","38288532168","486","78782988","78782988","0","2024-09"
"008470","부스타","31519062900","3900","8081811","8404800","322989","2024-09"
"338220","뷰노","407619168950","29350","13888217","13888217","0","2024-09"
"100120","뷰웍스","219906768450","23950","9181911","10001865","819954","2024-09"
"406820","뷰티스킨","49405879200","13980","3534040","3534040","0","2024-09"
"337930","브랜드엑스코퍼레이션","244751417450","8350","29311547","29311547","0","2024-09"
"099390","브레인즈컴퍼니","54455121890","6890","7903501","8208283","304782","2024-09"
"064480","브리지텍","59574933560","5140","11590454","11952500","362046","2024-09"
"288330","브릿지바이오테라퓨틱스","214038747000","4500","47564166","47564166","0","2024-09"
"365900","브이씨","24123990000","3300","7310300","7310300","0","2024-09"
"089970","브이엠","186375356640","8460","22030184","24075595","2045411","2024-09"
"251630","브이원텍","62500531275","4095","15262645","15942886","680241","2024-09"
"018290","브이티","1206745918000","34000","35492527","35798007","305480","2024-09"
"439580","블루엠텍","211005474690","18890","11170221","11170221","0","2024-09"
"033560","블루콤","56571293805","3315","17065247","17100000","34753","2024-09"
"369370","블리츠웨이스튜디오","78606565950","1650","47640343","49871911","2231568","2024-09"
"126340","비나텍","212229563300","35900","5911687","6085118","173431","2024-09"
"121800","비덴트","256296018720","3320","77197596","77201611","4015","2024-09"
"082800","비보존 제약","295085190240","6210","47517744","48242965","725221","2024-09"
"318410","비비씨","45330782880","8160","5555243","5555243","0","2024-09"
"002070","비비안","23954367960","804","29793990","29793990","0","2024-09"
"100220","비상교육","66158181000","5400","12251515","12996741","745226","2024-09"
"419540","비스토스","41980570830","1826","22990455","22992511","2056","2024-09"
"146320","비씨엔씨","162756361280","12820","12695504","12792923","97419","2024-09"
"200780","비씨월드제약","40800461775","4835","8438565","8892384","453819","2024-09"
"413640","비아이매트릭스","54556535800","7570","7206940","7206940","0","2024-09"
"141000","비아트론","75237005580","6820","11031819","12114710","1082891","2024-09"
"090460","비에이치","525024390030","16730","31382211","34464379","3082168","2024-09"
"083650","비에이치아이","350574378220","11330","30942134","30944375","2241","2024-09"
"445360","비엔케이제1호스팩","9051000000","2100","4310000","4310000","0","2024-09"
"473370","비엔케이제2호스팩","8567350000","2035","4210000","4210000","0","2024-09"
"065170","비엘팜텍","20195906704","227","88968752","88970559","1807","2024-09"
"086670","비엠티","79571517280","8720","9125174","9125174","0","2024-09"
"335890","비올","484463266600","8390","57742940","58419125","676185","2024-09"
"230980","비유테크놀러지","21370405721","229","93320549","93320557","8","2024-09"
"138580","비즈니스온","356042480800","15850","22463248","22556163","92915","2024-09"
"082920","비츠로셀","420712639920","18780","22402164","22872213","470049","2024-09"
"054220","비츠로시스","21827305956","444","49160599","49160599","0","2024-09"
"042370","비츠로테크","179994171750","6870","26200025","26200025","0","2024-09"
"050090","비케이홀딩스","15800807510","802","19701755","19784735","82980","2024-09"
"148780","비큐AI","32672108275","1039","31445725","31445725","0","2024-09"
"307870","비투엔","44437219299","981","45297879","45297879","0","2024-09"
"357880","비트나인","22611164740","2165","10443956","10443956","0","2024-09"
"032850","비트컴퓨터","79473848080","4930","16120456","16623293","502837","2024-09"
"238200","비피도","30266000000","3700","8180000","8180000","0","2024-09"
"093190","빅솔론","65242786065","4335","15050239","19238905","4188666","2024-09"
"065450","빅텍","143120736000","4995","28652800","28652800","0","2024-09"
"210120","빅텐츠","76256792500","24250","3144610","3144610","0","2024-09"
"044480","빌리언스","23218988688","571","40663728","40663728","0","2024-09"
"005180","빙그레","559686003300","63300","8841801","9851241","1009440","2024-09"
"069540","빛과전자","56839639480","1339","42449320","42449320","0","2024-09"
"072950","빛샘전자","31561858560","3940","8010624","8052610","41986","2024-09"
"451250","삐아","96064302270","9710","9893337","10089877","196540","2024-09"
"143240","사람인","173700192000","16000","10856262","11709263","853001","2024-09"
"003960","사조대림","366167714850","43850","8350461","9164467","814006","2024-09"
"008040","사조동아원","147006880342","1043","140946194","141144600","198406","2024-09"
"007160","사조산업","336528200000","67400","4993000","5000000","7000","2024-09"
"014710","사조씨푸드","120185430140","6980","17218543","17218543","0","2024-09"
"006090","사조오양","81977803200","8700","9422736","9422739","3","2024-09"
"452430","사피엔반도체","93906222400","11600","8095364","8096454","1090","2024-09"
"419120","산돌","45215234580","6180","7316381","7774326","457945","2024-09"
"062040","산일전기","1280704441050","42150","30384447","30445200","60753","2024-09"
"122350","삼기","54550773216","1437","37961568","38339428","377860","2024-09"
"419050","삼기이브이","117538273200","2055","57196240","57196240","0","2024-09"
"014970","삼륭물산","59026637800","3965","14886920","15125000","238080","2024-09"
"018310","삼목에스폼","307270843200","21600","14225502","14700000","474498","2024-09"
"053700","삼보모터스","95139931680","4280","22228956","22877190","648234","2024-09"
"009620","삼보산업","19921824990","270","73784537","73785902","1365","2024-09"
"023600","삼보판지","142489404180","9090","15675402","16170000","494598","2024-09"
"001470","삼부토건","116278148480","520","223611824","223611824","0","2024-09"
"028050","삼성E&A","3500560000000","17860","196000000","196000000","0","2024-09"
"006400","삼성SDI","21396636453000","327000","65433139","68764530","3331391","2024-09"
"006660","삼성공조","81437535760","10360","7860766","8126314","265548","2024-09"
"028260","삼성물산","18973606977000","117000","162167581","177784107","15616526","2024-09"
"207940","삼성바이오로직스","71316348000000","1002000","71174000","71174000","0","2024-09"
"032830","삼성생명","18226840068500","101500","179574779","200000000","20425221","2024-09"
"425290","삼성스팩6호","11702400000","2120","5520000","5520000","0","2024-09"
"439250","삼성스팩7호","36350760000","10380","3502000","3502000","0","2024-09"
"448740","삼성스팩8호","46966480000","10070","4664000","4664000","0","2024-09"
"468510","삼성스팩9호","22321000000","2020","11050000","11050000","0","2024-09"
"018260","삼성에스디에스","11068811616600","143100","77350186","77377800","27614","2024-09"
"009150","삼성전기","8606933606400","118400","72693696","74693696","2000000","2024-09"
"005930","삼성전자","353411126960000","59200","5969782550","5969782550","0","2024-09"
"001360","삼성제약","147486503832","1567","94120296","94162079","41783","2024-09"
"010140","삼성중공업","8190201125890","9590","854035571","880000000","25964429","2024-09"
"016360","삼성증권","4098870000000","45900","89300000","89300000","0","2024-09"
"068290","삼성출판사","141100000000","14110","10000000","10000000","0","2024-09"
"029780","삼성카드","4311112078000","40400","106710695","115858891","9148196","2024-09"
"000810","삼성화재","13402221604000","336500","39828296","47374837","7546541","2024-09"
"006110","삼아알미늄","750307716000","51000","14711916","14711916","0","2024-09"
"009300","삼아제약","133663189800","21900","6103342","6370000","266658","2024-09"
"145990","삼양사","479934277500","49650","9666350","10313449","647099","2024-09"
"003230","삼양식품","3878226560000","520000","7458128","7533015","74887","2024-09"
"002170","삼양통상","131164000000","48400","2710000","3000000","290000","2024-09"
"272550","삼양패키징","254190395690","16390","15508871","15788671","279800","2024-09"
"000070","삼양홀딩스","528667249500","71100","7435545","8564271","1128726","2024-09"
"003720","삼영","145258079100","4380","33163945","34000000","836055","2024-09"
"002810","삼영무역","224582044960","12740","17628104","18466948","838844","2024-09"
"361670","삼영에스앤씨","34863487500","6250","5578158","5667658","89500","2024-09"
"054540","삼영엠텍","48701950000","4015","12130000","13000000","870000","2024-09"
"065570","삼영이엔씨","32565870395","2045","15924631","15924631","0","2024-09"
"005680","삼영전자","195775932800","9800","19977136","20000000","22864","2024-09"
"023000","삼원강재","102926486040","2590","39739956","40000000","260044","2024-09"
"004380","삼익THK","185265000000","8950","20700000","21000000","300000","2024-09"
"002450","삼익악기","82873697350","1090","76030915","90530915","14500000","2024-09"
"032280","삼일","23235058560","1498","15510720","16213590","702870","2024-09"
"002290","삼일기업공사","35526000000","2865","12400000","12400000","0","2024-09"
"004440","삼일씨엔에스","54874691570","4310","12731947","12731947","0","2024-09"
"000520","삼일제약","338543072000","16000","21158942","21621100","462158","2024-09"
"009770","삼정펄프","67124221350","26850","2499971","2499971","0","2024-09"
"037460","삼지전자","134329230000","8750","15351912","16318522","966610","2024-09"
"032750","삼진","38536997660","4270","9025058","9031122","6064","2024-09"
"054090","삼진엘앤디","21614240456","872","24786973","24959232","172259","2024-09"
"005500","삼진제약","231004887200","18440","12527380","13900000","1372620","2024-09"
"000250","삼천당제약","3146735961600","135300","23257472","23457472","200000","2024-09"
"004690","삼천리","309189457500","90300","3424025","4055025","631000","2024-09"
"024950","삼천리자전거","48592212020","4015","12102668","13273577","1170909","2024-09"
"038500","삼표시멘트","330648940160","3080","107353552","107916306","562754","2024-09"
"437730","삼현","82968133650","7850","10569189","10569189","0","2024-09"
"017480","삼현철강","71268937350","4615","15442890","15702890","260000","2024-09"
"010960","삼호개발","70210400000","3140","22360000","25000000","2640000","2024-09"
"046390","삼화네트웍스","60294634878","1523","39589386","43172933","3583547","2024-09"
"004450","삼화왕관","55843673050","30950","1804319","2154379","350060","2024-09"
"009470","삼화전기","243388576000","36800","6613820","6613820","0","2024-09"
"011230","삼화전자","49012633200","2900","16900908","16902700","1792","2024-09"
"001820","삼화콘덴서","339126050000","33050","10261000","10395000","134000","2024-09"
"000390","삼화페인트","174099144600","7380","23590670","27203469","3612799","2024-09"
"027580","상보","68894333189","1223","56332243","59181279","2849036","2024-09"
"038540","상상인","91717886576","1676","54724276","55328313","604037","2024-09"
"415580","상상인제3호스팩","11151000000","2100","5310000","5310000","0","2024-09"
"452670","상상인제4호스팩","10492200000","2010","5220000","5220000","0","2024-09"
"001290","상상인증권","47393673086","446","106263841","108337120","2073279","2024-09"
"041650","상신브레이크","66018657100","3410","19360310","21471450","2111140","2024-09"
"091580","상신이디피","134215165330","10070","13328219","13428219","100000","2024-09"
"263810","상신전자","46141121880","3240","14241087","14244718","3631","2024-09"
"089980","상아프론테크","321165185800","20600","15590543","15989037","398494","2024-09"
"042940","상지건설","23914066460","6010","3979046","3981814","2768","2024-09"
"042600","새로닉스","166349338400","13600","12231569","12423574","192005","2024-09"
"075180","새론오토모티브","74688000000","3890","19200000","19200000","0","2024-09"
"107600","새빗켐","113330148750","22750","4981545","4981545","0","2024-09"
"411080","샌즈랩","106059571020","7290","14548638","15248638","700000","2024-09"
"252990","샘씨엔에스","324979081800","5700","57013874","58388063","1374189","2024-09"
"007540","샘표","89486779200","44400","2015468","2875800","860332","2024-09"
"248170","샘표식품","133801262800","29300","4566596","4568286","1690","2024-09"
"378800","샤페론","132780051555","4405","30143031","30143031","0","2024-09"
"294630","서남","85486771335","3565","23979459","23979459","0","2024-09"
"038070","서린바이오","61051522620","7230","8444194","8900676","456482","2024-09"
"006730","서부T&D","398577567360","6180","64494752","66426923","1932171","2024-09"
"079650","서산","24280000000","1214","20000000","20000000","0","2024-09"
"100660","서암기계공업","48636000000","3860","12600000","12600000","0","2024-09"
"007860","서연","157377823500","7250","21707286","23479844","1772558","2024-09"
"200880","서연이화","370211688700","13700","27022751","27028437","5686","2024-09"
"019770","서연탑메탈","44503000000","3820","11650000","11650000","0","2024-09"
"017390","서울가스","204623138400","52700","3882792","5000000","1117208","2024-09"
"043710","서울리거","33181104723","661","50198343","50198880","537","2024-09"
"092190","서울바이오시스","187469865185","4145","45227953","45868383","640430","2024-09"
"046890","서울반도체","529984596000","9400","56381340","58305400","1924060","2024-09"
"004410","서울식품","58836599213","157","374755409","374755559","150","2024-09"
"063170","서울옥션","132844072020","7890","16837018","17774267","937249","2024-09"
"027040","서울전자통신","18649629024","268","69588168","69588847","679","2024-09"
"018680","서울제약","45879420265","3935","11659319","11659319","0","2024-09"
"021050","서원","58821017010","1239","47474590","47474590","0","2024-09"
"093920","서원인텍","108438000000","5830","18600000","18600000","0","2024-09"
"189860","서전기전","47233058600","4870","9698780","9698780","0","2024-09"
"178320","서진시스템","1611503882100","28650","56247954","56247954","0","2024-09"
"122690","서진오토모티브","49739862560","2290","21720464","21844410","123946","2024-09"
"140070","서플러스글로벌","121267428480","3520","34450974","36988000","2537026","2024-09"
"011370","서한","78064917675","795","98194865","100894865","2700000","2024-09"
"065710","서호전기","106747100300","21650","4930582","5150000","219418","2024-09"
"008490","서흥","175904367660","15820","11119113","11569113","450000","2024-09"
"035890","서희건설","273338247280","1414","193308520","229808457","36499937","2024-09"
"357550","석경에이티","245298900000","45100","5439000","5455000","16000","2024-09"
"003100","선광","98878800000","15720","6290000","6600000","310000","2024-09"
"007610","선도전기","50907057000","3000","16969019","18000000","1030981","2024-09"
"067370","선바이오","79615504510","6470","12305333","12313555","8222","2024-09"
"171090","선익시스템","378233323200","43200","8755401","9494405","739004","2024-09"
"136490","선진","157180564880","6610","23779208","23779604","396","2024-09"
"086710","선진뷰티사이언스","132713373000","11050","12010260","12203280","193020","2024-09"
"014620","성광벤드","344836355920","12880","26773009","28600000","1826991","2024-09"
"037350","성도이엔지","65546845000","4615","14203000","15470000","1267000","2024-09"
"014910","성문전자","25967328507","1251","20757257","22460985","1703728","2024-09"
"003080","성보화학","51516495230","2630","19588021","20020000","431979","2024-09"
"004980","성신양회","194126530850","8050","24115097","24516073","400976","2024-09"
"011300","성안머티리얼스","36440108380","445","81887884","81887884","0","2024-09"
"458650","성우","421278760000","28000","15045670","15045670",,"자료 없음"
"081580","성우전자","67660910550","4450","15204699","15508143","303444","2024-09"
"045300","성우테크론","26528569400","2710","9789140","10151583","362443","2024-09"
"015750","성우하이텍","503947035900","6300","79991593","80000000","8407","2024-09"
"365340","성일하이텍","666340350300","54900","12137347","12137347","0","2024-09"
"000180","성창기업지주","96675717600","1386","69751600","69751600","0","2024-09"
"080470","성창오토텍","31426500000","4305","7300000","7300000","0","2024-09"
"043260","성호전자","92784329469","1521","61002189","61002189","0","2024-09"
"148150","세경하이테크","256999854540","7260","35399429","35860429","461000","2024-09"
"002420","세기상사","32630437760","5870","5558848","5558848","0","2024-09"
"188260","세니젠","19804259790","2790","7098301","7228470","130169","2024-09"
"053060","세동","20693865704","1172","17656882","17657419","537","2024-09"
"340440","세림B&G","40126999626","1414","28378359","28378364","5","2024-09"
"017510","세명전기","77602140000","5090","15246000","15246000","0","2024-09"
"004360","세방","214709768280","11970","17937324","19308690","1371366","2024-09"
"004490","세방전지","931337042400","70800","13154478","14000000","845522","2024-09"
"011560","세보엠이씨","100663863300","10150","9917622","10530000","612378","2024-09"
"396300","세아메카닉스","75949550000","2900","26189500","26489500","300000","2024-09"
"001430","세아베스틸지주","711504440960","19840","35862119","35862119","0","2024-09"
"306200","세아제강","318651380000","113800","2800100","2836300","36200","2024-09"
"003030","세아제강지주","689302646600","170600","4040461","4141657","101196","2024-09"
"019440","세아특수강","114575051370","13730","8344869","8570000","225131","2024-09"
"058650","세아홀딩스","393846069900","101100","3895609","4000000","104391","2024-09"
"013000","세우글로벌","35333369611","1231","28702981","28705031","2050","2024-09"
"100700","세운메디칼","117751792000","2720","43291100","43800000","508900","2024-09"
"024830","세원물산","50601000000","6060","8350000","8350000","0","2024-09"
"091090","세원이앤씨","54828158060","1270","43171778","43180255","8477","2024-09"
"021820","세원정공","68000000000","6800","10000000","10000000","0","2024-09"
"067830","세이브존I&C","81088868950","2150","37715753","41040895","3325142","2024-09"
"258830","세종메디칼","22974088612","412","55762351","55786351","24000","2024-09"
"036630","세종텔레콤","94782936236","499","189945764","200000000","10054236","2024-09"
"039310","세중","31096780572","1716","18121667","18121667","0","2024-09"
"075580","세진중공업","384870817120","6770","56849456","56849456","0","2024-09"
"067770","세진티에스","20490351830","2470","8295689","8396593","100904","2024-09"
"053450","세코닉스","80016784590","5470","14628297","14792803","164506","2024-09"
"222810","세토피아","81189010800","1080","75175010","75659350","484340","2024-09"
"252500","세화피앤씨","37628155730","907","41486390","41486390","0","2024-09"
"321370","센서뷰","56770770475","2155","26343745","26343745","0","2024-09"
"347000","센코","79762398450","2450","32556081","33004976","448895","2024-09"
"331920","셀레믹스","32085101640","3930","8164148","8164148","0","2024-09"
"049180","셀루메드","134948072760","2620","51506898","51515906","9008","2024-09"
"299660","셀리드","94224792305","4465","21102977","21102977","0","2024-09"
"268600","셀리버리","248384003120","6680","37183234","37183234","0","2024-09"
"108860","셀바스AI","291481609080","10830","26914276","26914790","514","2024-09"
"208370","셀바스헬스케어","106599364955","4145","25717579","25740564","22985","2024-09"
"318160","셀바이오휴먼텍","32560128650","3710","8776315","9260901","484586","2024-09"
"308430","셀비온","192608895810","15090","12764009","12764009","0","2024-09"
"068270","셀트리온","37612319797500","182500","206094903","217021190","10926287","2024-09"
"068760","셀트리온제약","2578635688300","62300","41390621","41600387","209766","2024-09"
"068940","셀피글로벌","29334496224","778","37705008","38260597","555589","2024-09"
"060230","소니드","43705294230","955","45764706","46066730","302024","2024-09"
"290690","소룩스","403658126880","8860","45559608","45564340","4732","2024-09"
"032680","소프트센","42128880832","404","104279408","105590764","1311356","2024-09"
"258790","소프트캠프","21796594668","909","23978652","24991284","1012632","2024-09"
"066910","손오공","51772706083","1537","33684259","33784259","100000","2024-09"
"336370","솔루스첨단소재","881866462880","12560","70212298","70217344","5046","2024-09"
"248070","솔루엠","933023376720","19170","48671016","50005551","1334535","2024-09"
"035610","솔본","101127763300","3940","25666945","27345997","1679052","2024-09"
"357780","솔브레인","1579600968000","204000","7743142","7778566","35424","2024-09"
"036830","솔브레인홀딩스","1015517295950","49150","20661593","20964056","302463","2024-09"
"304100","솔트룩스","202823096960","16720","12130568","12130568","0","2024-09"
"328380","솔트웨어","34600770890","1010","34258189","34262778","4589","2024-09"
"004430","송원산업","327600000000","13650","24000000","24000000","0","2024-09"
"086980","쇼박스","272229680000","4360","62438000","62638000","200000","2024-09"
"050960","수산아이앤티","67780040000","10040","6751000","6751000","0","2024-09"
"126720","수산인더스트리","315261520000","22400","14074175","14286000","211825","2024-09"
"017550","수산중공업","108574486200","1740","62399130","62399130","0","2024-09"
"084180","수성웹툰","69425049543","591","117470473","117470473","0","2024-09"
"253840","수젠텍","96019115040","6280","15289668","16743200","1453532","2024-09"
"298830","슈어소프트테크","245569928180","4705","52193396","52619061","425665","2024-09"
"236200","슈프리마","176280845300","25550","6899446","7193273","293827","2024-09"
"094840","슈프리마에이치큐","52724839680","5760","9153618","10471840","1318222","2024-09"
"192440","슈피겐코리아","123008572800","20400","6029832","6216363","186531","2024-09"
"424960","스마트레이더시스템","167417884800","10720","15617340","15617340","0","2024-09"
"099440","스맥","112042903460","3005","37285492","40243394","2957902","2024-09"
"053210","스카이라이프","237414534640","5020","47293732","47522955","229223","2024-09"
"276040","스코넥","39358275990","3135","12554474","12554474","0","2024-09"
"159910","스킨앤스킨","26409582300","730","36177510","36410098","232588","2024-09"
"060240","스타코링크","16508006518","523","31564066","32314179","750113","2024-09"
"115570","스타플렉스","23788404270","3015","7890018","7984508","94490","2024-09"
"330730","스톤브릿지벤처스","68694278240","3940","17435096","18150830","715734","2024-09"
"352090","스톰테크","89487083340","3330","26872998","26872998","0","2024-09"
"253450","스튜디오드래곤","1226386718400","40800","30058498","30058498","0","2024-09"
"408900","스튜디오미르","152246667405","4655","32706051","32706134","83","2024-09"
"204630","스튜디오산타클로스","23613109200","4650","5078088","5089941","11853","2024-09"
"415380","스튜디오삼익","33410151200","8240","4054630","4225498","170868","2024-09"
"026890","스틱인베스트먼트","295312607200","8080","36548590","41678175","5129585","2024-09"
"013810","스페코","66096169700","4510","14655470","14655470","0","2024-09"
"203690","스피어파워","63480561620","4820","13170241","13337850","167609","2024-09"
"049830","승일","42770488240","7240","5907526","6132112","224586","2024-09"
"020710","시공테크","65455529550","3470","18863265","20047970","1184705","2024-09"
"033170","시그네틱스","84613850853","987","85728319","85728319","0","2024-09"
"048870","시너지이노베이션","229515654600","2775","82708344","82708344","0","2024-09"
"025320","시노펙스","602672619640","7220","83472662","83817936","345274","2024-09"
"134790","시디즈","49697156800","29600","1678958","2000000","321042","2024-09"
"269620","시스웍","131663951937","889","148103433","148582691","479258","2024-09"
"429270","시지트로닉스","29470875000","6540","4506250","4506250","0","2024-09"
"418250","시큐레터","52279100100","6550","7981542","7981542","0","2024-09"
"131090","시큐브","34366735950","885","38832470","44000000","5167530","2024-09"
"232830","시큐센","23414944000","2000","11707472","11707472","0","2024-09"
"462870","시프트업","3774256384000","64700","58334720","58334720","0","2024-09"
"016590","신대양제지","180352730040","5880","30672233","40297820","9625587","2024-09"
"290520","신도기연","33124625220","2105","15736164","15929362","193198","2024-09"
"029530","신도리코","354396216900","41100","8622779","10080029","1457250","2024-09"
"004970","신라교역","149483950000","9470","15785000","16000000","215000","2024-09"
"001000","신라섬유","25151531440","1036","24277540","24277540","0","2024-09"
"025870","신라에스지","24800000000","6200","4000000","4000000","0","2024-09"
"215600","신라젠","360391828125","2625","137292125","137367125","75000","2024-09"
"065350","신성델타테크","1216481673000","44750","27183948","27483948","300000","2024-09"
"416180","신성에스티","228747565900","25550","8952938","9039778","86840","2024-09"
"011930","신성이엔지","296799226542","1458","203565999","205848151","2282152","2024-09"
"005390","신성통상","316158458000","2200","143708390","143708390","0","2024-09"
"004170","신세계","1419020166200","153800","9226399","9845181","618782","2024-09"
"035510","신세계 I&C","132246848600","10060","13145810","17200000","4054190","2024-09"
"034300","신세계건설","137514890640","18120","7589122","7760554","171432","2024-09"
"031430","신세계인터내셔날","453639900000","13100","34629000","35700000","1071000","2024-09"
"031440","신세계푸드","133594039500","34500","3872291","3872480","189","2024-09"
"006880","신송홀딩스","90309797370","8370","10789701","11828858","1039157","2024-09"
"162300","신스틸","102548880000","2500","41019552","41471382","451830","2024-09"
"290560","신시웨이","24453988540","6310","3875434","3877972","2538","2024-09"
"002800","신신제약","86926965000","5730","15170500","15170500","0","2024-09"
"472220","신영스팩10호","10060050000","2145","4690000","4690000","0","2024-09"
"430220","신영스팩8호","14601600000","2160","6760000","6760000","0","2024-09"
"445970","신영스팩9호","11738400000","2190","5360000","5360000","0","2024-09"
"005800","신영와코루","81810000000","9090","9000000","9000000","0","2024-09"
"001720","신영증권","631626976000","82000","7702768","16440000","8737232","2024-09"
"009270","신원","92764712016","1236","75052356","102586356","27534000","2024-09"
"017000","신원종합개발","36945196200","3300","11195514","11668027","472513","2024-09"
"002700","신일전자","100236146728","1426","70291828","71047521","755693","2024-09"
"012790","신일제약","83228839200","7200","11559561","11986415","426854","2024-09"
"138070","신진에스엠","41395236720","2460","16827332","17503204","675872","2024-09"
"226330","신테카바이오","71409663000","4680","15258475","15258475","0","2024-09"
"002870","신풍","25268218560","912","27706380","34958700","7252320","2024-09"
"019170","신풍제약","603570105250","12250","49271029","52984990","3713961","2024-09"
"418210","신한제10호스팩","8216700000","2245","3660000","3660000","0","2024-09"
"452980","신한제11호스팩","36978180000","1956","18905000","18905000","0","2024-09"
"474660","신한제12호스팩","11785200000","2135","5520000","5520000","0","2024-09"
"474930","신한제13호스팩","7873500000","2175","3620000","3620000","0","2024-09"
"055550","신한지주","25826745121200","51300","503445324","509393214","5947890","2024-09"
"056700","신화인터텍","48825666153","1683","29011091","29135091","124000","2024-09"
"187270","신화콘텍","30769293585","3345","9198593","10143845","945252","2024-09"
"004080","신흥","135129401550","14310","9443005","9500000","56995","2024-09"
"243840","신흥에스이씨","290482814550","7530","38576735","38919035","342300","2024-09"
"257720","실리콘투","2325357538800","38200","60873234","60873234","0","2024-09"
"222800","심텍","528004640660","16580","31845877","31854143","8266","2024-09"
"036710","심텍홀딩스","67929587540","1466","46336690","48350145","2013455","2024-09"
"160980","싸이맥스","113037933680","11060","10220428","10924243","703815","2024-09"
"356890","싸이버원","34672417200","2910","11914920","11916325","1405","2024-09"
"217330","싸이토젠","183864289590","7970","23069547","23129547","60000","2024-09"
"102280","쌍방울","70634046631","269","262580099","262592129","12030","2024-09"
"010280","쌍용정보통신","39399883270","605","65123774","65123786","12","2024-09"
"004770","써니전자","57920475046","1594","36336559","36702884","366325","2024-09"
"208640","썸에이지","40101193152","288","139240254","139240254","0","2024-09"
"222420","쎄노텍","37959290380","835","45460228","45460231","3","2024-09"
"037760","쎄니트","47732585970","1570","30402921","33832921","3430000","2024-09"
"099320","쎄트렉아이","462143931600","42200","10951278","10951278","0","2024-09"
"049960","쎌바이오텍","94035186000","13740","6843900","9400000","2556100","2024-09"
"088280","쏘닉스","45083406450","2605","17306490","17306490","0","2024-09"
"403550","쏘카","601169004640","18320","32814902","32814902","0","2024-09"
"050890","쏠리드","277550464040","4580","60600538","61095231","494693","2024-09"
"475400","씨메스","198101137200","17320","11437710","11437710",,"자료 없음"
"109670","씨싸이트","56310635350","9650","5835299","5836602","1303","2024-09"
"066790","씨씨에스","91332593110","1510","60485161","65152039","4666878","2024-09"
"222080","씨아이에스","631218077600","8800","71729327","71729327","0","2024-09"
"004920","씨아이테크","69591452270","1390","50065793","50065793","0","2024-09"
"352480","씨앤씨인터내셔널","669805968000","67000","9997104","10013941","16837","2024-09"
"264660","씨앤지하이테크","116968329720","12540","9327618","9627896","300278","2024-09"
"352700","씨앤투스","73693169280","2880","25587906","27276899","1688993","2024-09"
"458870","씨어스테크놀로지","147231206400","11730","12551680","12551680","0","2024-09"
"297090","씨에스베어링","150257700000","5510","27270000","27270000","0","2024-09"
"112610","씨에스윈드","2423624638500","58500","41429481","42171403","741922","2024-09"
"359090","씨엔알리서치","67288900640","1192","56450420","56450891","471","2024-09"
"115530","씨엔플러스","34321315000","505","67963000","67963000","0","2024-09"
"115480","씨유메디칼","36045293942","749","48124558","48224558","100000","2024-09"
"340810","씨유박스","33701204340","3180","10597863","10597863","0","2024-09"
"376290","씨유테크","54120237500","3065","17657500","17657500","0","2024-09"
"189330","씨이랩","41732145400","6850","6092284","6092284","0","2024-09"
"096530","씨젠","1103871881200","23900","46187108","52225994","6038886","2024-09"
"101240","씨큐브","50503357560","4885","10338456","10340947","2491","2024-09"
"060590","씨티씨바이오","187444796000","7840","23908775","24181020","272245","2024-09"
"308170","씨티알모빌리티","45460800000","5280","8610000","8610000","0","2024-09"
"260930","씨티케이","109859289870","5830","18843789","19341591","497802","2024-09"
"052300","씨티프라퍼티","61384741236","364","168639399","168651433","12034","2024-09"
"413630","씨피시스템","92543322500","2500","37017329","38703425","1686096","2024-09"
"013990","아가방컴퍼니","135099189315","4495","30055437","32887536","2832099","2024-09"
"123860","아나패스","228768841050","18870","12123415","12123415","0","2024-09"
"025980","아난티","453782927360","5120","88629478","88629478","0","2024-09"
"008700","아남전자","98329695750","1275","77121330","77124820","3490","2024-09"
"125210","아모그린텍","114652690500","6950","16496790","16496790","0","2024-09"
"002790","아모레G","1704680876250","22350","76272075","82458180","6186105","2024-09"
"090430","아모레퍼시픽","6812004034000","116600","58421990","58492759","70769","2024-09"
"357580","아모센스","78878455920","7030","11220264","11220264","0","2024-09"
"052710","아모텍","57719556700","3950","14612546","14615109","2563","2024-09"
"074430","아미노로직스","105655693332","1203","87826844","87826844","0","2024-09"
"092040","아미코젠","258732548960","4720","54816218","55018347","202129","2024-09"
"083930","아바코","227190909150","15650","14516991","14912798","395807","2024-09"
"149950","아바텍","156047689200","11280","13834015","15607500","1773485","2024-09"
"036010","아비코전자","69654974160","5240","13292934","13292934","0","2024-09"
"002030","아세아","426021453000","253500","1680558","2115648","435090","2024-09"
"183190","아세아시멘트","403381887900","10740","37558835","38501886","943051","2024-09"
"002310","아세아제지","323656155000","8100","39957550","42782510","2824960","2024-09"
"050860","아세아텍","44148482980","2230","19797526","22500000","2702474","2024-09"
"012170","아센디오","45570529840","440","103569386","103569488","102","2024-09"
"136410","아셈스","84286233330","7930","10628781","11019106","390325","2024-09"
"246720","아스타","58068044000","4280","13567300","13567300","0","2024-09"
"067390","아스트","183245629504","532","344446672","344580069","133397","2024-09"
"159010","아스플로","77160996300","5970","12924790","13334739","409949","2024-09"
"127710","아시아경제","46003580076","1318","34904082","34904082","0","2024-09"
"267850","아시아나IDT","199800000000","18000","11100000","11100000","0","2024-09"
"020560","아시아나항공","750814698760","10090","74411764","74411764","0","2024-09"
"154030","아시아종묘","27529461000","2375","11591352","11591352","0","2024-09"
"227610","아우딘퓨쳐스","45870212778","1294","35448387","35583547","135160","2024-09"
"143160","아이디스","147377714100","14620","10080555","10716390","635835","2024-09"
"054800","아이디스홀딩스","80279325810","9090","8831609","10347756","1516147","2024-09"
"332370","아이디피","46858981610","3715","12613454","13273726","660272","2024-09"
"122900","아이마켓코리아","264615099400","8410","31464340","33428840","1964500","2024-09"
"339950","아이비김영","78184877310","1803","43363770","44946655","1582885","2024-09"
"469750","아이비젼웍스","46098727698","1361","33871218","33936481","65263","2024-09"
"460470","아이빔테크놀로지","74743053350","4955","15084370","15084370","0","2024-09"
"099190","아이센스","533888609520","19320","27633986","27637273","3287","2024-09"
"461300","아이스크림미디어","192315057390","15030","12795413","13063433","268020","2024-09"
"289010","아이스크림에듀","30195359950","2410","12529195","12864037","334842","2024-09"
"214430","아이쓰리시스템","267254757000","38500","6941682","7106760","165078","2024-09"
"040910","아이씨디","76500236190","4690","16311351","18574275","2262924","2024-09"
"368600","아이씨에이치","62732779950","3650","17187063","17538346","351283","2024-09"
"456010","아이씨티케이","107229576560","8110","13221896","13221896","0","2024-09"
"052860","아이앤씨","25982963609","1601","16229209","17862854","1633645","2024-09"
"464500","아이언디바이스","55705313040","4080","13653263","13653263","0","2024-09"
"010780","아이에스동서","609776915200","20200","30186976","30186976","0","2024-09"
"038880","아이에이","61543463422","202","304670611","315334702","10664091","2024-09"
"307180","아이엘사이언스","84507784375","3125","27042491","27042828","337","2024-09"
"101390","아이엠","34589839410","3290","10513629","10548085","34456","2024-09"
"461030","아이엠비디엑스","204799327500","14610","14017750","14017750","0","2024-09"
"451220","아이엠티","74730058390","9490","7874611","7874611","0","2024-09"
"090150","아이윈","34830788172","877","39715836","41875293","2159457","2024-09"
"123010","아이윈플러스","21074304550","650","32422007","32658542","236535","2024-09"
"031310","아이즈비전","44120538462","1806","24429977","25334636","904659","2024-09"
"185490","아이진","78116075760","2890","27029784","27029784","0","2024-09"
"059100","아이컴포넌트","30520117320","4620","6606086","7070860","464774","2024-09"
"262840","아이퀘스트","40555263940","2155","18819148","19290000","470852","2024-09"
"175250","아이큐어","85950275500","2300","37369685","37558368","188683","2024-09"
"052460","아이크래프트","28160939280","2355","11957936","14607936","2650000","2024-09"
"119830","아이텍","118592552140","5570","21291302","21434297","142995","2024-09"
"052770","아이톡시","68865804076","1406","48979946","48979946","0","2024-09"
"124500","아이티센","149901244420","6460","23204527","23204527","0","2024-09"
"372800","아이티아이즈","33143753700","5630","5886990","6026990","140000","2024-09"
"084850","아이티엠반도체","384810210600","18600","20688721","22682934","1994213","2024-09"
"114840","아이패밀리에스씨","324838224960","18840","17241944","17241944","0","2024-09"
"027360","아주IB투자","239780873700","2025","118410308","120945406","2535098","2024-09"
"139990","아주스틸","133648673760","5040","26517594","26517744","150","2024-09"
"032080","아즈텍WB","23445862393","1117","20990029","21491029","501000","2024-09"
"013310","아진산업","104964663110","2705","38803942","38806582","2640","2024-09"
"059120","아진엑스텍","70859955420","7740","9155033","9748596","593563","2024-09"
"009320","아진전자부품","54525545620","1106","49299770","49299770","0","2024-09"
"158430","아톤","89334642320","4180","21371924","22602474","1230550","2024-09"
"321820","아티스트유나이티드","238463890400","17840","13366810","13366810","0","2024-09"
"001540","안국약품","81148706100","7140","11365365","13042420","1677055","2024-09"
"053800","안랩","583006823000","59500","9798434","11126506","1328072","2024-09"
"065660","안트로젠","147430300950","15150","9731373","9731373","0","2024-09"
"297570","알로이스","36767733516","1062","34621218","34621218","0","2024-09"
"001780","알루코","224161755580","2315","96830132","96830132","0","2024-09"
"260660","알리코제약","57125952755","3805","15013391","15327021","313630","2024-09"
"354320","알멕","194297982400","30400","6391381","6391381","0","2024-09"
"361570","알비더블유","61565875650","2150","28635291","28635291","0","2024-09"
"131370","알서포트","154961139550","2975","52087778","53267083","1179305","2024-09"
"140670","알에스오토메이션","96172618440","10410","9238484","9303140","64656","2024-09"
"096610","알에프세미","51550708615","2965","17386411","17386411","0","2024-09"
"061040","알에프텍","94132364220","3015","31221348","32089259","867911","2024-09"
"148250","알엔투테크놀로지","28876658125","4025","7174325","7391186","216861","2024-09"
"347860","알체라","49874548020","2265","22019668","22019668","0","2024-09"
"196170","알테오젠","20065612680000","376500","53295120","53318828","23708","2024-09"
"123750","알톤","20319150012","1596","12731297","12746297","15000","2024-09"
"085810","알티캐스트","39089857350","1290","30302215","31081959","779744","2024-09"
"043100","알파녹스","22549711680","2830","7968096","7975920","7824","2024-09"
"117670","알파홀딩스","37743429465","945","39940137","39940137","0","2024-09"
"314140","알피바이오","52591039360","6080","8649842","8666361","16519","2024-09"
"291650","압타머사이언스","35234022900","2075","16980252","16980252","0","2024-09"
"293780","압타바이오","200561922000","8110","24730200","24730200","0","2024-09"
"018250","애경산업","411223488000","16000","25701468","26409935","708467","2024-09"
"161000","애경케미칼","505943232480","10480","48277026","48648709","371683","2024-09"
"196300","애니젠","76002879420","12660","6003387","6003387","0","2024-09"
"310200","애니플러스","120108976200","2700","44484806","45520979","1036173","2024-09"
"299910","애닉","32483121920","6880","4721384","4721384","0","2024-09"
"179530","애드바이오텍","29066611920","3180","9140444","9140444","0","2024-09"
"205500","액션스퀘어","58469447310","1126","51926685","51928120","1435","2024-09"
"052790","액토즈소프트","72102010200","6600","10924547","11330638","406091","2024-09"
"290740","액트로","52727647550","5650","9332327","10065011","732684","2024-09"
"238090","앤디포스","90017959430","3955","22760546","23541303","780757","2024-09"
"092600","앤씨앤","29264835390","1195","24489402","25083517","594115","2024-09"
"129890","앱코","57762006768","1206","47895528","50643410","2747882","2024-09"
"174900","앱클론","285423318180","16380","17425111","17425111","0","2024-09"
"255440","야스","121891536900","10100","12068469","13058000","989531","2024-09"
"030960","양지사","128706975900","9370","13736070","15980000","2243930","2024-09"
"102120","어보브반도체","161852776740","9810","16498754","17780753","1281999","2024-09"
"263540","어스앤에어로스페이스","743050360","52","14289430","14294091","4661","2023-12"
"238120","얼라인드","43280476960","3010","14378896","14378896","0","2024-09"
"019990","에너토크","57703584510","6030","9569417","9756088","186671","2024-09"
"011090","에넥스","31489659891","531","59302561","59991641","689080","2024-09"
"270660","에브리봇","192276696240","15720","12231342","12231342","0","2024-09"
"038680","에스넷","66986891785","3685","18178261","19549677","1371416","2024-09"
"137310","에스디바이오센서","1109691516620","9070","122347466","124477353","2129887","2024-09"
"217480","에스디생명공학","54756837359","499","109733141","109733141","0","2024-09"
"121890","에스디시스템","18794104644","1414","13291446","13291446","0","2024-09"
"304360","에스바이오메딕스","343564533000","29250","11745796","11745796","0","2024-09"
"389500","에스비비테크","86091482160","14440","5962014","6174904","212890","2024-09"
"042110","에스씨디","71044459080","1470","48329564","48329564","0","2024-09"
"298060","에스씨엠생명과학","38261340700","1870","20460610","20467248","6638","2024-09"
"065420","에스아이리소스","18251557170","255","71574734","71577299","2565","2024-09"
"103230","에스앤더블류","24552000000","3410","7200000","7200000","0","2024-09"
"260970","에스앤디","93725229600","32400","2892754","2892754","0","2024-09"
"101490","에스앤에스텍","490234680000","23400","20950200","21451447","501247","2024-09"
"095910","에스에너지","27686678580","1485","18644228","19504503","860275","2024-09"
"275630","에스에스알","17693342160","3270","5410808","6017989","607181","2024-09"
"031330","에스에이엠티","303365158370","3110","97545067","99995067","2450000","2024-09"
"060540","에스에이티","37631424960","1440","26132934","26133306","372","2024-09"
"351320","에스에이티이엔지","33133592380","1505","22015676","22015886","210","2024-09"
"056190","에스에프에이","664423316100","21150","31414814","35908760","4493946","2024-09"
"080000","에스엔유","60185989734","1759","34216026","34322870","106844","2024-09"
"005850","에스엘","1526738565300","33150","46055462","46448520","393058","2024-09"
"214310","에스엘에너지","22487615640","6120","3674447","3679130","4683","2024-09"
"246250","에스엘에스바이오","44663279460","2910","15348206","15348206","0","2024-09"
"041510","에스엠","1623233521000","70900","22894690","23353627","458937","2024-09"
"010580","에스엠벡셀","133771946672","1204","111106268","111251760","145492","2024-09"
"007820","에스엠코어","91901741400","4700","19553562","20033946","480384","2024-09"
"464080","에스오에스랩","92829607500","5250","17681830","17681830","0","2024-09"
"109610","에스와이","194136310650","4065","47758010","48907400","1149390","2024-09"
"365330","에스와이스틸텍","157029300000","5130","30610000","30610000","0","2024-09"
"012750","에스원","2184141439400","64600","33810239","37999178","4188939","2024-09"
"031860","에스유홀딩스","16779084754","1117","15021562","15026356","4794","2024-09"
"306040","에스제이그룹","53666047200","5700","9415096","9865828","450732","2024-09"
"457940","에스케이증권제10호스팩","7050300000","2130","3310000","3310000","0","2024-09"
"472230","에스케이증권제11호스팩","8683950000","2090","4155000","4155000","0","2024-09"
"473000","에스케이증권제12호스팩","6951000000","2100","3310000","3310000","0","2024-09"
"473950","에스케이증권제13호스팩","9105200000","2060","4420000","4420000","0","2024-09"
"435870","에스케이증권제8호스팩","7849200000","2110","3720000","3720000","0","2024-09"
"455910","에스케이증권제9호스팩","10617300000","2115","5020000","5020000","0","2024-09"
"096630","에스코넥","58501653750","750","78002205","79052205","1050000","2024-09"
"069510","에스텍","92510000000","11000","8410000","10910000","2500000","2024-09"
"234300","에스트래픽","119850536325","4355","27520215","27809848","289633","2024-09"
"039440","에스티아이","321267624600","21800","14737047","15830000","1092953","2024-09"
"098660","에스티오","37625468800","3100","12137248","12500976","363728","2024-09"
"052020","에스티큐브","289660786290","6210","46644249","46694249","50000","2024-09"
"237690","에스티팜","2018690156600","100300","20126522","20126522","0","2024-09"
"050760","에스폴리텍","24306918406","1574","15442769","16334678","891909","2024-09"
"288620","에스퓨얼셀","72654679560","10410","6979316","6979316","0","2024-09"
"443670","에스피소프트","174479101580","7210","24199598","24201392","1794","2024-09"
"317830","에스피시스템스","53192855140","5230","10170718","10773818","603100","2024-09"
"058610","에스피지","473486636000","21350","22177360","22177360","0","2024-09"
"043340","에쎈테크","45030000000","474","95000000","95000000","0","2024-09"
"023960","에쓰씨엔지니어링","61858460300","1820","33988165","33988167","2","2024-09"
"298690","에어부산","277465121920","2380","116581984","116640000","58016","2024-09"
"054630","에이디칩스","12594094838","158","79709461","79709461","0","2024-09"
"200710","에이디테크놀로지","232794898770","17970","12954641","13440822","486181","2024-09"
"096690","에이루트","41505369280","1240","33472072","33477189","5117","2024-09"
"078520","에이블씨엔씨","188082362340","7230","26014158","26014161","3","2024-09"
"298380","에이비엘바이오","1801792087500","37500","48047789","48047789","0","2024-09"
"203400","에이비온","214410562000","8500","25224772","25224772","0","2024-09"
"195990","에이비프로바이오","153162093428","538","284687906","284689721","1815","2024-09"
"003800","에이스침대","290843834750","27550","10556945","11090000","533055","2024-09"
"088800","에이스테크","121673941440","960","126743689","127068928","325239","2024-09"
"241840","에이스토리","64957795000","7000","9279685","9539994","260309","2024-09"
"453860","에이에스텍","125947055250","22350","5635215","5657215","22000","2024-09"
"312610","에이에프더블류","33687204744","1663","20256888","20256888","0","2024-09"
"015260","에이엔피","31263404634","693","45113138","45116894","3756","2024-09"
"172670","에이엘티","78667254000","8880","8858925","8960259","101334","2024-09"
"445090","에이직랜드","446486384700","41450","10771686","10771686","0","2024-09"
"295310","에이치브이엠","188645606350","15850","11901931","11901931","0","2024-09"
"072990","에이치시티","71857513700","10150","7079558","7287341","207783","2024-09"
"044990","에이치엔에스하이텍","136372006080","16970","8036064","8036064",,"자료 없음"
"239610","에이치엘사이언스","77107278140","15140","5092951","5392115","299164","2024-09"
"462020","에이치엠씨제6호스팩","8863800000","2040","4345000","4345000","0","2024-09"
"477340","에이치엠씨제7호스팩","14974940000","1994","7510000","7510000","0","2024-09"
"148930","에이치와이티씨","43506218500","4475","9722060","10175213","453153","2024-09"
"044780","에이치케이","23719030836","1292","18358383","18505787","147404","2024-09"
"357230","에이치피오","122156864560","2960","41269211","42089487","820276","2024-09"
"355690","에이텀","35186419800","6510","5404980","5404980","0","2024-09"
"071670","에이테크솔루션","61100000000","6110","10000000","10000000","0","2024-09"
"045660","에이텍","126580836120","16780","7543554","8260000","716446","2024-09"
"224110","에이텍모빌리티","68686646000","14000","4906189","5340000","433811","2024-09"
"021080","에이티넘인베스트","118436030625","2575","45994575","48000000","2005425","2024-09"
"200470","에이팩트","120728932650","2850","42361029","42362093","1064","2024-09"
"262260","에이프로","104007356220","7220","14405451","14468152","62701","2024-09"
"007460","에이프로젠","286848351020","1078","266093090","286851768","20758678","2024-09"
"003060","에이프로젠바이오로직스","160033972860","810","197572806","198407845","835039","2024-09"
"397030","에이프릴바이오","477878194800","21300","22435596","22435596","0","2024-09"
"244920","에이플러스에셋","97213079900","4300","22607693","22607693","0","2024-09"
"278470","에이피알","1900619802300","50100","37936523","38113390","176867","2024-09"
"230240","에치에프알","127169370060","9690","13123774","13309000","185226","2024-09"
"230360","에코마케팅","332617066530","10570","31468029","31468029","0","2024-09"
"038870","에코바이오","53528754660","3820","14012763","14014949","2186","2024-09"
"097780","에코볼트","59399506426","877","67730338","67730338","0","2024-09"
"448280","에코아이","189639225600","19200","9877043","9877043","0","2024-09"
"101360","에코앤드림","679093900200","38700","17547646","17786114","238468","2024-09"
"128540","에코캡","32229353360","1240","25991414","26690460","699046","2024-09"
"086520","에코프로","10407783505000","79000","131744095","133138340","1394245","2024-09"
"450080","에코프로머티","7770442275000","112500","69070598","69070598","0","2024-09"
"247540","에코프로비엠","16651043810500","170500","97660081","97801344","141263","2024-09"
"383310","에코프로에이치엔","714278660600","46850","15246076","15304932","58856","2024-09"
"038110","에코플라스틱","113705828540","2830","40178738","41169370","990632","2024-09"
"073540","에프알텍","14706000000","1290","11400000","11400000","0","2024-09"
"064850","에프앤가이드","110680220400","9700","11410332","11410332","0","2024-09"
"036810","에프에스티","372179250800","18650","19955992","21756789","1800797","2024-09"
"173940","에프엔씨엔터","54785359970","3670","14927891","15392808","464917","2024-09"
"083500","에프엔에스테크","75058026000","9390","7993400","8575722","582322","2024-09"
"054940","엑사이엔씨","24515251972","739","33173548","33173548","0","2024-09"
"373110","엑셀세라퓨틱스","65074033520","5960","10918462","10918462","0","2024-09"
"205100","엑셈","124558287096","1731","71957416","71963431","6015","2024-09"
"356680","엑스게이트","144093579100","5050","28533382","28543492","10110","2024-09"
"070300","엑스큐어","34116359530","4085","8351618","8351618","0","2024-09"
"317770","엑스페릭스","84415174080","3680","22938906","22938906","0","2024-09"
"373200","엑스플러스","49132464524","649","75704876","75705657","781","2024-09"
"069920","엑시온그룹","45471255984","1299","35004816","35194116","189300","2024-09"
"092870","엑시콘","154904847510","12390","12502409","13050797","548388","2024-09"
"317870","엔바이오니아","157800212500","18550","8506750","8506750","0","2024-09"
"067570","엔브이에이치코리아","104068407090","2490","41794541","42170000","375459","2024-09"
"236810","엔비티","61930560000","3840","16127750","16975426","847676","2024-09"
"333620","엔시스","96399509970","9330","10332209","10556344","224135","2024-09"
"101400","엔시트론","26045562074","419","62161246","62162413","1167","2024-09"
"036570","엔씨소프트","4345808775000","217500","19980730","21954022","1973292","2024-09"
"078860","엔에스이엔엠","92808538200","8820","10522510","10531054","8544","2024-09"
"422040","엔에이치스팩23호","15071800000","2105","7160000","7160000","0","2024-09"
"437780","엔에이치스팩24호","10663600000","2120","5030000","5030000","0","2024-09"
"438580","엔에이치스팩25호","6644000000","2200","3020000","3020000","0","2024-09"
"439410","엔에이치스팩26호","18392000000","2090","8800000","8800000","0","2024-09"
"440820","엔에이치스팩27호","16380000000","2100","7800000","7800000","0","2024-09"
"451700","엔에이치스팩29호","28700000000","2000","14350000","14350000","0","2024-09"
"466910","엔에이치스팩30호","18190900000","1999","9100000","9100000","0","2024-09"
"481890","엔에이치스팩31호","12848625000","2025","6345000","6345000","0","2024-09"
"265740","엔에프씨","47963766000","5370","8931800","8931800","0","2024-09"
"354200","엔젠바이오","40459835380","2945","13738484","13738484","0","2024-09"
"455900","엔젤로보틱스","351963722550","23550","14945381","14945381","0","2024-09"
"419080","엔젯","101785995360","10080","10097817","10517817","420000","2024-09"
"208860","엔지스테크널러지","41831348265","2205","18971133","18971133","0","2024-09"
"183490","엔지켐생명과학","113129373331","1417","79837243","85065562","5228319","2024-09"
"085310","엔케이","60658967618","769","78880322","79983352","1103030","2024-09"
"182400","엔케이맥스","172744574320","2020","85517116","85518831","1715","2024-09"
"348370","엔켐","3633554140400","174800","20786923","20786923","0","2024-09"
"069410","엔텔스","35994767820","3630","9915914","10244824","328910","2024-09"
"227950","엔투텍","45262506610","437","103575530","103575530","0","2024-09"
"291230","엔피","93703496375","2125","44095763","44095775","12","2024-09"
"198080","엔피디","57175916175","2655","21535185","21535185","0","2024-09"
"048830","엔피케이","22079263857","1181","18695397","18723923","28526","2024-09"
"096870","엘디티","15560672000","2330","6678400","6678400","0","2024-09"
"290650","엘앤씨바이오","405832699990","17890","22684891","22684891","0","2024-09"
"066970","엘앤에프","3963167558700","118100","33557727","36296338","2738611","2024-09"
"156100","엘앤케이바이오","144341946920","7240","19936733","19936743","10","2024-09"
"073110","엘엠에스","37021619200","6400","5784628","8895755","3111127","2024-09"
"083310","엘오티베큠","162447390760","10040","16180019","17810033","1630014","2024-09"
"037950","엘컴텍","106014447192","1256","84406407","84447519","41112","2024-09"
"170920","엘티씨","102327140980","11030","9277166","9805620","528454","2024-09"
"058630","엠게임","117196216200","6300","18602574","19543877","941303","2024-09"
"058970","엠로","619949451400","52300","11853718","11853718","0","2024-09"
"019590","엠벤처투자","104963185182","921","113966542","113966542","0","2024-09"
"169330","엠브레인","38532512060","2170","17756918","18256918","500000","2024-09"
"097520","엠씨넥스","299940504840","17370","17267732","17977732","710000","2024-09"
"373170","엠아이큐브솔루션","37079164800","7360","5037930","5037930","0","2024-09"
"179290","엠아이텍","274784606220","8490","32365678","32365678","0","2024-09"
"009780","엠에스씨","93808000000","5330","17600000","17600000","0","2024-09"
"123040","엠에스오토텍","170794986885","3105","55006437","69172213","14165776","2024-09"
"323230","엠에프엠코리아","6967193212","161","43274492","43274492","0","2024-06"
"032790","엠젠솔루션","57607227872","1346","42798832","42798832","0","2024-09"
"033160","엠케이전자","165136307000","7900","20903330","22066331","1163001","2024-09"
"347890","엠투아이","90790440900","5550","16358638","16913204","554566","2024-09"
"033310","엠투엔","80550297960","2035","39582456","40342231","759775","2024-09"
"259630","엠플러스","111425492230","9230","12072101","12282402","210301","2024-09"
"105550","엣지파운드리","150058794375","2625","57165255","57165255","0","2024-09"
"060850","영림원소프트랩","56103900000","6900","8131000","8131000","0","2024-09"
"014440","영보화학","66202500000","3395","19500000","20000000","500000","2024-09"
"143540","영우디에스피","31105001600","712","43686800","44599895","913095","2024-09"
"111770","영원무역","1809086273100","42300","42767997","44311468","1543471","2024-09"
"009970","영원무역홀딩스","1023552003600","88200","11604898","13635592","2030694","2024-09"
"003520","영진약품","440770814140","2410","182892454","182892731","277","2024-09"
"000670","영풍","688053600000","400000","1720134","1842040","121906","2024-09"
"036560","영풍정밀","303975000000","19300","15750000","15750000","0","2024-09"
"006740","영풍제지","54635253165","1237","44167545","46482148","2314603","2024-09"
"012280","영화금속","39339125385","777","50629505","51664505","1035000","2024-09"
"265560","영화테크","88162285800","8310","10609180","10690180","81000","2024-09"
"012160","영흥","31494679986","462","68170303","101310372","33140069","2024-09"
"036000","예림당","68987659615","2995","23034277","23034277","0","2024-09"
"250930","예선테크","16699667537","511","32680367","33000440","320073","2024-09"
"053280","예스24","144916781600","5800","24985652","25000000","14348","2024-09"
"015360","예스코홀딩스","218331000000","51000","4281000","6000000","1719000","2024-09"
"122640","예스티","400104043750","19850","20156375","20930108","773733","2024-09"
"045060","오공","45828039670","2705","16941974","16941974","0","2024-09"
"080520","오디텍","35653986160","3445","10349488","11746609","1397121","2024-09"
"007310","오뚜기","1449676330500","421500","3439327","4007830","568503","2024-09"
"039830","오로라","56237058100","5690","9883490","10762890","879400","2024-09"
"322310","오로스테크놀로지","156217576320","16960","9210942","9366542","155600","2024-09"
"046120","오르비텍","59122785920","2180","27120544","27449486","328942","2024-09"
"014940","오리엔탈정공","152127945260","3340","45547289","45573661","26372","2024-09"
"002630","오리엔트바이오","54897042338","463","118568126","118583005","14879","2024-09"
"065500","오리엔트정공","40229270472","1268","31726554","31742912","16358","2024-09"
"271560","오리온","3944973042400","99800","39528788","39536132","7344","2024-09"
"001800","오리온홀딩스","1011233336930","16810","60156653","62645422","2488769","2024-09"
"010470","오리콤","87383654550","7530","11604735","11975050","370315","2024-09"
"417860","오브젠","45280875080","10220","4430614","4430614","0","2024-09"
"352910","오비고","83030359140","6570","12637802","12637802","0","2024-09"
"053980","오상자이엘","69734619110","3695","18872698","18982783","110085","2024-09"
"036220","오상헬스케어","179073718020","13060","13711617","14489416","777799","2024-09"
"052420","오성첨단소재","141169335846","1694","83334909","86315192","2980283","2024-09"
"039200","오스코텍","1082310180800","28300","38244176","38244176","0","2024-09"
"226400","오스테오닉","114059053440","5760","19801919","20661601","859682","2024-09"
"031510","오스템","35309408204","1348","26193923","28000000","1806077","2024-09"
"368970","오에스피","30094635200","3220","9346160","9346160","0","2024-09"
"138080","오이솔루션","104585104800","10260","10193480","10624095","430615","2024-09"
"080580","오킨스전자","101668459350","5910","17202785","17679298","476513","2024-09"
"067170","오텍","51140480400","3600","14205689","15391605","1185916","2024-09"
"353590","오토앤","59871400500","4650","12875570","12875570","0","2024-09"
"173130","오파스넷","114909570040","8810","13043084","13046473","3389","2024-09"
"440320","오픈놀","47456200000","4840","9805000","9805000","0","2024-09"
"049480","오픈베이스","68544369760","2285","29997536","31422383","1424847","2024-09"
"394280","오픈엣지테크놀로지","257621250330","11790","21850827","21850827","0","2024-09"
"309930","오하임앤컴퍼니","43020881565","2095","20535027","21290990","755963","2024-09"
"244460","올리패스","18965436720","4710","4026632","4029073","2441","2024-09"
"226950","올릭스","413717352000","24000","17238223","17238223","0","2024-09"
"057540","옴니시스템","44923479158","757","59344094","61449355","2105261","2024-09"
"131030","옵투스제약","97755283200","6400","15274263","16153162","878899","2024-09"
"082210","옵트론텍","65836848040","2120","31055117","31722356","667239","2024-09"
"109080","옵티시스","33865617840","7120","4756407","5636000","879593","2024-09"
"380540","옵티코어","32440607260","1130","28708502","29779596","1071094","2024-09"
"153710","옵티팜","74523386640","5080","14669958","14669958","0","2024-09"
"432430","와이랩","83845632000","5100","16440320","16440320","0","2024-09"
"338840","와이바이오로직스","160987724400","10900","14769516","14769516","0","2024-09"
"122990","와이솔","169626497290","6130","27671533","28186941","515408","2024-09"
"232140","와이씨","998792460300","12450","80224294","82045350","1821056","2024-09"
"112290","와이씨켐","161465403650","15970","10110545","10110545","0","2024-09"
"065530","와이어블","67596166467","1413","47838759","52860000","5021241","2024-09"
"067900","와이엔텍","119095756220","6580","18099659","18199659","100000","2024-09"
"007530","와이엠","50128016025","2635","19023915","19174452","150537","2024-09"
"155650","와이엠씨","74259220120","4105","18089944","19474358","1384414","2024-09"
"273640","와이엠텍","122994583800","11640","10566545","10966000","399455","2024-09"
"251370","와이엠티","135899485120","8330","16314464","16314464","0","2024-09"
"066430","와이오엠","21960413442","561","39145122","39153476","8354","2024-09"
"209640","와이제이링크","181182840020","12740","14221573","14221573",,"자료 없음"
"273060","와이즈버즈","46876945175","929","50459575","50459582","7","2024-09"
"019210","와이지-원","171226476900","5100","33573819","33573819","0","2024-09"
"122870","와이지엔터테인먼트","708490739600","38200","18546878","18691049","144171","2024-09"
"011690","와이투솔루션","97638594540","2670","36568762","36574394","5632","2024-09"
"332570","와이팜","104999797960","2545","41257288","42233850","976562","2024-09"
"079000","와토스코리아","41503472560","5840","7106759","7200000","93241","2024-09"
"403490","우듬지팜","84634589520","1872","45210785","45212464","1679","2024-09"
"316140","우리금융지주","11457354489080","15430","742537556","742591501","53945","2024-09"
"032820","우리기술","344720688200","2170","158857460","158859048","1588","2024-09"
"041190","우리기술투자","714857212080","9180","77871156","84000000","6128844","2024-09"
"115440","우리넷","82225338540","7860","10461239","10754239","293000","2024-09"
"046970","우리로","49561837294","1142","43399157","43824999","425842","2024-09"
"082850","우리바이오","164753749220","3490","47207378","48456578","1249200","2024-09"
"215360","우리산업","107211593620","11740","9132163","9132163","0","2024-09"
"072470","우리산업홀딩스","55612581905","2945","18883729","18887341","3612","2024-09"
"073560","우리손에프앤지","97209650772","1404","69237643","69237643","0","2024-09"
"037400","우리엔터프라이즈","33102391140","1365","24250836","26223346","1972510","2024-09"
"153490","우리이앤엘","45116557200","892","50579100","51480000","900900","2024-09"
"101170","우림피티에스","70446087660","5330","13216902","13500000","283098","2024-09"
"006980","우성","42659484720","16620","2566756","3090000","523244","2024-09"
"066590","우수AMS","122609060290","3170","38677937","39073104","395167","2024-09"
"017370","우신시스템","123920763940","7970","15548402","18314054","2765652","2024-09"
"103840","우양","64320062040","3930","16366428","16366428","0","2024-09"
"046940","우원개발","42745837750","2365","18074350","18074350","0","2024-09"
"215380","우정바이오","31991290760","2035","15720536","15879576","159040","2024-09"
"065680","우주일렉트로","117361676600","14600","8038471","9530000","1491529","2024-09"
"105840","우진","156163129280","7880","19817656","20323614","505958","2024-09"
"018620","우진비앤지","29378252907","1017","28887171","28889293","2122","2024-09"
"010400","우진아이엔에스","21433451220","3180","6740079","7622000","881921","2024-09"
"457550","우진엔텍","184221505930","19870","9271339","9271339","0","2024-09"
"049800","우진플라임","45300000000","2265","20000000","20000000","0","2024-09"
"016880","웅진","69943901400","900","77715446","79927080","2211634","2024-09"
"095720","웅진씽크빅","197420771928","1752","112683089","115505985","2822896","2024-09"
"396470","워트","149593600000","9280","16120000","16120000","0","2024-09"
"005820","원림","31880865000","15500","2056830","2297970","241140","2024-09"
"307280","원바이오젠","47427237886","1337","35472878","36959013","1486135","2024-09"
"032940","원익","68952155990","3790","18193181","18193230","49","2024-09"
"240810","원익IPS","1355060966500","27850","48655690","49083901","428211","2024-09"
"074600","원익QnC","633540800000","24100","26288000","26288000","0","2024-09"
"104830","원익머트리얼즈","274224000000","21750","12608000","12608000","0","2024-09"
"014190","원익큐브","57835546014","1634","35395071","35399906","4835","2024-09"
"217820","원익피앤이","126310790090","2855","44241958","47454559","3212601","2024-09"
"030530","원익홀딩스","170334101150","2230","76383005","77237981","854976","2024-09"
"012620","원일특강","31504000000","7160","4400000","4400000","0","2024-09"
"382840","원준","207941256890","13690","15189281","15271581","82300","2024-09"
"336570","원텍","514580117760","5760","89336826","89340619","3793","2024-09"
"376980","원티드랩","41837701215","4685","8930139","9754994","824855","2024-09"
"008370","원풍","53954240340","4940","10921911","12000000","1078089","2024-09"
"008290","원풍물산","21895557556","548","39955397","40693679","738282","2024-09"
"101160","월덱스","311397327980","18860","16510993","16510993","0","2024-09"
"336060","웨이버스","65972624000","1370","48155200","48155200","0","2024-09"
"095270","웨이브일렉트로","56275824780","4410","12760958","14971256","2210298","2024-09"
"289930","웨이비스","112526205660","9060","12420111","12420111",,"자료 없음"
"010600","웰바이오텍","49552926545","545","90922801","90923407","606","2024-09"
"065950","웰크론","61849602670","2270","27246521","28231302","984781","2024-09"
"076080","웰크론한텍","32535426594","1474","22072881","22594156","521275","2024-09"
"043590","웰킵스하이텍","19493721440","730","26703728","27136762","433034","2024-09"
"196700","웹스","19276681248","1342","14364144","14364144","0","2024-09"
"069080","웹젠","500051850550","16970","29466815","34950884","5484069","2024-09"
"053580","웹케시","91556044120","7160","12787157","13636248","849091","2024-09"
"071460","위니아","21802751835","613","35567295","35967295","400000","2024-09"
"377460","위니아에이드","26030247855","1691","15393405","15393405","0","2024-09"
"044340","위닉스","91685843200","5800","15807904","17873425","2065521","2024-09"
"330350","위더스제약","92925747200","7040","13199680","13202139","2459","2024-09"
"348350","위드텍","83759752000","8570","9773600","10183600","410000","2024-09"
"112040","위메이드","1307628206900","38900","33615121","33948483","333362","2024-09"
"101730","위메이드맥스","330795861180","10020","33013559","33295292","281733","2024-09"
"123420","위메이드플레이","80088015700","7700","10401041","11469842","1068801","2024-09"
"065370","위세아이텍","30280609840","4360","6945094","7383954","438860","2024-09"
"038620","위즈코프","37768373151","601","62842551","66546465","3703914","2024-09"
"299900","위지윅스튜디오","207554057900","1225","169431884","171048884","1617000","2024-09"
"036090","위지트","88459076250","750","117945435","118392284","446849","2024-09"
"136540","윈스","154531800000","12500","12362544","13644162","1281618","2024-09"
"097800","윈팩","151035947013","1297","116450229","116450229","0","2024-09"
"192390","윈하이텍","41624215710","3810","10924991","10924991","0","2024-09"
"008600","윌비스","28754333430","437","65799390","67236039","1436649","2024-09"
"335870","윙스풋","20301290574","1217","16681422","16681422","0","2024-09"
"033270","유나이티드제약","306729958650","20850","14711269","16333822","1622553","2024-09"
"014830","유니드","466052815800","70200","6638929","6767600","128671","2024-09"
"446070","유니드비티플러스","45962341425","4495","10225215","10611215","386000","2024-09"
"036200","유니셈","202970765700","6900","29416053","30664223","1248170","2024-09"
"018000","유니슨","117368920108","697","168391564","168391564","0","2024-09"
"000910","유니온","72906260730","4670","15611619","15611619","0","2024-09"
"047400","유니온머티리얼","99540000000","2370","42000000","42000000","0","2024-09"
"203450","유니온커뮤니티","32263264260","2620","12314223","14079007","1764784","2024-09"
"011330","유니켐","139354252653","1551","89848003","96997167","7149164","2024-09"
"077500","유니퀘스트","101304478380","4690","21600102","21794015","193913","2024-09"
"011320","유니크","78731832125","4075","19320695","19320695","0","2024-09"
"086390","유니테스트","209021358760","10280","20332817","21134126","801309","2024-09"
"241690","유니테크노","90786319260","3710","24470706","24470706","0","2024-09"
"142210","유니트론텍","94360850645","4985","18928957","19246092","317135","2024-09"
"088340","유라클","48540062280","11210","4330068","4330068","0","2024-09"
"048430","유라테크","75474953680","6590","11452952","11520000","67048","2024-09"
"206650","유바이오로직스","562628327800","15400","36534307","36534307","0","2024-09"
"089850","유비벨록스","99501001200","6840","14546930","14730199","183269","2024-09"
"084440","유비온","16992433600","862","19712800","19712800","0","2024-09"
"032620","유비케어","193329466020","3810","50742642","52197139","1454497","2024-09"
"264450","유비쿼스","139437157780","14020","9945589","10245706","300117","2024-09"
"078070","유비쿼스홀딩스","160010136660","9690","16512914","18150700","1637786","2024-09"
"002920","유성기업","51423237500","2005","25647500","25947500","300000","2024-09"
"024800","유성티엔에스","66530664576","1992","33398928","37051812","3652884","2024-09"
"000700","유수홀딩스","125434449920","5120","24498916","26041812","1542896","2024-09"
"054930","유신","68100000000","22700","3000000","3000000","0","2024-09"
"069330","유아이디","17436611676","1236","14107291","14191091","83800","2024-09"
"049520","유아이엘","107566228080","5030","21384936","21784936","400000","2024-09"
"435380","유안타제10호스팩","11975700000","2090","5730000","5730000","0","2024-09"
"444920","유안타제11호스팩","10768200000","2055","5240000","5240000","0","2024-09"
"446150","유안타제12호스팩","9778500000","2050","4770000","4770000","0","2024-09"
"449020","유안타제13호스팩","19654600000","2020","9730000","9730000","0","2024-09"
"450940","유안타제14호스팩","9624800000","2120","4540000","4540000","0","2024-09"
"473050","유안타제15호스팩","14090100000","2010","7010000","7010000","0","2024-09"
"474490","유안타제16호스팩","11130200000","2020","5510000","5510000","0","2024-09"
"430700","유안타제9호스팩","11056400000","2110","5240000","5240000","0","2024-09"
"003470","유안타증권","552028495095","2865","192680103","199596576","6916473","2024-09"
"263770","유에스티","49964400375","2125","23512659","23700172","187513","2024-09"
"072130","유엔젤","57976337400","4850","11953884","13195454","1241570","2024-09"
"000220","유유제약","71527414660","4420","16182673","17032351","849678","2024-09"
"388720","유일로보틱스","362501186100","31650","11453434","11453434","0","2024-09"
"340930","유일에너테크","76735012500","2250","34104450","34204450","100000","2024-09"
"023410","유진기업","234745448225","3425","68538817","77310863","8772046","2024-09"
"056080","유진로봇","217945603120","5810","37512152","37512152","0","2024-09"
"468760","유진스팩10호","9010000000","2125","4240000","4240000","0","2024-09"
"488060","유진스팩11호","9510800000","2015","4720000","4720000",,"자료 없음"
"442130","유진스팩9호","7698500000","2225","3460000","3460000","0","2024-09"
"084370","유진테크","831895306000","37400","22243190","22916042","672852","2024-09"
"240600","유진테크놀로지","43606036200","6360","6856295","6928151","71856","2024-09"
"001200","유진투자증권","361846231300","3940","91839145","96866418","5027273","2024-09"
"221800","유투바이오","32732868400","2900","11287196","11287196","0","2024-09"
"179900","유티아이","363896639000","23000","15821593","16286895","465302","2024-09"
"263050","유틸렉스","84996172800","2310","36794880","36798858","3978","2024-09"
"000100","유한양행","10235218784500","138700","73793935","80209064","6415129","2024-09"
"003460","유화증권","102035891150","2230","45756005","56702415","10946410","2024-09"
"191410","육일씨엔에쓰","19013620735","1697","11204255","11204255","0","2024-09"
"372170","윤성에프앤씨","440443449600","55200","7979048","7979048","0","2024-09"
"146060","율촌","30089465567","1253","24013939","24015595","1656","2024-09"
"008730","율촌화학","711760000000","28700","24800000","24800000","0","2024-09"
"072770","율호","128184795300","1825","70238244","70238244","0","2024-09"
"008250","이건산업","50354992700","4925","10224364","10952635","728271","2024-09"
"039020","이건홀딩스","72125205930","3330","21659221","22584709","925488","2024-09"
"025820","이구산업","148309899215","4435","33440789","33442000","1211","2024-09"
"067920","이글루","53191506520","5080","10470769","10996119","525350","2024-09"
"044960","이글벳","62724723670","5110","12274897","12641883","366986","2024-09"
"303530","이노뎁","53765132400","7560","7111790","7339299","227509","2024-09"
"296640","이노룰스","28763814880","5690","5055152","5178252","123100","2024-09"
"302430","이노메트리","88447725000","9000","9827525","9833208","5683","2024-09"
"214320","이노션","792400000000","19810","40000000","40000000","0","2024-09"
"462350","이노스페이스","200639851600","21400","9375694","9375694","0","2024-09"
"274400","이노시뮬레이션","39959310860","5110","7819826","7819826","0","2024-09"
"056090","이노시스","125226768975","1331","94084725","94084725","0","2024-09"
"073490","이노와이어리스","132002766560","17360","7603846","7603846","0","2024-09"
"215790","이노인스트루먼트","18046527744","448","40282428","40283149","721","2024-09"
"344860","이노진","22038594000","1843","11958000","12030000","72000","2024-09"
"088390","이녹스","97800390280","10420","9385834","9385844","10","2024-09"
"272290","이녹스첨단소재","475089088150","24650","19273391","20227658","954267","2024-09"
"053350","이니텍","68426206320","4080","16771129","19790916","3019787","2024-09"
"452400","이닉스","109310707400","12050","9071428","9071428","0","2024-09"
"264850","이랜시스","156623144040","5170","30294612","30294612","0","2024-09"
"054210","이랜텍","135384632640","5440","24886881","25291210","404329","2024-09"
"009730","이렘","72243787551","1569","46044479","46056774","12295","2024-09"
"065440","이루온","35635833144","1348","26436078","27275020","838942","2024-09"
"139480","이마트","1749279450900","65300","26788353","27875819","1087466","2024-09"
"115610","이미지스","60829720700","3860","15758995","15758995","0","2024-09"
"478110","이베스트스팩6호","10115300000","2015","5020000","5020000","0","2024-09"
"131400","이브이첨단소재","124831987030","2095","59585674","59589882","4208","2024-09"
"351330","이삭엔지니어링","68463175200","8260","8288520","8288520","0","2024-09"
"080010","이상네트웍스","50561088890","5330","9486133","9835071","348938","2024-09"
"457190","이수스페셜티케미컬","1215501679000","40600","29938465","30208280","269815","2024-09"
"086890","이수앱지스","222593875600","6200","35902238","35902238","0","2024-09"
"007660","이수페타시스","2302169651600","36400","63246419","63246419","0","2024-09"
"005950","이수화학","170228365260","7710","22078906","22722739","643833","2024-09"
"015020","이스타코","29090437332","748","38890959","42851600","3960641","2024-09"
"047560","이스트소프트","134532592810","13090","10277509","11603992","1326483","2024-09"
"239340","이스트에이드","44705134234","1657","26979562","26979634","72","2024-09"
"067010","이씨에스","34850493000","3060","11389050","12294000","904950","2024-09"
"093230","이아이디","354065768064","1392","254357592","254384360","26768","2024-09"
"418620","이에이트","119183390950","12350","9650477","9650477","0","2024-09"
"456070","이엔셀","196263569900","18380","10678105","10678105","0","2024-09"
"102710","이엔에프테크놀로지","231891578280","16230","14287836","14287836","0","2024-09"
"074610","이엔플러스","99496132524","1356","73374729","73374729","0","2024-09"
"041520","이엘씨","63286834610","5410","11698121","12188730","490609","2024-09"
"063760","이엘피","20439736900","2315","8829260","9325130","495870","2024-09"
"123570","이엠넷","57333151365","2685","21353129","22276078","922949","2024-09"
"083470","이엠앤아이","28743527934","1347","21338922","21340329","1407","2024-09"
"095190","이엠코리아","95171521200","2100","45319772","45319772","0","2024-09"
"091120","이엠텍","407640526400","24800","16437118","17132936","695818","2024-09"
"102460","이연제약","298591333480","16280","18340991","18586811","245820","2024-09"
"039030","이오테크닉스","2070678378300","171100","12102153","12319550","217397","2024-09"
"294090","이오플로우","155526217490","5110","30435659","30435659","0","2024-09"
"088290","이원컴포텍","35153654646","1122","31331243","31331669","426","2024-09"
"084680","이월드","244606687050","1725","141800978","141806193","5215","2024-09"
"353810","이지바이오","117566626800","3515","33447120","34191720","744600","2024-09"
"099750","이지케어텍","113650655740","16910","6720914","6834776","113862","2024-09"
"377330","이지트로닉스","45002892800","5690","7909120","8139954","230834","2024-09"
"035810","이지홀딩스","167739569400","2600","64515219","65145845","630626","2024-09"
"160600","이큐셀","106346383500","3100","34305285","34482552","177267","2024-09"
"092130","이크레더블","153074156000","12710","12043600","12043600","0","2024-09"
"096040","이트론","245561522409","271","906131079","906131295","216","2024-09"
"134060","이퓨쳐","16174902540","4205","3846588","4769250","922662","2024-09"
"001840","이화공영","49608433830","2505","19803766","19805760","1994","2024-09"
"000760","이화산업","31584000000","11280","2800000","2800000","0","2024-09"
"024810","이화전기","196810080587","899","218921113","218948640","27527","2024-09"
"014990","인디에프","55055622670","733","75109990","75112995","3005","2024-09"
"041830","인바디","317855066800","24400","13026847","13683782","656935","2024-09"
"352940","인바이오","24235037900","2230","10867730","10867730","0","2024-09"
"101140","인바이오젠","93257770480","9340","9984772","10044216","59444","2024-09"
"079950","인베니아","17562740000","806","21790000","23200000","1410000","2024-09"
"389470","인벤티지랩","165629541740","16510","10032074","10032074","0","2024-09"
"277410","인산가","50395784334","1337","37693182","38356789","663607","2024-09"
"060150","인선이엔티","250560519690","5590","44822991","46563612","1740621","2024-09"
"033230","인성정보","107229196140","2140","50107101","50515380","408279","2024-09"
"450520","인스웨이브시스템즈","50583748320","3440","14704578","14704578","0","2024-09"
"006490","인스코비","177223809048","1496","118465113","119368998","903885","2024-09"
"465480","인스피언","89111015880","8790","10137772","10137772",,"자료 없음"
"037330","인지디스플레","62346117112","1546","40327372","43885224","3557852","2024-09"
"100030","인지소프트","47964540600","17460","2747110","3283714","536604","2024-09"
"023800","인지컨트롤스","97534721710","6430","15168697","15809197","640500","2024-09"
"034590","인천도시가스","105317074450","25550","4121999","4374754","252755","2024-09"
"211050","인카금융서비스","263256067690","5390","48841571","51379800","2538229","2024-09"
"083640","인콘","25832243960","335","77111176","77720351","609175","2024-09"
"064090","인크레더블버즈","176828103180","3555","49740676","49742745","2069","2024-09"
"216050","인크로스","89560809800","7420","12070190","12843222","773032","2024-09"
"049070","인탑스","321315400600","20200","15906703","17200000","1293297","2024-09"
"119610","인터로조","312050211300","24900","12532137","13216478","684341","2024-09"
"017250","인터엠","20893321944","1032","20245467","21045467","800000","2024-09"
"129260","인터지스","62776443700","2225","28214132","29747874","1533742","2024-09"
"051370","인터플렉스","237940214400","10200","23327472","23327472","0","2024-09"
"064290","인텍플러스","158868311680","12820","12392224","12863962","471738","2024-09"
"189300","인텔리안테크","539135665200","51700","10428156","10733334","305178","2024-09"
"150840","인트로메딕","251537720850","5850","42997901","42997901","0","2024-09"
"048530","인트론바이오","192067427250","5870","32720175","34150762","1430587","2024-09"
"023810","인팩","69800000000","6980","10000000","10000000","0","2024-09"
"115310","인포바인","42658190410","19910","2142551","3192883","1050332","2024-09"
"039290","인포뱅크","49795835670","5970","8341011","8693978","352967","2024-09"
"071200","인피니트헬스케어","104209336575","4275","24376453","24396458","20005","2024-09"
"101930","인화정공","217163155300","22850","9503858","9615733","111875","2024-09"
"249420","일동제약","379880177600","13600","27932366","28062501","130135","2024-09"
"000230","일동홀딩스","90223799100","7990","11292090","11540400","248310","2024-09"
"013360","일성건설","70394418640","1303","54024880","54024880","0","2024-09"
"003120","일성아이에스","107755790130","15810","6815673","13300000","6484327","2024-09"
"333430","일승","86366111385","2815","30680679","30726747","46068","2024-09"
"068330","일신바이오","51054028550","1225","41676758","44216140","2539382","2024-09"
"003200","일신방직","170832496200","8020","21300810","23280000","1979190","2024-09"
"007110","일신석재","124505848080","1608","77429010","77456610","27600","2024-09"
"007570","일양약품","227176495360","12640","17972824","19085664","1112840","2024-09"
"178780","일월지엠엘","124101377000","8650","14346980","14349195","2215","2024-09"
"008500","일정실업","17133446500","14500","1181617","1200000","18383","2024-09"
"019540","일지테크","54768407270","4145","13213126","13513500","300374","2024-09"
"081000","일진다이아","173359167300","12210","14198130","14202975","4845","2024-09"
"020760","일진디스플","46254365393","899","51450907","51513741","62834","2024-09"
"103590","일진전기","1189547861550","24950","47677269","47685390","8121","2024-09"
"094820","일진파워","149430006190","9910","15078709","15078709","0","2024-09"
"271940","일진하이솔루스","762576990000","21000","36313190","36313190","0","2024-09"
"015860","일진홀딩스","183482292630","3990","45985537","49347483","3361946","2024-09"
"226320","잇츠한불","212457221100","12060","17616685","21929315","4312630","2024-09"
"049550","잉크테크","75582197835","3855","19606277","19606277","0","2024-09"
"389020","자람테크놀로지","205142093100","33450","6132798","6197730","64932","2024-09"
"254120","자비스","57523894410","1873","30712170","30754270","42100","2024-09"
"043910","자연과환경","67806893492","598","113389454","113391457","2003","2024-09"
"234920","자이글","42290391150","3150","13425521","13530910","105389","2024-09"
"289220","자이언트스텝","145339864650","6570","22121745","22121745","0","2024-09"
"317400","자이에스앤디","149401078400","3920","38112520","38782520","670000","2024-09"
"033240","자화전자","340758163200","16160","21086520","22155870","1069350","2024-09"
"174880","장원테크","11454988050","2650","4322637","4381265","58628","2024-09"
"049630","재영솔루텍","59812762295","715","83654213","83654213","0","2024-09"
"417840","저스템","56454357760","7960","7092256","7249175","156919","2024-09"
"000950","전방","22037349800","19340","1139470","1680000","540530","2024-09"
"079900","전진건설로봇","348540480000","24000","14522520","15360574","838054","2024-09"
"110020","전진바이오팜","20472802120","2260","9058762","9058762","0","2024-09"
"208140","정다운","86449804220","2645","32684236","32684246","10","2024-09"
"040420","정상제이엘에스","98595697200","6600","14938742","15677552","738810","2024-09"
"045510","정원엔시스","26506123794","842","31479957","32209292","729335","2024-09"
"217190","제너셈","71118001140","8110","8769174","8769174","0","2024-09"
"095700","제넥신","332911242960","7320","45479678","45540494","60816","2024-09"
"072520","제넨바이오","28838655818","389","74135362","74163194","27832","2024-09"
"122310","제노레이","80485044540","5970","13481582","14553844","1072262","2024-09"
"361390","제노코","121887821250","16250","7500789","7500789","0","2024-09"
"187420","제노포커스","110208805455","4655","23675361","23675361","0","2024-09"
"225220","제놀루션","51459671250","2850","18056025","19190021","1133996","2024-09"
"123330","제닉","163535937400","20900","7824686","7968680","143994","2024-09"
"381620","제닉스","121559392000","27800","4372640","4372640","0","2024-09"
"159580","제로투세븐","87943272040","4390","20032636","20032636","0","2024-09"
"147830","제룡산업","116252512530","6070","19151979","20000000","848021","2024-09"
"033100","제룡전기","849701436100","52900","16062409","16062409","0","2024-09"
"079370","제우스","421583884140","13740","30682961","31016990","334029","2024-09"
"054950","제이브이엠","238421937600","20700","11517968","12089892","571924","2024-09"
"023440","제이스코홀딩스","104346392780","1778","58687510","58687510","0","2024-09"
"090470","제이스텍","106877238160","6160","17350201","17476594","126393","2024-09"
"287410","제이시스메디칼","960860460300","12900","74485307","75692193","1206886","2024-06"
"137950","제이씨케미칼","101120716735","4685","21583931","22267814","683883","2024-09"
"033320","제이씨현시스템","73961988165","3915","18891951","19114432","222481","2024-09"
"417500","제이아이테크","106027877120","3355","31602944","32784744","1181800","2024-09"
"204270","제이앤티씨","1189880747850","20850","57068621","57848466","779845","2024-09"
"194370","제이에스코퍼레이션","232675767300","17470","13318590","13335601","17011","2024-09"
"026040","제이에스티나","26056300061","1819","14324519","16503790","2179271","2024-09"
"452160","제이엔비","56738512300","5900","9616697","9617527","830","2024-09"
"126880","제이엔케이글로벌","84100286490","3630","23168123","23204903","36780","2024-09"
"322510","제이엘케이","183517363400","8740","20997410","21329410","332000","2024-09"
"033050","제이엠아이","30438397568","956","31839328","32579342","740014","2024-09"
"094970","제이엠티","54815799520","3280","16712134","16748240","36106","2024-09"
"418550","제이오","589433197890","19930","29575173","31772273","2197100","2024-09"
"025620","제이준코스메틱","22259931050","4975","4474358","4484846","10488","2024-09"
"420570","제이투케이바이오","77137056000","13500","5713856","5732807","18951","2024-09"
"089790","제이티","43228037600","4730","9139120","10315513","1176393","2024-09"
"030000","제일기획","1867579689000","18440","101278725","115041225","13762500","2024-09"
"052670","제일바이오","56184286080","2080","27011676","29129064","2117388","2024-09"
"271980","제일약품","204729813850","14050","14571517","14704872","133355","2024-09"
"412540","제일엠앤에스","206830676600","10040","20600665","20600665","0","2024-09"
"001560","제일연마","58667720000","8620","6806000","9900000","3094000","2024-09"
"199820","제일일렉트릭","194425000000","8750","22220000","22220000","0","2024-09"
"038010","제일테크노스","56881440000","6840","8316000","9000000","684000","2024-09"
"002620","제일파마홀딩스","133401276250","8690","15351125","15973355","622230","2024-09"
"276730","제주맥주","34665612200","2920","11871785","11886605","14820","2024-09"
"080220","제주반도체","408239220480","12120","33683104","34442833","759729","2024-09"
"006220","제주은행","267632687420","8330","32128774","32128774","0","2024-09"
"089590","제주항공","767036976720","9520","80571111","80640985","69874","2024-09"
"216080","제테마","346638512190","19410","17858759","17858759","0","2024-09"
"229000","젠큐릭스","34680111375","2275","15244005","15244005","0","2024-09"
"082270","젬백스","546392443320","13770","39679916","39994174","314258","2024-09"
"044060","조광ILI","70075958688","732","95732184","95732184","0","2024-09"
"004910","조광페인트","63454259600","6200","10234558","12800000","2565442","2024-09"
"004700","조광피혁","191147257400","53800","3552923","6649138","3096215","2024-09"
"001550","조비","52904727320","10190","5191828","5192239","411","2024-09"
"462520","조선내화","207952301700","17550","11849134","11855168","6034","2024-09"
"120030","조선선재","91724999500","94700","968585","1257651","289066","2024-09"
"034940","조아제약","40490633889","1307","30979827","30979827","0","2024-09"
"067000","조이시티","113383389412","1622","69903446","69903446","0","2024-09"
"018470","조일알미늄","209322234813","1653","126631721","126631721","0","2024-09"
"002600","조흥","102780000000","171300","600000","600000","0","2024-09"
"185750","종근당","1296943612400","102800","12616183","13174420","558237","2024-09"
"063160","종근당바이오","140440550400","25600","5485959","5485962","3","2024-09"
"001630","종근당홀딩스","265639136400","55800","4760558","5009861","249303","2024-09"
"033340","좋은사람들","62823961584","648","96950558","96950558","0","2024-09"
"036930","주성엔지니어링","1465317951000","31000","47268321","47268321","0","2024-09"
"109070","주성코퍼레이션","216476814300","4100","52799223","52810230","11007","2024-09"
"044380","주연테크","22438782132","348","64479259","66403852","1924593","2024-09"
"072020","중앙백신","101699141760","10610","9585216","9658687","73471","2024-09"
"000440","중앙에너비스","86459782500","19500","4433835","6227130","1793295","2024-09"
"051980","중앙첨단소재","1158917795000","11620","99734750","99961003","226253","2024-09"
"228760","지노믹트리","390559023360","16280","23990112","24362333","372221","2024-09"
"314130","지놈앤컴퍼니","110720799475","3575","30970853","30970853","0","2024-09"
"013890","지누스","482486217400","24200","19937447","20260832","323385","2024-09"
"389030","지니너스","50628100710","1518","33351845","33351845","0","2024-09"
"043610","지니뮤직","143545131860","2470","58115438","58115438","0","2024-09"
"263860","지니언스","83594360610","9690","8626869","9444600","817731","2024-09"
"303030","지니틱스","41882770144","1172","35736152","35745668","9516","2024-09"
"036180","지더블유바이텍","53929030348","577","93464524","93464524","0","2024-09"
"208350","지란지교시큐리티","25743684120","3290","7824828","8838549","1013721","2024-09"
"144510","지씨셀","524447220900","34900","15027141","15800344","773203","2024-09"
"358570","지아이이노베이션","631430341080","14280","44217811","44217811","0","2024-09"
"382480","지아이텍","90832934925","2325","39067929","39357140","289211","2024-09"
"382800","지앤비에스 에코","104066124890","3290","31631041","31631041","0","2024-09"
"051160","지어소프트","136262603400","9380","14526930","15474430","947500","2024-09"
"053050","지에스이","108105287185","3605","29987597","29987597","0","2024-09"
"119850","지엔씨에너지","75469631820","5060","14914947","16448909","1533962","2024-09"
"065060","지엔코","33976397070","315","107861578","108008044","146466","2024-09"
"204840","지엘팜텍","81861423090","1065","76865186","76865206","20","2024-09"
"013870","지엠비코리아","74000446400","3880","19072280","19072280","0","2024-09"
"071320","지역난방공사","530306475200","45800","11578744","11578744","0","2024-09"
"270520","지오릿에너지","159743530716","1006","158790786","158790786","0","2024-09"
"311320","지오엘리먼트","93095452800","7380","12614560","12614560","0","2024-09"
"388050","지투파워","143272558080","7680","18655281","18709437","54156","2024-09"
"088790","진도","21845790720","1755","12447744","12447744","0","2024-09"
"018120","진로발효","117597666280","17770","6617764","6621120","3356","2024-09"
"109820","진매트릭스","64084963230","3210","19964163","20393640","429477","2024-09"
"086060","진바이오텍","29620419280","3440","8610587","8610587","0","2024-09"
"036890","진성티이씨","171475521360","8580","19985492","22482268","2496776","2024-09"
"363250","진시스템","67163342400","9900","6784176","7006491","222315","2024-09"
"003780","진양산업","89440000000","6880","13000000","13000000","0","2024-09"
"007370","진양제약","65265237000","5750","11350476","12574867","1224391","2024-09"
"010640","진양폴리","72100000000","7210","10000000","10000000","0","2024-09"
"100250","진양홀딩스","177747028560","3180","55895292","55895292","0","2024-09"
"051630","진양화학","42502000000","2690","15800000","15800000","0","2024-09"
"272450","진에어","576661364460","11190","51533634","52200000","666366","2024-09"
"285800","진영","47101194140","2695","17477252","17477270","18","2024-09"
"011000","진원생명과학","199573927500","2500","79829571","80039035","209464","2024-09"
"002780","진흥기업","108333142430","745","145413614","145471745","58131","2024-09"
"085660","차바이오텍","970297852890","17230","56314443","56314443","0","2024-09"
"261780","차백신연구소","105287135900","3925","26824748","26824748","0","2024-09"
"351870","차이커뮤니케이션","85698998000","7700","11129740","11131089","1349","2024-09"
"009310","참엔지니어링","31733047904","376","84396404","84867419","471015","2024-09"
"094850","참좋은여행","62777605730","4690","13385417","14000000","614583","2024-09"
"004650","창해에탄올","70941731850","9350","7587351","9190885","1603534","2024-09"
"278280","천보","553101000000","55700","9930000","10000000","70000","2024-09"
"000650","천일고속","56939454600","39900","1427054","1429220","2166","2024-09"
"362320","청담글로벌","138651163040","6890","20123536","20551290","427754","2024-09"
"012600","청호ICT","116119947330","2490","46634517","46634517","0","2024-09"
"066360","체리부로","34285690725","715","47952015","47952015","0","2024-09"
"033250","체시스","46240000000","1445","32000000","32000000","0","2024-09"
"047820","초록뱀미디어","131865872400","5400","24419606","24453930","34324","2024-09"
"094360","칩스앤미디어","283993398000","14040","20227450","20823124","595674","2024-09"
"016920","카스","28629081635","1165","24574319","26493538","1919219","2024-09"
"284620","카이노스메드","144865133680","5210","27805208","28180793","375585","2024-09"
"035720","카카오","16216523551100","36950","438877498","443530908","4653410","2024-09"
"293490","카카오게임즈","1453004509920","17760","81813317","82667326","854009","2024-09"
"323410","카카오뱅크","10314737709950","21650","476431303","476963637","532334","2024-09"
"377300","카카오페이","3304822456300","24550","134615986","134615986","0","2024-09"
"140430","카티스","64912654800","3780","17172660","19102219","1929559","2024-09"
"042000","카페24","581484964450","24050","24178169","24253054","74885","2024-09"
"006380","카프로","618528628380","3660","168996893","168999996","3103","2024-09"
"313760","캐리","48225593640","6590","7317996","7417913","99917","2024-09"
"317530","캐리소프트","32514894610","4735","6866926","6971196","104270","2024-09"
"071850","캐스텍코리아","52524930770","2165","24260938","24529188","268250","2024-09"
"050110","캠시스","77999429565","1065","73238901","73824118","585217","2024-09"
"452300","캡스톤파트너스","38694563100","2745","14096380","14096380","0","2024-09"
"451760","컨텍","140763122700","9550","14739594","14940476","200882","2024-09"
"078340","컴투스","496275949950","43450","11421771","12737755","1315984","2024-09"
"063080","컴투스홀딩스","154651577500","23450","6594950","6595192","242","2024-09"
"307930","컴퍼니케이","79923200000","5120","15610000","15610000","0","2024-09"
"079190","케스피온","22222830260","590","37665814","38355514","689700","2024-09"
"263700","케어랩스","58102937105","2995","19399979","19414200","14221","2024-09"
"214370","케어젠","832411474990","16990","48994201","53715000","4720799","2024-09"
"221980","케이디켐","46811012500","12500","3744881","4034800","289919","2024-09"
"038530","케이바이오","30375669183","263","115496841","115714347","217506","2024-09"
"001620","케이비아이동국실업","64772544042","582","111293031","111293031","0","2024-09"
"424140","케이비제21호스팩","16692150000","2165","7710000","7710000","0","2024-09"
"192250","케이사인","65517422949","957","68461257","70671257","2210000","2024-09"
"431190","케이쓰리아이","42073804040","5620","7486442","7486442","0","2024-09"
"029460","케이씨","219694432270","18910","11617897","13554044","1936147","2024-09"
"115500","케이씨에스","92400000000","7700","12000000","12000000","0","2024-09"
"281820","케이씨텍","725072823200","36200","20029636","20861556","831920","2024-09"
"089150","케이씨티","43303750000","2525","17150000","17150000","0","2024-09"
"025880","케이씨피드","44514083520","2820","15785136","16715858","930722","2024-09"
"093320","케이아이엔엑스","339545957400","70200","4836837","4880000","43163","2024-09"
"093640","케이알엠","135224928000","4150","32584320","32584320","0","2024-09"
"073010","케이에스피","157873412360","3940","40069394","40191250","121856","2024-09"
"105330","케이엔더블유","62211979760","3920","15870403","16060028","189625","2024-09"
"053080","케이엔솔","204355481920","15770","12958496","12999807","41311","2024-09"
"199430","케이엔알시스템","81290493240","7480","10867713","10867713","0","2024-09"
"432470","케이엔에스","132720706800","15300","8674556","8674556","0","2024-09"
"272110","케이엔제이","127205726550","15890","8005395","8005395","0","2024-09"
"039420","케이엘넷","55461289770","2595","21372366","24154730","2782364","2024-09"
"083550","케이엠","37137019920","3220","11533236","12374226","840990","2024-09"
"032500","케이엠더블유","316974228680","7960","39820883","39820883","0","2024-09"
"225430","케이엠제약","18572749326","666","27887011","27887050","39","2024-09"
"102370","케이옥션","111837412800","4320","25888290","27229210","1340920","2024-09"
"068100","케이웨더","33874688880","3480","9734106","9939614","205508","2024-09"
"381970","케이카","626848769730","13010","48182073","48182073","0","2024-09"
"036030","케이티알파","202203956625","4125","49019141","49019283","142","2024-09"
"064820","케이프","134207311680","4810","27901728","30901728","3000000","2024-09"
"256940","케이피에스","111367028520","5940","18748658","18748658","0","2024-09"
"024880","케이피에프","78465815230","4055","19350386","20682798","1332412","2024-09"
"042040","케이피엠테크","55648348008","319","174446232","174460917","14685","2024-09"
"054410","케이피티유","22705350460","3965","5726444","5726444","0","2024-09"
"258610","케일럼","40959974664","1544","26528481","26787133","258652","2024-09"
"274090","켄코아에어로스페이스","116477298520","9020","12913226","12913226","0","2024-09"
"089010","켐트로닉스","292891719150","19650","14905431","15334346","428915","2024-09"
"220260","켐트로스","124292806560","4680","26558292","26558307","15","2024-09"
"052400","코나아이","219948047040","15060","14604784","14899999","295215","2024-09"
"402030","코난테크놀로지","167899338080","14660","11452888","11452888","0","2024-09"
"391710","코닉오토메이션","82959435532","1999","41500468","41503222","2754","2024-09"
"046070","코다코","145807623880","10280","14183621","14219097","35476","2024-09"
"047770","코데즈컴바인","55151667399","1461","37749259","37842602","93343","2024-09"
"080530","코디","60845611560","1410","43152916","43300427","147511","2024-09"
"104540","코렌텍","79143730600","6190","12785740","12785740","0","2024-09"
"027050","코리아나","77877000000","2545","30600000","40000000","9400000","2024-09"
"007810","코리아써키트","239042000120","10120","23620751","23620751","0","2024-09"
"190650","코리아에셋투자증권","36092200000","5650","6388000","6388000","0","2024-09"
"123410","코리아에프티","141154169130","5070","27841059","27841064","5","2024-09"
"003690","코리안리","1390205445440","9440","147267526","165367526","18100000","2024-09"
"036690","코맥스","45885746130","2885","15904938","15904938","0","2024-09"
"049430","코메론","95503853100","10630","8984370","9048000","63630","2024-09"
"183300","코미코","523462504000","50800","10304380","10460684","156304","2024-09"
"041960","코미팜","298609988600","4310","69283060","70622233","1339173","2024-09"
"089890","코세스","144153327840","8790","16399696","16584962","185266","2024-09"
"360350","코셈","41972578000","7400","5671970","5671970","0","2024-09"
"082660","코스나인","47827116000","480","99639825","99640869","1044","2024-09"
"192820","코스맥스","1712060395800","150900","11345662","11349509","3847","2024-09"
"044820","코스맥스비티아이","83509292860","8740","9554839","9603921","49082","2024-09"
"222040","코스맥스엔비티","76052893200","3700","20554836","20628000","73164","2024-09"
"241710","코스메카코리아","850128000000","79600","10680000","10680000","0","2024-09"
"005070","코스모신소재","3363646086000","103500","32498996","32510756","11760","2024-09"
"005420","코스모화학","822915500550","21450","38364359","38408228","43869","2024-09"
"355150","코스텍시스","57097587960","7560","7552591","7797350","244759","2024-09"
"071950","코아스","32183241600","9780","3290720","3290720","0","2024-09"
"166480","코아스템켐온","325938526020","13380","24360129","32870376","8510247","2024-09"
"045970","코아시아","114710697625","4625","24802313","26314876","1512563","2024-09"
"196450","코아시아씨엠","37424631846","826","45308271","45319582","11311","2024-09"
"384470","코어라인소프트","99830664900","7780","12831705","12832064","359","2024-09"
"029960","코엔텍","359497328000","7400","48580720","50000000","1419280","2024-09"
"002020","코오롱","182451855700","14450","12626426","12626426","0","2024-09"
"138490","코오롱ENP","215460000000","5670","38000000","38000000","0","2024-09"
"003070","코오롱글로벌","170666918150","9050","18858223","18932713","74490","2024-09"
"450140","코오롱모빌리티그룹","142288574240","2320","61331282","62777250","1445968","2024-09"
"102940","코오롱생명과학","234305078820","18860","12423387","12423387","0","2024-09"
"120110","코오롱인더","894144257500","32500","27512131","27519091","6960","2024-09"
"021240","코웨이","4530275379000","63000","71909133","73799619","1890486","2024-09"
"033290","코웰패션","120816798720","2280","52989824","56156301","3166477","2024-09"
"056360","코위버","45919025280","4960","9257868","9796800","538932","2024-09"
"282880","코윈테크","151827184100","13900","10922819","11141807","218988","2024-09"
"121850","코이즈","27634348560","910","30367416","30614175","246759","2024-09"
"448710","코츠테크놀로지","98974513700","22300","4438319","5166069","727750","2024-09"
"126730","코칩","94828469460","11580","8188987","8503460","314473","2024-09"
"015710","코콤","77927314215","4695","16597937","17530500","932563","2024-09"
"052330","코텍","102715993290","8170","12572337","15574552","3002215","2024-09"
"322780","코퍼스코리아","37263697500","1010","36894750","37932613","1037863","2024-09"
"036420","콘텐트리중앙","173851468700","9100","19104557","19262308","157751","2024-09"
"200130","콜마비앤에이치","413459866400","14200","29116892","29415558","298666","2024-09"
"024720","콜마홀딩스","242474551130","7070","34296259","34296259","0","2024-09"
"031820","콤텍시스템","67425666562","557","121051466","121051466","0","2024-09"
"294570","쿠콘","136650292200","13400","10197783","10254685","56902","2024-09"
"192400","쿠쿠홀딩스","758312594000","24400","31078385","35562185","4483800","2024-09"
"284740","쿠쿠홈시스","498897955000","22250","22422380","22437330","14950","2024-09"
"317690","퀀타매트릭스","121219222630","7330","16537411","16537411","0","2024-09"
"078940","퀀타피아","151577916950","2855","53092090","53094278","2188","2024-09"
"227100","퀀텀온","20102547148","1282","15680614","15680614","0","2024-09"
"432720","퀄리타스반도체","138522243760","10030","13810792","13810792","0","2024-09"
"365270","큐라클","85602382560","6170","13873968","13873968","0","2024-09"
"348080","큐라티스","39496433370","937","42152010","42152010","0","2024-09"
"060280","큐렉소","280233731800","6820","41089990","41089990","0","2024-09"
"372320","큐로셀","419159782800","29700","14113124","14113124","0","2024-09"
"051780","큐로홀딩스","18463947248","136","135764318","136422450","658132","2024-09"
"115180","큐리언트","155624699240","4820","32287282","32292671","5389","2024-09"
"445680","큐리옥스바이오시스템즈","384712038200","23900","16096738","16096738","0","2024-09"
"182360","큐브엔터","181111229920","13040","13888898","14571557","682659","2024-09"
"405100","큐알티","168032081250","14250","11791725","12289301","497576","2024-09"
"066310","큐에스아이","61238965750","6850","8939995","9271621","331626","2024-09"
"016600","큐캐피탈","47294925962","271","174520022","178247112","3727090","2024-09"
"355390","크라우드웍스","48040795180","11380","4221511","4224606","3095","2024-09"
"264900","크라운제과","102497921570","8530","12016169","12523850","507681","2024-09"
"005740","크라운해태홀딩스","85577273250","5950","14382735","14847347","464612","2024-09"
"259960","크래프톤","15045784071000","331000","45455541","47900115","2444574","2024-09"
"096240","크레버스","134041795230","15890","8435607","11138180","2702573","2024-09"
"040350","크레오에스지","112999836585","745","151677633","152074086","396453","2024-09"
"110790","크리스에프앤씨","132659226350","6550","20253317","23430960","3177643","2024-09"
"045520","크린앤사이언스","31747230000","5190","6117000","6500000","383000","2024-09"
"036170","클라우드에어","51774256172","859","60272708","61365626","1092918","2024-09"
"214150","클래시스","3321136911300","50700","65505659","65505659","0","2024-09"
"466100","클로봇","213091863400","8900","23942906","23942906",,"자료 없음"
"352770","클리노믹스","24721508448","643","38447136","38886113","438977","2024-09"
"237880","클리오","389046630600","22200","17524623","18071353","546730","2024-09"
"139670","키네마스터","37979598900","2690","14118810","14118810","0","2024-09"
"020120","키다리스튜디오","144175816880","3890","37063192","37063766","574","2024-09"
"413600","키움제6호스팩","9724050000","2835","3430000","3430000","0","2024-09"
"433530","키움제7호스팩","10036725000","2445","4105000","4105000","0","2024-09"
"446840","키움제8호스팩","13729800000","2335","5880000","5880000","0","2024-09"
"039490","키움증권","3248081190600","134600","24131361","25526706","1395345","2024-09"
"054780","키이스트","86949729250","4450","19539265","19547793","8528","2024-09"
"219130","타이거일렉","120602939000","19100","6314290","6314290","0","2024-09"
"360070","탑머티리얼","283438737600","35400","8006744","8076743","69999","2024-09"
"065130","탑엔지니어링","60509264400","3900","15515196","17189982","1674786","2024-09"
"134580","탑코미디어","41256990100","1906","21645850","22025767","379917","2024-09"
"014580","태경비케이","125778936000","4560","27583100","27583100","0","2024-09"
"015890","태경산업","151697212500","5190","29228750","29228750","0","2024-09"
"006890","태경케미컬","122972804150","10850","11333899","11600000","266101","2024-09"
"023160","태광","319201766280","12340","25867242","26500000","632758","2024-09"
"003240","태광산업","548743412000","652000","841631","1113400","271769","2024-09"
"011280","태림포장","141120198050","2050","68839121","70805940","1966819","2024-09"
"323280","태성","738472878000","28600","25820730","25820730","0","2024-09"
"053620","태양","49995274680","6280","7961031","8600000","638969","2024-09"
"004100","태양금속","123294766100","3385","36423860","36700000","276140","2024-09"
"009410","태영건설","1276836442345","4435","287899987","287905337","5350","2024-09"
"044490","태웅","277102226850","13850","20007381","20007381","0","2024-09"
"124560","태웅로직스","107047168640","2960","36164584","38416584","2252000","2024-09"
"001420","태원물산","27425820180","3740","7333107","7600000","266893","2024-09"
"191420","테고사이언스","136031556340","16990","8006566","8108834","102268","2024-09"
"073640","테라사이언스","59577565530","654","91097195","95587404","4490209","2024-09"
"066700","테라젠이텍스","110258530655","3445","32005379","32474435","469056","2024-09"
"095610","테스","295569658100","16850","17541226","19768226","2227000","2024-09"
"055490","테이팩스","81561015000","17100","4769650","4769650","0","2024-09"
"064520","테크엘","47595961860","2130","22345522","22351062","5540","2024-09"
"089030","테크윙","1594025140400","44600","35740474","37353645","1613171","2024-09"
"054450","텔레칩스","189535040640","12840","14761296","15144233","382937","2024-09"
"078000","텔코웨어","51536749940","9980","5164003","9240077","4076074","2024-09"
"200230","텔콘RF제약","73232393115","609","120250235","120250235","0","2024-09"
"214420","토니모리","175923511360","7360","23902651","24054799","152148","2024-09"
"393210","토마토시스템","99511543850","6470","15380455","15614544","234089","2024-09"
"215480","토박스코리아","23924460240","2670","8960472","9400000","439528","2024-09"
"051360","토비스","318446345100","20850","15273206","16167058","893852","2024-09"
"045340","토탈소프트","46641318000","5450","8558040","8558040","0","2024-09"
"108230","톱텍","192015548760","5270","36435588","38023245","1587657","2024-09"
"079970","투비소프트","9428530461","1127","8366043","9290500","924457","2024-09"
"199800","툴젠","449648964800","56600","7944328","7946828","2500","2024-09"
"417790","트루엔","94529570730","9030","10468391","10999650","531259","2024-09"
"290090","트윔","59722462330","8530","7001461","7432268","430807","2024-09"
"026150","특수건설","109664568750","6250","17546331","17546331","0","2024-09"
"464280","티디에스팜","76841905000","14530","5288500","5530000","241500","2024-09"
"322180","티라유텍","94326202250","5710","16519475","16519475","0","2024-09"
"117730","티로보틱스","132529355800","7430","17837060","17837060","0","2024-09"
"033830","티비씨","80260766850","849","94535650","100000000","5464350","2024-09"
"057680","티사이언티픽","75380914058","1058","71248501","71248501","0","2024-09"
"204610","티쓰리","78421602294","1338","58611063","63851720","5240657","2024-09"
"064760","티씨케이","998212500000","85500","11675000","11675000","0","2024-09"
"246710","티앤알바이오팹","158153717520","7340","21546828","21546828","0","2024-09"
"340570","티앤엘","544860742500","67500","8072011","8128000","55989","2024-09"
"043220","티에스넥스젠","73387669140","516","142224165","142224165","0","2024-09"
"277880","티에스아이","122577858560","6080","20160832","20160832","0","2024-09"
"131290","티에스이","547904416000","50800","10785520","11061429","275909","2024-09"
"019180","티에이치엔","57150000000","3175","18000000","18000000","0","2024-09"
"425420","티에프이","177695810000","15710","11311000","11381000","70000","2024-09"
"131100","티엔엔터테인먼트","44028315410","1570","28043513","28048252","4739","2024-09"
"356860","티엘비","134862294000","13800","9772630","9832630","60000","2024-09"
"062860","티엘아이","42843237000","5800","7386765","9872720","2485955","2024-09"
"363280","티와이홀딩스","123916572500","3500","35404735","50429268","15024533","2024-09"
"321550","티움바이오","136633838250","5250","26025493","26025493","0","2024-09"
"091810","티웨이항공","750955811650","3490","215173585","215378976","205391","2024-09"
"004870","티웨이홀딩스","100277692696","892","112418938","112419447","509","2024-09"
"425040","티이엠씨","195666110250","9250","21153093","21316062","162969","2024-09"
"241790","티이엠씨씨엔에스","55755128380","5740","9713437","10002634","289197","2024-09"
"104480","티케이케미칼","126344653260","1390","90895434","90895434","0","2024-09"
"081150","티플랙스","75232046200","3100","24268402","24268402","0","2024-09"
"130740","티피씨글로벌","22722508185","2015","11276679","11276679","0","2024-09"
"084730","팅크웨어","110975215140","10590","10479246","11109424","630178","2024-09"
"440110","파두","1063895817600","21600","49254436","49334436","80000","2024-09"
"034230","파라다이스","913692238500","10580","86360325","91771623","5411298","2024-09"
"033540","파라텍","51492659616","1376","37421991","37751063","329072","2024-09"
"388870","파로스아이바이오","113792465600","8800","12930962","12930962","0","2024-09"
"043200","파루","23153173528","554","41792732","41804315","11583","2024-09"
"214450","파마리서치","2340303493000","225500","10378286","10498238","119952","2024-09"
"208340","파멥신","233760977175","2915","80192445","80201108","8663","2024-09"
"005690","파미셀","304220350980","5070","60004014","60016964","12950","2024-09"
"177830","파버나인","37481462550","3150","11898877","14288753","2389876","2024-09"
"037070","파세코","116038394850","5810","19972185","20000000","27815","2024-09"
"150900","파수","55164305680","4880","11304161","11685422","381261","2024-09"
"037030","파워넷","55120819320","2520","21873341","21878974","5633","2024-09"
"047310","파워로직스","184884312750","5050","36610755","36610755","0","2024-09"
"368770","파이버프로","139440869625","4265","32694225","32854225","160000","2024-09"
"170790","파이오링크","53641275270","8030","6680109","6856330","176221","2024-09"
"049120","파인디앤씨","54584632440","1170","46653532","46653532","0","2024-09"
"038950","파인디지털","29318406975","3575","8200953","10210765","2009812","2024-09"
"441270","파인엠텍","219248425290","5930","36972753","36987901","15148","2024-09"
"106240","파인테크닉스","16681326962","1051","15871862","15923057","51195","2024-09"
"131760","파인텍","34614971651","797","43431583","43431583","0","2024-09"
"065690","파커스","14277176487","1071","13330697","14049331","718634","2024-09"
"140860","파크시스템스","1484736708000","214000","6938022","6983609","45587","2024-09"
"091700","파트론","362309987450","7130","50814865","58918214","8103349","2024-09"
"032800","판타지오","37249153971","163","228522417","229785294","1262877","2024-09"
"318010","팜스빌","40340775960","5220","7728118","7929338","201220","2024-09"
"036580","팜스코","74590120680","2130","35018836","36727943","1709107","2024-09"
"027710","팜스토리","144225348344","1304","110602261","111416600","814339","2024-09"
"004720","팜젠사이언스","86330287400","4760","18136615","18178525","41910","2024-09"
"225590","패션플랫폼","22201166694","867","25606882","26636713","1029831","2024-09"
"054300","팬스타엔터프라이즈","32946178776","492","66963778","66985895","22117","2024-09"
"068050","팬엔터테인먼트","57329101480","2120","27042029","27694076","652047","2024-09"
"028670","팬오션","1900394615160","3555","534569512","534569512","0","2024-09"
"222110","팬젠","55140238780","4805","11475596","11475596","0","2024-09"
"271830","팸텍","63994535230","2230","28697101","29490202","793101","2024-09"
"010820","퍼스텍","155017530030","3190","48594837","48771938","177101","2024-09"
"016800","퍼시스","375855984000","42000","8948952","11500000","2551048","2024-09"
"263750","펄어비스","2376931167000","38700","61419410","64247855","2828445","2024-09"
"251970","펌텍코리아","459360201300","37050","12398386","12400000","1614","2024-09"
"001020","페이퍼코리아","142337185600","800","177921482","177983313","61831","2024-09"
"168360","펨트론","156043121720","7330","21288284","21288284","0","2024-09"
"087010","펩트론","1811338232000","88000","20583389","20657350","73961","2024-09"
"090080","평화산업","54847356741","999","54902259","54902259","0","2024-09"
"010770","평화홀딩스","39857421970","2770","14388961","14625466","236505","2024-09"
"064800","포니링크","169284021880","1343","126049160","127807298","1758138","2024-09"
"119500","포메탈","34356972800","2900","11847232","11847232","0","2024-09"
"389140","포바이포","62572974660","5670","11035798","11112735","76937","2024-09"
"105760","포스뱅크","63192699800","6680","9459985","9459985","0","2024-09"
"022100","포스코DX","4144754768700","27300","151822519","152034729","212210","2024-09"
"058430","포스코스틸리온","217158887500","36250","5990590","6000000","9410","2024-09"
"009520","포스코엠텍","670396899900","16100","41639559","41642703","3144","2024-09"
"047050","포스코인터내셔널","8914246670100","52300","170444487","175922788","5478301","2024-09"
"003670","포스코퓨처엠","17384216768000","224500","77435264","77463220","27956","2024-09"
"189690","포시에스","62412431730","2290","27254337","27321969","67632","2024-09"
"318020","포인트모바일","49915804860","4005","12463372","12662272","198900","2024-09"
"256630","포인트엔지니어링","72740018016","1278","56917072","57997072","1080000","2024-09"
"331380","포커스에이치엔에스","82774033880","3715","22281032","22725452","444420","2024-09"
"472850","폰드그룹","193369142460","5980","32335977","32343933","7956","2024-09"
"039980","폴라리스AI","170096928795","2385","71319467","72152777","833310","2024-09"
"041910","폴라리스AI파마","84216439000","6340","13283350","13501607","218257","2024-09"
"234100","폴라리스세원","68560648380","1260","54413213","54413213","0","2024-09"
"041020","폴라리스오피스","259846237390","5230","49683793","49725498","41705","2024-09"
"114630","폴라리스우노","39744229693","523","75992791","77757548","1764757","2024-09"
"290720","푸드나무","40341411230","3230","12489601","13403058","913457","2024-09"
"005670","푸드웰","50064044670","5310","9428257","10000000","571743","2024-09"
"094940","푸른기술","50591123200","6400","7904863","8361386","456523","2024-09"
"057880","푸른소나무","215672327790","8790","24536101","24580368","44267","2024-09"
"007330","푸른저축은행","103353818400","8820","11718120","15082800","3364680","2024-09"
"017810","풀무원","385222059750","10450","36863355","38120542","1257187","2024-09"
"093380","풍강","25696434960","2680","9588222","9879313","291091","2024-08"
"023900","풍국주정","127260000000","10100","12600000","12600000","0","2024-09"
"103140","풍산","1895610893200","69400","27314278","28024278","710000","2024-09"
"005810","풍산홀딩스","383004367600","27350","14003816","14417292","413476","2024-09"
"371950","풍원정밀","210404880000","10000","21040488","21040488","0","2024-09"
"370090","퓨런티어","125263817300","15310","8181830","8181830","0","2024-09"
"445180","퓨릿","111012024560","6620","16769188","16769188","0","2024-09"
"151910","퓨처코어","121645902080","640","190071722","190071722","0","2024-09"
"220100","퓨쳐켐","521487500800","23600","22096928","22102155","5227","2024-09"
"035200","프럼파스트","23658299860","2795","8464508","9730590","1266082","2024-09"
"334970","프레스티지바이오로직스","524891578860","6780","77417637","77417637","0","2024-09"
"321260","프로이천","61176755010","2170","28192053","28192084","31","2024-09"
"053610","프로텍","302850000000","33650","9000000","11000000","2000000","2024-09"
"303360","프로티아","36442518450","2830","12877215","12877215","0","2024-09"
"377220","프롬바이오","60724950000","2145","28310000","28310000","0","2024-09"
"335810","프리시젼바이오","39953969440","3440","11614526","11614526","0","2024-09"
"053160","프리엠스","70962216160","13240","5359684","6000000","640316","2024-09"
"405000","플라즈맵","45347631716","1739","26076844","26076844","0","2024-09"
"041590","플래스크","103917099150","789","131707350","131707350","0","2024-09"
"367000","플래티어","37476370375","4625","8102999","8388207","285208","2024-09"
"075130","플랜티넷","32462912070","2085","15569742","16622320","1052578","2024-09"
"009810","플레이그램","56194817450","370","151877885","151887500","9615","2024-09"
"237820","플레이디","81067524800","6320","12827140","12827140","0","2024-09"
"023770","플레이위드","37609657800","4290","8766820","8766820","0","2024-09"
"019570","플루토스","21839876528","376","58084778","58090042","5264","2024-09"
"300080","플리토","86025937250","15650","5496865","5501817","4952","2024-09"
"033790","피노","181622400000","8000","22702800","22822800","120000","2024-09"
"032580","피델릭스","50300769043","1519","33114397","33132064","17667","2024-09"
"051380","피씨디렉트","39619493240","2680","14783393","15340072","556679","2024-09"
"241820","피씨엘","53018082432","896","59171967","59171967","0","2024-09"
"237750","피앤씨테크","28357659000","4365","6496600","6496600","0","2024-09"
"460940","피앤에스미캐닉스","71706879200","11080","6471740","6471740","0","2024-09"
"319660","피에스케이","602507651200","20800","28966714","28966714","0","2024-09"
"031980","피에스케이홀딩스","1095369666000","50800","21562395","21562395","0","2024-09"
"002230","피에스텍","59337153450","3590","16528455","19370673","2842218","2024-09"
"043370","피에이치에이","193378808700","9900","19533213","21000000","1466787","2024-09"
"239890","피엔에이치테크","74418804950","7490","9935755","9935755","0","2024-09"
"347740","피엔케이피부임상연구센타","69749525265","2415","28881791","30010576","1128785","2024-09"
"137400","피엔티","1222809873600","52600","23247336","23743086","495750","2024-09"
"257370","피엔티엠에스","54300358580","4420","12285149","12504861","219712","2024-09"
"147760","피엠티","47336913750","4375","10819866","10819866","0","2024-09"
"128660","피제이메탈","80858982940","3260","24803369","24803369","0","2024-09"
"006140","피제이전자","75662850000","5090","14865000","15000000","135000","2024-09"
"376180","피코그램","57948590700","3150","18396378","18491378","95000","2024-09"
"304840","피플바이오","110626310680","5260","21031618","21089464","57846","2024-09"
"087600","픽셀플러스","45878973480","7080","6480081","8166558","1686477","2024-09"
"291810","핀텔","23056155360","2030","11357712","11357712","0","2024-09"
"378340","필에너지","361859994000","17000","21285882","21285882","0","2024-09"
"161580","필옵틱스","469427349000","20550","22843180","22843180","0","2024-09"
"347770","핌스","52228340970","2285","22857042","22857042","0","2024-09"
"163730","핑거","107450610610","11690","9191669","9365608","173939","2024-09"
"417180","핑거스토리","41113357155","2445","16815279","16816209","930","2024-09"
"446750","하나26호스팩","12843900000","2130","6030000","6030000","0","2024-09"
"448370","하나27호스팩","11970600000","2130","5620000","5620000","0","2024-09"
"454750","하나28호스팩","14764100000","2050","7202000","7202000","0","2024-09"
"454640","하나29호스팩","11477125000","2125","5401000","5401000","0","2024-09"
"469880","하나30호스팩","14938725000","2045","7305000","7305000","0","2024-09"
"469900","하나31호스팩","11602350000","2070","5605000","5605000","0","2024-09"
"475240","하나32호스팩","6992000000","2185","3200000","3200000","0","2024-09"
"475250","하나33호스팩","7899500000","2135","3700000","3700000","0","2024-09"
"406760","하나금융21호스팩","15412800000","2080","7410000","7410000","0","2024-09"
"418170","하나금융22호스팩","14063400000","2340","6010000","6010000","0","2024-09"
"435620","하나금융25호스팩","44740800000","10400","4302000","4302000","0","2024-09"
"086790","하나금융지주","16639331203800","59900","277785162","287240880","9455718","2024-09"
"299030","하나기술","226655698500","28350","7994910","7994910","0","2024-09"
"067310","하나마이크론","747519467520","11370","65744896","65744896","0","2024-09"
"166090","하나머티리얼즈","580741029200","29800","19487954","19777674","289720","2024-09"
"293480","하나제약","192716274040","11140","17299486","17772946","473460","2024-09"
"039130","하나투어","763653647600","49300","15489932","16039185","549253","2024-09"
"136480","하림","305288148250","2875","106187182","106209702","22520","2024-09"
"003380","하림지주","524237765590","5390","97261181","112005621","14744440","2024-09"
"450330","하스","63628393080","8120","7836009","7836009","0","2024-09"
"101670","하이드로리튬","78757991512","1577","49941656","51691656","1750000","2024-09"
"365590","하이딥","128419284590","890","144291331","144447309","155978","2024-09"
"149980","하이로닉","113459032750","6790","16709725","18594363","1884638","2024-09"
"013030","하이록코리아","285626434000","23600","12102815","12856050","753235","2024-09"
"352820","하이브","7698638993500","185500","41502097","41652097","150000","2024-09"
"126700","하이비젼시스템","220466816920","17320","12729031","14942112","2213081","2024-09"
"106080","하이소닉","77885077050","4950","15734359","15735465","1106","2024-09"
"071090","하이스틸","63073596875","3125","20183551","20191471","7920","2024-09"
"450050","하이제8호스팩","10629680000","2120","5014000","5014000","0","2024-09"
"160190","하이젠알앤엠","199678080000","7160","27888000","30888000","3000000","2024-09"
"221840","하이즈항공","34203326069","1829","18700561","18700561","0","2024-09"
"106190","하이텍팜","160552229800","15100","10632598","10633173","575","2024-09"
"019490","하이트론","91591393250","3050","30029965","30044269","14304","2024-09"
"000080","하이트진로","1455367852400","21200","68649427","70133611","1484184","2024-09"
"000140","하이트진로홀딩스","209604609630","9810","21366423","23206765","1840342","2024-09"
"065650","하이퍼코퍼레이션","130263625650","1223","106511550","106681728","170178","2024-09"
"066130","하츠","65546268060","5460","12004811","12800000","795189","2024-09"
"004590","한국가구","55200000000","3680","15000000","15000000","0","2024-09"
"036460","한국가스공사","3421197012800","39200","87275434","92313000","5037566","2024-09"
"039340","한국경제TV","113769665300","5350","21265358","23000000","1734642","2024-09"
"005430","한국공항","173400563700","56700","3058211","3166355","108144","2024-09"
"071050","한국금융지주","4066139352300","77100","52738513","55725992","2987479","2024-09"
"034950","한국기업평가","380512296300","85300","4460871","4540514","79643","2024-09"
"010040","한국내화","80973778070","2285","35437102","41067062","5629960","2024-09"
"025540","한국단자","787034500000","76300","10315000","10415000","100000","2024-09"
"222980","한국맥널티","41111216560","3785","10861616","11031483","169867","2024-09"
"010100","한국무브넥스","109469259900","3595","30450420","30450420","0","2024-09"
"256840","한국비엔씨","318931929600","4800","66444152","67912443","1468291","2024-09"
"219750","한국비티비","63245329550","967","65403650","65426885","23235","2024-09"
"004090","한국석유","198614942960","15760","12602471","12694120","91649","2024-09"
"025550","한국선재","63492619680","2870","22122864","23300000","1177136","2024-09"
"002200","한국수출포장","97936934295","2635","37167717","40000000","2832283","2024-09"
"002960","한국쉘석유","421200000000","324000","1300000","1300000","0","2024-09"
"017890","한국알콜","186460172580","9060","20580593","21605760","1025167","2024-09"
"000240","한국앤컴퍼니","1586528912000","16750","94718144","94935240","217096","2024-09"
"080720","한국유니온제약","15410411825","2725","5655197","7912828","2257631","2024-09"
"123890","한국자산신탁","357311800600","2920","122367055","123977752","1610697","2024-09"
"015760","한국전력","14829370178700","23100","641964077","641964077","0","2024-09"
"063570","한국전자금융","156201395200","5150","30330368","34147728","3817360","2024-09"
"041460","한국전자인증","64636985625","3415","18927375","19000000","72625","2024-09"
"006200","한국전자홀딩스","32541068154","742","43855887","46803136","2947249","2024-09"
"101680","한국정밀기계","20124631755","2395","8402769","8404000","1231","2024-09"
"039740","한국정보공학","21930315795","2735","8018397","8018397","0","2024-09"
"053300","한국정보인증","166137222935","4045","41072243","42441361","1369118","2024-09"
"025770","한국정보통신","289235537100","8100","35708091","37444271","1736180","2024-09"
"458610","한국제12호스팩","9200250000","2175","4230000","4230000","0","2024-09"
"464440","한국제13호스팩","9331200000","2160","4320000","4320000","0","2024-09"
"477530","한국제14호스팩","10942750000","2275","4810000","4810000","0","2024-09"
"479880","한국제15호스팩","14049150000","2045","6870000","6870000","0","2024-09"
"027970","한국제지","181784088320","956","190150720","190178237","27517","2024-09"
"023350","한국종합기술","46245402175","4445","10403915","10950000","546085","2024-09"
"025890","한국주강","22066339680","1980","11144616","11309259","164643","2024-09"
"000970","한국주철관","137455098300","6390","21510970","22800500","1289530","2024-09"
"104700","한국철강","305875657560","8920","34290993","42450000","8159007","2024-09"
"062970","한국첨단소재","19509844593","1977","9868409","9868409","0","2024-09"
"017960","한국카본","536473431400","10900","49217746","51908452","2690706","2024-09"
"023760","한국캐피탈","174821981425","559","312740575","315609576","2869001","2024-09"
"054040","한국컴퓨터","71830685160","5310","13527436","16071290","2543854","2024-09"
"161890","한국콜마","1673599959300","70900","23605077","23605077","0","2024-09"
"021650","한국큐빅","40625222500","2500","16250089","16350563","100474","2024-09"
"161390","한국타이어앤테크놀로지","4306202980900","35300","121988753","123875069","1886316","2024-09"
"034830","한국토지신탁","224711453589","1043","215447223","252489230","37042007","2024-09"
"007280","한국특강","94017378806","1546","60813311","60813311","0","2024-09"
"032300","한국파마","224132705550","20550","10906701","10906701","0","2024-09"
"037230","한국팩키지","59362251384","1992","29800327","29800327","0","2024-09"
"047810","한국항공우주","5702293759500","58500","97475107","97475107","0","2024-09"
"123690","한국화장품","105721327180","6580","16067071","16068000","929","2024-09"
"003350","한국화장품제조","268250518000","74000","3625007","4532000","906993","2024-09"
"030520","한글과컴퓨터","459000692850","19070","24069255","24179744","110489","2024-09"
"052600","한네트","46832985000","4050","11563700","11563700","0","2024-09"
"011500","한농화성","266574768600","17430","15294020","15637042","343022","2024-09"
"002390","한독","190900202710","13870","13763533","13763533","0","2024-09"
"256150","한독크린텍","52314521280","6720","7784899","8395000","610101","2024-09"
"092460","한라IMS","104926425600","6420","16343680","17109680","766000","2024-09"
"053690","한미글로벌","148301199000","14580","10171550","10957550","786000","2024-09"
"042700","한미반도체","8802228984000","92000","95676402","96993634","1317232","2024-09"
"008930","한미사이언스","3233329461500","47750","67713706","68391550","677844","2024-09"
"128940","한미약품","4064008587000","320500","12680214","12810991","130777","2024-09"
"452190","한빛레이저","93569991560","4040","23160889","23162757","1868","2024-09"
"047080","한빛소프트","35719378918","1439","24822362","24822362","0","2024-09"
"009240","한샘","883137130400","53200","16600322","23533928","6933606","2024-09"
"452280","한선엔지니어링","143671125000","8450","17002500","17002500","0","2024-09"
"020000","한섬","334611566520","15580","21476994","23398500","1921506","2024-09"
"003680","한성기업","29087483250","5150","5648055","6209515","561460","2024-09"
"066980","한성크린텍","103864500000","2000","51932250","51935125","2875","2024-09"
"105630","한세실업","606101892210","15390","39382839","40000000","617161","2024-09"
"069640","한세엠케이","45024223665","1641","27437065","30106502","2669437","2024-09"
"016450","한세예스24홀딩스","194240228015","4945","39280127","40000000","719873","2024-09"
"010420","한솔PNS","21620127660","1055","20493012","20493012","0","2024-09"
"009180","한솔로지스틱스","63617042840","2260","28149134","28155825","6691","2024-09"
"114810","한솔아이원스","187080304710","6770","27633723","29113174","1479451","2024-09"
"070590","한솔인티큐브","15247323216","1116","13662476","13879521","217045","2024-09"
"213500","한솔제지","222789253160","9370","23776868","23800576","23708","2024-09"
"014680","한솔케미칼","1433902167500","126500","11335195","11335195","0","2024-09"
"004710","한솔테크닉스","136980374120","4360","31417517","32109878","692361","2024-09"
"004150","한솔홀딩스","94771489890","2310","41026619","42008577","981958","2024-09"
"025750","한솔홈데코","55751083108","692","80565149","80565149","0","2024-09"
"226440","한송네오텍","100580954580","1530","65739186","65739186","0","2024-09"
"042520","한스바이오메드","107532186120","8280","12986979","13526367","539388","2024-09"
"004960","한신공영","78102238500","6750","11570702","11570702","0","2024-09"
"011700","한신기계","108521336605","3355","32346151","32446151","100000","2024-09"
"430690","한싹","51098975760","4690","10895304","10895327","23","2024-09"
"078350","한양디지텍","177161027580","11940","14837607","15244382","406775","2024-09"
"045100","한양이엔지","286067213280","17040","16787982","18000000","1212018","2024-09"
"001750","한양증권","157197394900","12350","12728534","12728534","0","2024-09"
"018880","한온시스템","2118663667100","3970","533668430","533800000","131570","2024-09"
"009420","한올바이오파마","2241394376000","44200","50710280","52240638","1530358","2024-09"
"214870","한울BnC","64715071880","6920","9351889","9359221","7332","2024-09"
"320000","한울반도체","75087697755","2685","27965623","27965627","4","2024-09"
"091440","한울소재과학","71524629100","5090","14051990","14606671","554681","2024-09"
"014130","한익스프레스","41300000000","3500","11800000","12000000","200000","2024-09"
"024740","한일단조","104473555440","3345","31232752","31532546","299794","2024-09"
"005860","한일사료","161555108500","4100","39403685","39403685","0","2024-09"
"300720","한일시멘트","982821252600","14190","69261540","69261540","0","2024-09"
"002220","한일철강","49072786100","2015","24353740","26697460","2343720","2024-09"
"006390","한일현대시멘트","266335320160","13780","19327672","19327672","0","2024-09"
"003300","한일홀딩스","430406958240","13960","30831444","30832884","1440","2024-09"
"007770","한일화학","40786200000","11620","3510000","3510000","0","2024-09"
"051600","한전KPS","2018250000000","44850","45000000","45000000","0","2024-09"
"052690","한전기술","2617393144000","68800","38043505","38220000","176495","2024-09"
"130660","한전산업","414346000000","12710","32600000","32600000","0","2024-09"
"198940","한주라이트메탈","37907055352","974","38918948","38922978","4030","2024-09"
"058450","한주에이알티","32271464490","2235","14439134","14452469","13335","2024-09"
"107640","한중엔시에스","355273156200","39700","8948946","8948946","0","2024-09"
"002320","한진","277375081590","19170","14469227","14947628","478401","2024-09"
"003480","한진중공업홀딩스","90791473920","3480","26089504","29529812","3440308","2024-09"
"180640","한진칼","5610861419400","84600","66322239","66762279","440040","2024-09"
"005110","한창","22551214950","1254","17983425","18606407","622982","2024-09"
"079170","한창산업","42599539280","8240","5169847","5200000","30153","2024-09"
"009460","한창제지","42781587462","717","59667486","59667486","0","2024-09"
"372910","한컴라이프케어","113880180690","4115","27674406","27674406","0","2024-09"
"054920","한컴위드","63564856215","2555","24878613","28217081","3338468","2024-09"
"457370","한켐","103630235390","12910","8027129","8027134","5","2024-09"
"002680","한탑","21835826496","704","31016799","32316799","1300000","2024-09"
"000880","한화","1945997697600","28050","69376032","74958735","5582703","2024-09"
"452260","한화갤러리아","248809962036","1284","193777229","193859610","82381","2024-09"
"088350","한화생명","2224115140000","2960","751390250","868530000","117139750","2024-09"
"000370","한화손해보험","553821840540","4790","115620426","116738915","1118489","2024-09"
"009830","한화솔루션","3632520584550","21450","169348279","171892536","2544257","2024-09"
"272210","한화시스템","3414496945860","18260","186993261","188919389","1926128","2024-09"
"012450","한화에어로스페이스","16731689664000","368000","45466548","45581161","114613","2024-09"
"082740","한화엔진","1190482384450","14270","83425535","83447142","21607","2024-09"
"042660","한화오션","8196124752250","26750","306397187","306413394","16207","2024-09"
"489790","한화인더스트리얼솔루션즈","2130970026600","42300","50377542","50488390","110848","2024-09"
"003530","한화투자증권","763517285160","3570","213870388","214547775","677387","2024-09"
"430460","한화플러스제3호스팩","12698400000","2145","5920000","5920000","0","2024-09"
"455310","한화플러스제4호스팩","10600700000","2095","5060000","5060000","0","2024-09"
"195870","해성디에스","455600000000","26800","17000000","17000000","0","2024-09"
"034810","해성산업","198548604000","6700","29634120","32556857","2922737","2024-09"
"059270","해성에어로보틱스","63836778270","5730","11140799","11140799","0","2024-09"
"076610","해성옵틱스","29208886413","1149","25421137","25453198","32061","2024-09"
"101530","해태제과식품","156984559040","5920","26517662","29116822","2599160","2024-09"
"220180","핸디소프트","59776640000","3080","19408000","19408000","0","2024-09"
"143210","핸즈코퍼레이션","40838039500","1900","21493705","21875747","382042","2024-09"
"214180","헥토이노베이션","153595318580","12410","12376738","13257185","880447","2024-09"
"234340","헥토파이낸셜","136948041920","16480","8309954","9453000","1143046","2024-09"
"084990","헬릭스미스","168301375640","3655","46046888","46092797","45909","2024-09"
"187660","현대ADM","75304427240","3560","21152929","21836250","683321","2024-09"
"000720","현대건설","3106825843500","27900","111355765","111355765","0","2024-09"
"170030","현대공업","79937330590","5330","14997623","15340000","342377","2024-09"
"453340","현대그린푸드","395036326950","11670","33850585","33880914","30329","2024-09"
"086280","현대글로비스","9157500000000","122100","75000000","75000000","0","2024-09"
"064350","현대로템","6810479083200","62400","109142293","109142293","0","2024-09"
"079430","현대리바트","160511331960","7980","20114202","20535282","421080","2024-09"
"012330","현대모비스","22457156428500","249500","90008643","92995094","2986451","2024-09"
"319400","현대무벡스","359702966660","3085","116597396","117741058","1143662","2024-09"
"048410","현대바이오","688874789600","17300","39819352","39821608","2256","2024-09"
"052260","현대바이오랜드","154500000000","5150","30000000","30000000","0","2024-09"
"069960","현대백화점","1029379260600","47100","21855186","23402441","1547255","2024-09"
"004560","현대비앤지스틸","200548186300","13300","15078811","15078811","0","2024-09"
"016790","현대사료","187340898626","994","188471729","188471729","0","2024-09"
"004310","현대약품","101537186730","3885","26135698","32000000","5864302","2024-08"
"041440","현대에버다임","155579728640","8720","17841712","17915944","74232","2024-09"
"039010","현대에이치티","48167800000","6200","7769000","8625000","856000","2024-09"
"017800","현대엘리베이","1707769432600","47300","36105062","39092385","2987323","2024-09"
"307950","현대오토에버","3704862971600","135100","27423116","27423982","866","2024-09"
"011210","현대위아","1111128317100","41700","26645763","27195083","549320","2024-09"
"090850","현대이지웰","132742157990","5590","23746361","23746361","0","2024-09"
"004020","현대제철","3334684483650","25350","131545739","133445785","1900046","2024-09"
"005440","현대지에프홀딩스","699230789985","4485","155904301","155904301","0","2024-09"
"005380","현대차","43824714415000","215000","203835881","209416191","5580310","2024-09"
"001500","현대차증권","278436294360","8780","31712562","31712562","0","2024-09"
"011760","현대코퍼레이션","231811643800","19300","12010966","13228966","1218000","2024-09"
"227840","현대코퍼레이션홀딩스","92363209470","10470","8821701","9100836","279135","2024-09"
"126560","현대퓨처넷","431801151600","3920","110153355","110202945","49590","2024-09"
"001450","현대해상","2379880075000","30350","78414500","89400000","10985500","2024-09"
"057050","현대홈쇼핑","546057675000","47700","11447750","12000000","552250","2024-09"
"460930","현대힘스","352353635160","9960","35376871","35376871","0","2024-09"
"092300","현우산업","50409857695","2755","18297589","18672816","375227","2024-09"
"138360","협진","38653556800","800","48316946","48348248","31302","2024-09"
"011080","형지I&C","15782145943","619","25496197","25503364","7167","2024-09"
"093240","형지엘리트","44864384725","1325","33859913","34164255","304342","2024-09"
"003010","혜인","54064064690","5030","10748323","12712747","1964424","2024-09"
"111110","호전실업","78263852000","8500","9207512","9749984","542472","2024-09"
"008770","호텔신라","1655245196600","44600","37113121","39248121","2135000","2024-09"
"060560","홈센타홀딩스","103075286496","812","126940008","127669525","729517","2024-09"
"064240","홈캐스트","92430404050","2690","34360745","35038012","677267","2024-09"
"039610","화성밸브","98690592000","9480","10410400","10410400","0","2024-09"
"378850","화승알앤에이","72449848590","3815","18990786","18993623","2837","2024-09"
"241590","화승엔터프라이즈","557421339200","9200","60589276","60589276","0","2024-09"
"006060","화승인더","210734715180","4260","49468243","55320000","5851757","2024-09"
"013520","화승코퍼레이션","83970312622","1891","44405242","50051252","5646010","2024-09"
"010690","화신","306828734030","8830","34748441","34920410","171969","2024-09"
"126640","화신정공","47009975310","1341","35055910","36373887","1317977","2024-09"
"133820","화인베스틸","26510461480","860","30826118","30826118","0","2024-09"
"127980","화인써키트","80983096560","6840","11839634","11840684","1050","2024-09"
"061250","화일약품","102712884456","1378","74537652","76877652","2340000","2024-09"
"010660","화천기계","64130000000","2915","22000000","22000000","0","2024-09"
"000850","화천기공","59510000000","27050","2200000","2200000","0","2024-09"
"016580","환인제약","206105445000","13500","15267070","18600070","3333000","2024-09"
"032560","황금에스티","89870656780","5290","16988782","17000000","11218","2024-09"
"004800","효성","832572535200","49800","16718324","16740407","22083","2024-09"
"094280","효성ITX","138421097100","12540","11038365","11558200","519835","2024-09"
"097870","효성오앤비","48602400000","6160","7890000","8490000","600000","2024-09"
"298040","효성중공업","3734008141000","401000","9311741","9324548","12807","2024-09"
"298020","효성티앤씨","1331390365000","308500","4315690","4327682","11992","2024-09"
"298000","효성화학","151179200000","40000","3779480","3791811","12331","2024-09"
"093370","후성","672490329720","6270","107255236","107255330","94","2024-09"
"081660","휠라홀딩스","2374923889800","39900","59521902","60095839","573937","2024-09"
"290270","휴네시온","34267130705","3695","9273919","9607672","333753","2024-09"
"005870","휴니드","104331205300","7970","13090490","14116015","1025525","2024-09"
"353190","휴럼","31068854601","789","39377509","39378420","911","2024-09"
"192410","휴림네트웍스","35053729700","2465","14220580","14235530","14950","2024-09"
"090710","휴림로봇","133464064944","1218","109576408","109623165","46757","2024-09"
"078590","휴림에이텍","30823192708","574","53698942","54210339","511397","2024-09"
"205470","휴마시스","220310526480","1947","113153840","129375009","16221169","2024-09"
"115160","휴맥스","74341333252","1724","43121423","43970124","848701","2024-09"
"028080","휴맥스홀딩스","32590403130","2985","10918058","12577506","1659448","2024-09"
"175140","휴먼테크놀로지","94236978960","4380","21515292","21515292","0","2024-09"
"200670","휴메딕스","315446801400","30600","10308719","11229930","921211","2024-09"
"079980","휴비스","88035106000","2675","32910320","34500000","1589680","2024-09"
"065510","휴비츠","98227391850","9030","10877895","12159371","1281476","2024-09"
"215090","휴센텍","149904424845","1505","99604269","99649272","45003","2024-09"
"005010","휴스틸","225033240375","4005","56188075","56188075","0","2024-09"
"263920","휴엠앤씨","50026036680","1020","49045134","49045134","0","2024-09"
"243070","휴온스","324794305000","27500","11810702","11979665","168963","2024-09"
"084110","휴온스글로벌","419681908500","34500","12164693","12621492","456799","2024-09"
"145020","휴젤","3002787606000","273000","10999222","12604033","1604811","2024-09"
"024060","흥구석유","236142868080","16240","14540817","15000000","459183","2024-09"
"010240","흥국","53969643000","4875","11070696","12322696","1252000","2024-09"
"189980","흥국에프엔비","70963414998","1834","38693247","40137827","1444580","2024-09"
"000540","흥국화재","218103779775","3395","64242645","64242645","0","2024-09"
"003280","흥아해운","456503199800","1900","240264842","240424899","160057","2024-09"
"037440","희림","59903347400","4745","12624520","13922475","1297955","2024-09"
"238490","힘스","49339233300","4445","11099940","11312236","212296","2024-09"