종목코드,종목명,자기주식 제외 시가총액(A*B),종가,자기주식 제외 발행주식수(B=C-D),총발행주식수(C),자기주식수(D),자기주식수 반영시점
"060310","3S","105489785730","2065","51084642","51084642","0","2024-09"
"095570","AJ네트웍스","217042592500","4850","44751050","45252759","501709","2024-09"
"006840","AK홀딩스","172070079050","13190","13045495","13247561","202066","2024-09"
"054620","APS","108289886240","5960","18169444","19894221","1724777","2024-09"
"265520","AP시스템","276370465600","18400","15020134","15281421","261287","2024-09"
"211270","AP위성","151013838210","10610","14233161","15082304","849143","2024-09"
"109960","AP헬스케어","61737794179","541","114117919","114153169","35250","2024-09"
"139050","BF랩스","24234697905","2805","8639821","8644551","4730","2024-09"
"027410","BGF","345030101430","3605","95708766","95716791","8025","2024-09"
"282330","BGF리테일","1941711686000","112400","17275015","17283906","8891","2024-09"
"126600","BGF에코머티리얼즈","216734700000","3500","61924200","62766899","842699","2024-09"
"138930","BNK금융지주","3081952463920","9680","318383519","320436727","2053208","2024-09"
"001460","BYC","205709156500","32950","6243070","6246150","3080","2024-09"
"013720","CBI","50365935120","1130","44571624","44628136","56512","2024-09"
"083790","CG인바이츠","172627438590","2245","76894182","76894182","0","2024-09"
"001040","CJ","3022429423500","111700","27058455","29176998","2118543","2024-09"
"079160","CJ CGV","938838617010","5670","165580003","165580003","0","2024-09"
"035760","CJ ENM","1299747111300","62700","20729619","21929154","1199535","2024-09"
"311690","CJ 바이오사이언스","111445899460","12230","9112502","9112502","0","2024-09"
"000120","CJ대한통운","1757165864900","88100","19945129","22812344","2867215","2024-09"
"011150","CJ씨푸드","114439512005","3185","35930773","35930773","0","2024-09"
"097950","CJ제일제당","4137171438500","281500","14696879","15054186","357307","2024-09"
"051500","CJ프레시웨이","221761226480","18680","11871586","11871586","0","2024-09"
"058820","CMG제약","316674316320","2280","138892244","138892244","0","2024-09"
"023460","CNH","9689781066","294","32958439","37200000","4241561","2024-09"
"056730","CNT85","55701358400","800","69626698","74111186","4484488","2024-09"
"000480","CR홀딩스","236400042960","5730","41256552","46890490","5633938","2024-09"
"065770","CS","20498153280","1056","19411130","19411130","0","2024-09"
"083660","CSA 코스믹","50237634912","848","59242494","61247181","2004687","2024-09"
"000590","CS홀딩스","72364373000","69500","1041214","1154482","113268","2024-09"
"012030","DB","305457822267","1599","191030533","201173933","10143400","2024-09"
"456440","DB금융스팩11호","12065050000","2270","5315000","5315000","0","2024-09"
"477760","DB금융스팩12호","12088800000","2070","5840000","5840000","0","2024-09"
"016610","DB금융투자","226868266730","5570","40730389","42446389","1716000","2024-09"
"005830","DB손해보험","6796920690800","113200","60043469","70800000","10756531","2024-09"
"000990","DB하이텍","1671995143800","40200","41591919","44398588","2806669","2024-09"
"139130","DGB금융지주","1351109795840","8120","166392832","169145833","2753001","2024-09"
"099520","DGI","58000622016","1284","45171824","45281824","110000","2024-09"
"060900","DGP","30279052012","1199","25253588","25258229","4641","2024-09"
"290120","DH오토리드","42511478120","2740","15515138","15515138","0","2024-09"
"025440","DH오토웨어","33397626955","217","153906115","153906120","5","2024-09"
"001530","DI동일","763210268600","39400","19370819","25215672","5844853","2024-09"
"000210","DL","881183606700","42100","20930727","20955884","25157","2024-09"
"375500","DL이앤씨","1234597072800","32100","38460968","38693623","232655","2024-09"
"068790","DMS","132234643520","5620","23529296","24573061","1043765","2024-09"
"007340","DN오토모티브","966402981150","18670","51762345","60564965","8802620","2024-09"
"004840","DRB동일","88941959860","4615","19272364","19930000","657636","2024-09"
"241520","DSC인베스트먼트","74916312000","2865","26148800","27496125","1347325","2024-09"
"155660","DSR","64160000000","4010","16000000","16000000","0","2024-09"
"069730","DSR제강","53208000000","3695","14400000","14400000","0","2024-09"
"017860","DS단석","413228982000","70500","5861404","5861404","0","2024-09"
"180400","DXVX","130921731360","2660","49218696","49219432","736","2024-09"
"017940","E1","433053149900","74900","5781751","6860000","1078249","2024-09"
"245620","EDGC","57441040175","415","138412145","138493951","81806","2024-09"
"037370","EG","61754799520","7160","8624972","8624972","0","2024-09"
"050120","ES큐브","23587022427","1761","13394107","13564086","169979","2024-09"
"383220","F&F","2288133776500","60500","37820393","38307075","486682","2024-09"
"007700","F&F홀딩스","531350544800","13600","39069893","39114367","44474","2024-09"
"214270","FSN","66428532972","1998","33247514","33250463","2949","2024-09"
"130500","GH신소재","46325930105","3185","14545033","14545052","19","2024-09"
"114090","GKL","682886596800","11040","61855670","61855670","0","2024-09"
"078930","GS","3869097366750","41650","92895495","92915378","19883","2024-09"
"083450","GST","302266737500","16250","18601030","18618260","17230","2024-09"
"006360","GS건설","1614586782900","19020","84888895","85581490","692595","2024-09"
"001250","GS글로벌","286670826950","3475","82495202","82533764","38562","2024-09"
"007070","GS리테일","2187719114400","21150","103438256","104717922","1279666","2024-09"
"297890","HB솔루션","315237339340","4310","73140914","73140914","0","2024-09"
"440290","HB인베스트먼트","53238167640","1964","27107010","27107010","0","2024-09"
"078150","HB테크놀러지","229689187530","2585","88854618","92715916","3861298","2024-09"
"012630","HDC","565350141800","11300","50030986","59741721","9710735","2024-09"
"039570","HDC랩스","183105593410","7970","22974353","25957601","2983248","2024-09"
"089470","HDC현대EP","104197849260","4020","25919863","31900000","5980137","2024-09"
"294870","HDC현대산업개발","1437392992000","22400","64169330","65907330","1738000","2024-09"
"009540","HD한국조선해양","13944925036000","197200","70714630","70773116","58486","2024-09"
"267250","HD현대","5759477045000","81500","70668430","78993085","8324655","2024-09"
"267270","HD현대건설기계","973164573900","55100","17661789","18305586","643797","2024-09"
"443060","HD현대마린솔루션","5365115000000","120700","44450000","44450000","0","2024-09"
"071970","HD현대마린엔진","715655388700","21100","33917317","33917339","22","2024-09"
"010620","HD현대미포","4375307490600","109700","39884298","39942149","57851","2024-09"
"322000","HD현대에너지솔루션","263760000000","23550","11200000","11200000","0","2024-09"
"042670","HD현대인프라코어","1486802767040","7720","192591032","192655867","64835","2024-09"
"267260","HD현대일렉트릭","11031763776000","306500","35992704","36047135","54431","2024-09"
"329180","HD현대중공업","17506058475200","197200","88773116","88773116","0","2024-09"
"097230","HJ중공업","207754508300","2495","83268340","83274281","5941","2024-09"
"195940","HK이노엔","1371166724400","48400","28329891","28329891","0","2024-09"
"014790","HL D&I","96539432550","2550","37858601","37858601","0","2024-09"
"028300","HLB","9121723755200","69700","130871216","131127236","256020","2024-09"
"003580","HLB글로벌","200856182130","4230","47483731","47489591","5860","2024-09"
"278650","HLB바이오스텝","178915484250","2125","84195522","86730589","2535067","2024-09"
"067630","HLB생명과학","1089991051520","9190","118606208","118676128","69920","2024-09"
"024850","HLB이노베이션","276850405540","3035","91219244","91226268","7024","2024-09"
"047920","HLB제약","663017761050","20850","31799413","31799994","581","2024-09"
"115450","HLB테라퓨틱스","646404599700","8100","79803037","80139933","336896","2024-09"
"046210","HLB파나진","125000583050","2950","42373079","42373079","0","2024-09"
"204320","HL만도","1805501264000","38450","46957120","46957120","0","2024-09"
"060980","HL홀딩스","337665311550","35550","9498321","10169410","671089","2024-09"
"011200","HMM","13070739205200","17450","749039496","749039496","0","2024-09"
"403870","HPSP","2638708391150","32950","80082197","82934144","2851947","2024-09"
"036640","HRS","85022989800","5320","15981765","16354800","373035","2024-09"
"035000","HS애드","104539303800","6450","16207644","16567409","359765","2024-09"
"002460","HS화성","86412975770","9130","9464729","10150000","685271","2024-09"
"487570","HS효성","153252486450","41350","3706227","3725927","19700","2024-09"
"298050","HS효성첨단소재","1192961874000","267000","4468022","4479948","11926","2024-09"
"439730","IBKS제20호스팩","9417350000","2185","4310000","4310000","0","2024-09"
"442770","IBKS제21호스팩","9093600000","2160","4210000","4210000","0","2024-09"
"448760","IBKS제22호스팩","9590950000","2165","4430000","4430000","0","2024-09"
"467930","IBKS제23호스팩","9157950000","2165","4230000","4230000","0","2024-09"
"469480","IBKS제24호스팩","9263700000","2190","4230000","4230000","0","2024-09"
"003560","IHQ","61224765840","10760","5690034","5772083","82049","2024-09"
"095340","ISC","1252408550400","61200","20464192","21197058","732866","2024-09"
"175330","JB금융지주","3288796469700","17150","191766558","195083198","3316640","2024-09"
"234080","JW생명과학","173117313720","11180","15484554","15834554","350000","2024-09"
"067290","JW신약","86937625495","1715","50692493","50841502","149009","2024-09"
"001060","JW중외제약","682717434300","29700","22987119","23285930","298811","2024-09"
"096760","JW홀딩스","224500865960","3115","72070904","73924942","1854038","2024-09"
"035900","JYP Ent.","1693099314900","51100","33133059","35532492","2399433","2024-09"
"318000","KBG","51065249070","5870","8699361","8740223","40862","2024-09"
"024840","KBI메탈","106430337455","3055","34838081","34909199","71118","2024-09"
"105560","KB금융","35345110153000","93700","377215690","393528423","16312733","2024-09"
"024120","KB오토시스","43125000000","3750","11500000","11500000","0","2024-09"
"455250","KB제25호스팩","11365200000","2640","4305000","4305000","0","2024-09"
"458320","KB제26호스팩","12193575000","2215","5505000","5505000","0","2024-09"
"464680","KB제27호스팩","25706760000","1992","12905000","12905000","0","2024-09"
"476470","KB제28호스팩","11560500000","2100","5505000","5505000","0","2024-09"
"478390","KB제29호스팩","12782100000","2055","6220000","6220000","0","2024-09"
"486630","KB제30호스팩","10673100000","2010","5310000","5310000","0","2024-09"
"002380","KCC","2033428281500","276500","7354171","8886471","1532300","2024-09"
"021320","KCC건설","86363737880","4330","19945436","21400000","1454564","2024-09"
"344820","KCC글라스","629761653500","39500","15943333","15970512","27179","2024-09"
"036670","KCI","83821958000","7790","10760200","11270000","509800","2024-09"
"009070","KCTC","140856082500","4710","29905750","30000000","94250","2024-09"
"009440","KC그린홀딩스","18584983200","840","22124980","22434980","310000","2024-09"
"119650","KC코트렐","29988234177","471","63669287","63669287","0","2024-09"
"044180","KD","12447415006","466","26711191","26717799","6608","2024-09"
"092220","KEC","185304379143","923","200763141","200763141","0","2024-09"
"046440","KG모빌리언스","166221538560","4480","37103022","38825568","1722546","2024-09"
"003620","KG모빌리티","1013445950640","5160","196404254","196404254","0","2024-09"
"016380","KG스틸","648871243020","6510","99673002","100008897","335895","2024-09"
"151860","KG에코솔루션","229105629480","5460","41960738","49603002","7642264","2024-09"
"035600","KG이니시스","251278526720","9440","26618488","27904434","1285946","2024-09"
"001390","KG케미칼","281750099600","4115","68469040","68469040","0","2024-09"
"226360","KH 건설","60474013950","2555","23668890","23756732","87842","2024-09"
"111870","KH 미래물산","43747975260","8910","4909986","4930249","20263","2024-09"
"033180","KH 필룩스","125157155370","6630","18877399","18903579","26180","2024-09"
"060720","KH바텍","204287087340","9270","22037442","23677442","1640000","2024-09"
"015590","KIB플러그에너지","92659782531","391","236981541","236981544","3","2024-09"
"001940","KISCO홀딩스","241727826120","19140","12629458","16176380","3546922","2024-09"
"058400","KNN","102368173560","773","132429720","132429720","0","2024-09"
"025000","KPX케미칼","228726130100","48100","4755221","4840000","84779","2024-09"
"092230","KPX홀딩스","221327066700","56300","3931209","4224646","293437","2024-09"
"000040","KR모터스","32224995360","536","60121260","60132868","11608","2024-09"
"044450","KSS해운","212228735000","9400","22577525","23085880","508355","2024-09"
"101000","KS인더스트리","64483849600","2140","30132640","30149619","16979","2024-09"
"030200","KT","10521343170000","42800","245825775","252021685","6195910","2024-09"
"033780","KT&G","11794474622500","107500","109716043","130322497","20606454","2024-09"
"058850","KTcs","114385267935","3015","37938729","42685000","4746271","2024-09"
"058860","KTis","83438905950","2725","30619782","34802000","4182218","2024-09"
"122450","KX","152166570590","3665","41518846","45335964","3817118","2024-09"
"052900","KX하이텍","53964306960","993","54344720","55107517","762797","2024-09"
"376190","LB루셈","112545000000","4575","24600000","24600000","0","2024-09"
"061970","LB세미콘","173386984320","3960","43784592","43784592","0","2024-09"
"309960","LB인베스트먼트","92671635290","4030","22995443","23217239","221796","2024-09"
"093050","LF","423299001840","15290","27684696","29240000","1555304","2024-09"
"003550","LG","11762737911200","77800","151192004","157300993","6108989","2024-09"
"034220","LG디스플레이","5295000000000","10590","500000000","500000000","0","2024-09"
"051900","LG생활건강","5138254642500","350500","14659785","15618197","958412","2024-09"
"373220","LG에너지솔루션","92898000000000","397000","234000000","234000000","0","2024-09"
"032640","LG유플러스","4225212700160","9830","429828352","436611361","6783009","2024-09"
"011070","LG이노텍","4709236893000","199000","23664507","23667107","2600","2024-09"
"066570","LG전자","15897540668800","97600","162884638","163647814","763176","2024-09"
"037560","LG헬로비전","202523551975","2615","77446865","77446865","0","2024-09"
"051910","LG화학","23401361704500","331500","70592343","70592343","0","2024-09"
"079550","LIG넥스원","5546664620000","254500","21794360","22000000","205640","2024-09"
"225190","LK삼양","131945944000","2600","50748440","50748440","0","2024-09"
"006260","LS","3270765544800","119600","27347538","32200000","4852462","2024-09"
"010120","LS ELECTRIC","4661773231200","157200","29655046","30000000","344954","2024-09"
"000680","LS네트웍스","271082368160","3440","78803014","78803016","2","2024-09"
"060370","LS마린솔루션","470607583200","17200","27360906","28706781","1345875","2024-09"
"417200","LS머트리얼즈","1143329937100","16900","67652659","67652659","0","2024-09"
"229640","LS에코에너지","894663492000","29500","30327576","30624879","297303","2024-09"
"078020","LS증권","220524902500","4375","50405692","55481190","5075498","2024-09"
"108320","LX세미콘","1045794490000","64300","16264300","16264300","0","2024-09"
"001120","LX인터내셔널","1080835455100","30050","35967902","38760000","2792098","2024-09"
"108670","LX하우시스","380813777250","42550","8949795","8967670","17875","2024-09"
"383800","LX홀딩스","545079742350","7150","76234929","76280690","45761","2024-09"
"476080","M83","116541450000","14970","7785000","7785000","0","2024-09"
"086960","MDS테크","99969065676","1077","92821788","92821788","0","2024-09"
"023150","MH에탄올","37847963100","5900","6414909","7378526","963617","2024-09"
"038340","MIT","39924432729","1233","32379913","32424892","44979","2024-09"
"035420","NAVER","26467865200000","175000","151244944","160784508","9539564","2024-09"
"160550","NEW","69765265000","2500","27906106","27906106","0","2024-09"
"053290","NE능률","58833652920","3560","16526307","16526307","0","2024-09"
"181710","NHN","531959404800","16160","32918280","33766123","847843","2024-09"
"060250","NHN KCP","281877450930","7290","38666317","40160611","1494294","2024-09"
"104200","NHN벅스","48065640570","3555","13520574","14827550","1306976","2024-09"
"005940","NH투자증권","4464205858480","13660","326808628","327492299","683671","2024-09"
"034310","NICE","393303414680","11240","34991407","37503477","2512070","2024-09"
"030190","NICE평가정보","655050666920","11180","58591294","60107670","1516376","2024-09"
"008260","NI스틸","116402476190","4070","28600117","28600117","0","2024-09"
"004250","NPC","174962003400","5160","33907365","36720000","2812635","2024-09"
"222160","NPX","79551289560","8040","9894439","9894439","0","2024-09"
"456040","OCI","698294610000","78000","8952495","8952495","0","2024-09"
"010060","OCI홀딩스","1264013068600","66200","19093853","19563983","470130","2024-09"
"178920","PI첨단소재","603477917100","20550","29366322","29366322","0","2024-09"
"024940","PN풍년","52538621200","5590","9398680","10000000","601320","2024-09"
"005490","POSCO홀딩스","25900116807500","342500","75620779","82624377","7003598","2024-09"
"218410","RFHIC","303319478970","11790","25726843","26484442","757599","2024-09"
"327260","RF머트리얼즈","52996678400","6400","8280731","8433231","152500","2024-09"
"091340","S&K폴리텍","26880300330","2510","10709283","11703721","994438","2024-09"
"010950","S-Oil","6619868169600","58800","112582792","112582792","0","2024-09"
"419530","SAMG엔터","116464171000","14660","7944350","8590930","646580","2024-09"
"019550","SBI인베스트먼트","114733390936","712","161142403","162066575","924172","2024-09"
"034120","SBS","289354946400","15600","18548394","18551238","2844","2024-09"
"036120","SCI평가정보","81168134985","2385","34032761","35500000","1467239","2024-09"
"246960","SCL사이언스","64749434890","8890","7283401","7283401","0","2024-09"
"099220","SDN","70098323434","1294","54171811","56171811","2000000","2024-09"
"036540","SFA반도체","595192946370","3630","163964999","164460303","495304","2024-09"
"255220","SG","233941964080","2810","83253368","93851574","10598206","2024-09"
"040610","SG&G","52778878504","1564","33746086","34087196","341110","2024-09"
"049470","SGA","19885381100","340","58486415","58862249","375834","2024-09"
"184230","SGA솔루션즈","32053686098","514","62361257","62599161","237904","2024-09"
"016250","SGC E&C","51691816360","15980","3234782","3243585","8803","2024-09"
"005090","SGC에너지","427174725300","29650","14407242","14409333","2091","2024-09"
"001380","SG글로벌","134667608285","2995","44964143","44964143","0","2024-09"
"004060","SG세계물산","68578146420","345","198777236","202424960","3647724","2024-09"
"001770","SHD","20616479660","16970","1214878","1214878","0","2024-09"
"002360","SH에너지화학","56406240408","518","108892356","111133730","2241374","2024-09"
"009160","SIMPAC","223047710760","4110","54269516","65429516","11160000","2024-09"
"033530","SJG세종","127416328290","4710","27052299","27820961","768662","2024-09"
"123700","SJM","52666530750","3375","15604898","15604898","0","2024-09"
"025530","SJM홀딩스","48380607870","3570","13551991","14934008","1382017","2024-09"
"034730","SK","8014491303000","147000","54520349","72502703","17982354","2024-09"
"011790","SKC","5096462096000","149600","34067260","37868298","3801038","2024-09"
"018670","SK가스","1540117893600","171600","8975046","9230244","255198","2024-09"
"001740","SK네트웍스","989035809000","5100","193928590","221277902","27349312","2024-09"
"006120","SK디스커버리","587077151700","33150","17709718","18785855","1076137","2024-09"
"210980","SK디앤디","156291164400","8400","18606091","18617382","11291","2024-09"
"302440","SK바이오사이언스","4386864525000","57100","76827750","76827750","0","2024-09"
"326030","SK바이오팜","9820481550000","125400","78313250","78313250","0","2024-09"
"402340","SK스퀘어","11599634658000","87000","133329134","134749960","1420826","2024-09"
"361610","SK아이이테크놀로지","2413299869000","33850","71293940","71297592","3652","2024-09"
"100090","SK오션플랜트","865439204160","14620","59195568","59195568","0","2024-09"
"096770","SK이노베이션","10674094067400","112100","95219394","95735590","516196","2024-09"
"475150","SK이터닉스","568333935360","16880","33669072","33691895","22823","2024-09"
"001510","SK증권","208194820109","503","413906203","472590171","58683968","2024-09"
"285130","SK케미칼","874924640800","50800","17222926","17253783","30857","2024-09"
"017670","SK텔레콤","11751326078400","55200","212886342","214790053","1903711","2024-09"
"000660","SK하이닉스","135051591276000","196000","689038731","728002365","38963634","2024-09"
"048550","SM C&C","163922442516","1708","95973327","96714620","741293","2024-09"
"063440","SM Life Design","64302728138","1397","46029154","46029154","0","2024-09"
"003570","SNT다이내믹스","615830902500","27500","22393851","33252697","10858846","2024-09"
"064960","SNT모티브","541123371200","45200","11971756","14623136","2651380","2024-09"
"100840","SNT에너지","264601236120","13390","19761108","20680783","919675","2024-09"
"036530","SNT홀딩스","329680293600","22800","14459662","16303886","1844224","2024-09"
"067160","SOOP","998500932000","93700","10656360","11494767","838407","2024-09"
"005610","SPC삼립","409313761500","50500","8105223","8629009","523786","2024-09"
"011810","STX","158927656500","5130","30980050","31017927","37877","2024-09"
"465770","STX그린로지스","75732654000","10600","7144590","7171032","26442","2024-09"
"077970","STX엔진","487591668400","21200","22999607","23008904","9297","2024-09"
"002820","SUN&L","38964148920","3230","12063204","12607989","544785","2024-09"
"289080","SV인베스트먼트","89273418000","1677","53234000","53234000","0","2024-09"
"084870","TBH글로벌","29679253437","1423","20856819","20856819","0","2024-09"
"002710","TCC스틸","1108839383100","42300","26213697","26213697","0","2024-09"
"089230","THE E&M","30230201062","1382","21874241","21882953","8712","2024-09"
"032540","TJ미디어","73419579430","5270","13931609","13931609","0","2024-09"
"022220","TKG애강","53400210949","1031","51794579","51794579","0","2024-09"
"069260","TKG휴켐스","766650122460","19980","38370877","40878588","2507711","2024-09"
"007980","TP","65829286842","1353","48654314","51175130","2520816","2024-09"
"048770","TPC","42227595790","2690","15697991","15697991","0","2024-09"
"246690","TS인베스트먼트","42428172800","1040","40796320","41477862","681542","2024-09"
"317240","TS트릴리온","29786621715","279","106762085","107240922","478837","2024-09"
"002900","TYM","133073473700","3100","42926927","45050956","2124029","2024-09"
"024070","WISCOM","31955623230","2085","15326438","15326438","0","2024-09"
"057030","YBM넷","59153788285","3655","16184347","16312697","128350","2024-09"
"037270","YG PLUS","176333759800","2780","63429410","63429410","0","2024-09"
"040300","YTN","140490000000","3345","42000000","42000000","0","2024-09"
"051390","YW","30157181820","3735","8074212","11355368","3281156","2024-09"
"052220","iMBC","58075000000","2525","23000000","23000000","0","2024-09"
"079940","가비아","177850356880","13720","12962854","13535684","572830","2024-09"
"078890","가온그룹","60415725120","3760","16068012","17410157","1342145","2024-09"
"000500","가온전선","303323972400","42550","7128648","7357946","229298","2024-09"
"399720","가온칩스","477339696000","41550","11488320","11488320","0","2024-09"
"036620","감성코퍼레이션","330311406880","3640","90744892","90744892","0","2024-09"
"000860","강남제비스코","168675000000","25950","6500000","6500000","0","2024-09"
"198440","강동씨앤엘","97983672640","1610","60859424","60931896","72472","2024-09"
"217730","강스템바이오텍","119395337370","2130","56054149","56054149","0","2024-09"
"035250","강원랜드","3408042556380","16810","202738998","213940500","11201502","2024-09"
"114190","강원에너지","327844126900","12550","26123038","26123038","0","2024-09"
"094480","갤럭시아머니트리","333845921380","8510","39229838","39229838","0","2024-09"
"011420","갤럭시아에스엠","67772124240","2460","27549644","27549644","0","2024-09"
"039240","경남스틸","73519420900","2725","26979604","26979604","0","2024-09"
"053950","경남제약","25093146075","705","35593115","35593402","287","2024-09"
"002100","경농","164176133500","9190","17864650","19522575","1657925","2024-09"
"009450","경동나비엔","1309435639200","90600","14452932","14568592","115660","2024-09"
"267290","경동도시가스","110798931870","18810","5890427","5895406","4979","2024-09"
"012320","경동인베스트","163526400000","75000","2180352","2365023","184671","2024-09"
"011040","경동제약","173235581100","6430","26941770","30768766","3826996","2024-09"
"000050","경방","151733994300","6090","24915270","27415270","2500000","2024-09"
"214390","경보제약","177867038400","7440","23906860","23906860","0","2024-09"
"012610","경인양행","127613622570","3085","41365842","41616365","250523","2024-09"
"009140","경인전자","26832262200","20600","1302537","1570797","268260","2024-09"
"024910","경창산업","86824667200","2440","35583880","35819005","235125","2024-09"
"013580","계룡건설","122503332510","13830","8857797","8930907","73110","2024-09"
"012200","계양전기","42452415894","1561","27195654","27222829","27175","2024-09"
"002140","고려산업","80182115000","3250","24671420","24939425","268005","2024-09"
"049720","고려신용정보","138977647680","9980","13925616","14300000","374384","2024-09"
"010130","고려아연","16319382926000","794000","20553379","20703283","149904","2024-09"
"002240","고려제강","494761667400","19800","24987963","25000000","12037","2024-09"
"014570","고려제약","54702709230","5070","10789489","11000000","210511","2024-09"
"348150","고바이오랩","128642364000","6640","19373850","19373850","0","2024-09"
"098460","고영","652669218560","9920","65793268","68654755","2861487","2024-09"
"035290","골드앤에스","22646328000","475","47676480","47676480","0","2024-09"
"215000","골프존","401741190000","66900","6005100","6275415","270315","2024-09"
"121440","골프존뉴딘홀딩스","165594043230","4065","40736542","42836818","2100276","2024-09"
"366030","공구우먼","103867902250","4585","22653850","22653850","0","2024-09"
"009290","광동제약","234471580200","5850","40080612","52420851","12340239","2024-09"
"014200","광림","91136252176","1006","90592696","90706696","114000","2024-09"
"017040","광명전기","68993483080","1592","43337615","43337615","0","2024-09"
"029480","광무","196405352360","4055","48435352","48473133","37781","2024-09"
"017900","광전자","93273689076","1852","50363763","57943763","7580000","2024-09"
"037710","광주신세계","225764291200","29600","7627172","7957190","330018","2024-09"
"026910","광진실업","13899728850","2170","6405405","6405405","0","2024-09"
"421800","교보12호스팩","14082900000","2355","5980000","5980000","0","2024-06"
"440790","교보13호스팩","8808750000","2175","4050000","4050000","0","2024-09"
"456490","교보14호스팩","9135000000","2175","4200000","4200000","0","2024-09"
"465320","교보15호스팩","8248650000","2165","3810000","3810000","0","2024-09"
"482520","교보16호스팩","12505000000","2050","6100000","6100000","0","2024-09"
"030610","교보증권","637711900950","5650","112869363","113962961","1093598","2024-09"
"339770","교촌에프앤비","221595129800","8870","24982540","24982540","0","2024-09"
"053270","구영테크","61818169920","2370","26083616","27410405","1326789","2024-09"
"007690","국도화학","278156808900","33350","8340534","9010616","670082","2024-09"
"005320","국동","33239947068","502","66215034","67327897","1112863","2024-09"
"001140","국보","33448047050","2110","15852155","15856388","4233","2024-09"
"066620","국보디자인","112362588000","17000","6609564","7500000","890436","2024-09"
"043650","국순당","75003320490","4765","15740466","17858304","2117838","2024-09"
"006050","국영지앤엠","63858637812","1884","33895243","34895243","1000000","2024-09"
"060480","국일신동","22180000000","2000","11090000","11090000","0","2024-09"
"078130","국일제지","901924696800","800","1127405871","1127405871","0","2024-09"
"307750","국전약품","217130997600","4425","49069152","49069269","117","2024-09"
"002720","국제약품","110975635900","5450","20362502","21159832","797330","2024-09"
"035080","그래디언트","152543439900","11150","13681026","14527584","846558","2024-09"
"453450","그리드위즈","172754812500","21750","7942750","7942750","0","2024-09"
"204020","그리티","56260856170","2810","20021657","20147430","125773","2024-09"
"402490","그린리소스","145563273840","17610","8265944","8265944","0","2024-09"
"114450","그린생명과학","40847185800","2140","19087470","20000000","912530","2024-09"
"083420","그린케미칼","142057313160","6090","23326324","24000000","673676","2024-09"
"186230","그린플러스","100205954040","9330","10740188","10820188","80000","2024-09"
"014530","극동유화","127943796000","3800","33669420","34869420","1200000","2024-09"
"204620","글로벌텍스프리","238044105185","3895","61115303","61116035","732","2024-09"
"019660","글로본","19413236268","558","34790746","34790746","0","2024-09"
"014280","금강공업","113131612570","4210","26872117","29329357","2457240","2024-09"
"053260","금강철강","77735312880","4890","15896792","18720000","2823208","2024-09"
"008870","금비","45917850000","56100","818500","1000000","181500","2024-09"
"001570","금양","2887581738350","49850","57925411","58050037","124626","2024-09"
"282720","금양그린파워","126581781000","10490","12066900","12119500","52600","2024-09"
"002990","금호건설","110916674760","3090","35895364","36953595","1058231","2024-09"
"011780","금호석유","3180292342500","136500","23298845","27672679","4373834","2024-09"
"214330","금호에이치티","132435668950","650","203747183","213914131","10166948","2024-09"
"001210","금호전기","37827041196","908","41659737","42525621","865884","2024-09"
"073240","금호타이어","1205056903965","4195","287260287","287260287","0","2024-09"
"036190","금화피에스시","163885672500","27750","5905790","6000000","94210","2024-09"
"049080","기가레인","60095038584","708","84879998","84883347","3349","2024-09"
"420770","기가비스","524142593300","41350","12675758","12675758","0","2024-09"
"035460","기산텔레콤","27390821860","1879","14577340","14577340","0","2024-09"
"092440","기신정기","75044000000","2570","29200000","29200000","0","2024-09"
"000270","기아","37302715704800","95200","391835249","399858417","8023168","2024-09"
"024110","기업은행","11482932484800","14400","797425867","797425869","2","2024-09"
"013700","까뮤이앤씨","60368598360","1337","45152280","45152280","0","2024-09"
"308100","까스텔바작","21994032830","3410","6449863","6624733","174870","2024-09"
"004540","깨끗한나라","79691988580","2140","37239247","37240693","1446","2024-09"
"407400","꿈비","75367653750","6390","11794625","12259474","464849","2024-09"
"187790","나노","31435070025","1025","30668361","30840830","172469","2024-09"
"286750","나노브릭","44180993990","2135","20693674","20694559","885","2024-09"
"121600","나노신소재","1037328392400","86700","11964572","12196078","231506","2024-09"
"247660","나노씨엠에스","36689625180","8590","4271202","4343920","72718","2024-09"
"039860","나노엔텍","149472431710","4655","32110082","32110082","0","2024-09"
"091970","나노캠텍","25297762700","700","36139661","37417493","1277832","2024-09"
"417010","나노팀","216967608000","11000","19724328","19724328","0","2024-09"
"405920","나라셀라","49107952350","3950","12432393","12878076","445683","2024-09"
"051490","나라엠앤디","68678246000","5200","13207355","14200000","992645","2024-09"
"137080","나래나노텍","40477484520","3660","11059422","11059422","0","2024-09"
"190510","나무가","200254772760","12670","15805428","16264384","458956","2024-09"
"242040","나무기술","50931734996","1537","33137108","34606264","1469156","2024-09"
"089600","나스미디어","181464012450","16050","11306169","11568163","261994","2024-09"
"293580","나우IB","90372372300","954","94729950","94929950","200000","2024-09"
"138610","나이벡","250091298900","24300","10291823","10291823","0","2024-09"
"130580","나이스디앤비","78540000000","5100","15400000","15400000","0","2024-09"
"036800","나이스정보통신","165946374000","18920","8770950","10000000","1229050","2024-09"
"267320","나인테크","103731413350","2390","43402265","43664104","261839","2024-09"
"001260","남광토건","61005263940","6210","9823714","9832572","8858","2024-09"
"008350","남선알미늄","179807172370","1393","129079090","129079090","0","2024-09"
"004270","남성","41878165119","1337","31322487","36212160","4889673","2024-09"
"003920","남양유업","380470743000","579000","657117","679731","22614","2024-09"
"025860","남해화학","312625491400","6520","47948695","49678843","1730148","2024-09"
"111710","남화산업","99337100000","4825","20588000","20588000","0","2024-09"
"091590","남화토건","47664400000","4060","11740000","11740000","0","2024-09"
"168330","내츄럴엔도텍","52569612765","1665","31573341","31754900","181559","2024-09"
"094860","네오리진","30066008044","1406","21384074","21399569","15495","2024-09"
"253590","네오셈","484489306800","11400","42499062","43869164","1370102","2024-09"
"212560","네오오토","70634776290","8970","7874557","7874963","406","2024-09"
"095660","네오위즈","408134561500","20500","19909003","22033719","2124716","2024-09"
"042420","네오위즈홀딩스","126463686050","19450","6501989","8856866","2354877","2024-09"
"311390","네오크레마","75252118110","6910","10890321","10979147","88826","2024-09"
"085910","네오티스","48693277360","3640","13377274","13934818","557544","2024-09"
"092730","네오팜","202554265200","25900","7820628","8207361","386733","2024-09"
"290660","네오펙트","39306835629","933","42129513","42129513","0","2024-09"
"306620","네온테크","86883957000","2125","40886568","42608149","1721581","2024-09"
"153460","네이블","40462763520","6320","6402336","6530014","127678","2024-09"
"007390","네이처셀","606244409520","9420","64357156","64357156","0","2024-09"
"033640","네패스","183052862300","8050","22739486","23059202","319716","2024-09"
"330860","네패스아크","162900681650","13370","12184045","12184045","0","2024-09"
"005720","넥센","227696247000","4700","48446010","53543977","5097967","2024-09"
"002350","넥센타이어","695261569980","7230","96163426","97667877","1504451","2024-09"
"089140","넥스턴바이오","42116394105","3735","11276143","11282627","6484","2024-09"
"389650","넥스트바이오메디컬","318721026800","39800","8008066","8008066","0","2024-09"
"137940","넥스트아이","35524666848","464","76561782","78320992","1759210","2024-09"
"396270","넥스트칩","197169446000","10900","18088940","18088940","0","2024-09"
"348210","넥스틴","649140112800","62800","10336626","10437250","100624","2024-09"
"092790","넥스틸","208276020000","8010","26002000","26002000","0","2024-09"
"225570","넥슨게임즈","944186380920","14760","63969267","65860174","1890907","2024-09"
"217270","넵튠","238245102810","5310","44867251","46676150","1808899","2024-09"
"251270","넷마블","4793172403500","58500","81934571","85953502","4018931","2024-09"
"104620","노랑풍선","76913521730","4855","15842126","15842126","0","2024-09"
"090350","노루페인트","178600000000","8930","20000000","20000000","0","2024-09"
"000320","노루홀딩스","138767303220","13540","10248693","13291151","3042458","2024-09"
"194700","노바렉스","191183932800","10800","17702216","18754848","1052632","2024-09"
"285490","노바텍","120909800340","12180","9926913","10575831","648918","2024-09"
"145170","노브랜드","114602405280","13820","8292504","9079834","787330","2024-09"
"106520","노블엠앤비","15902299386","411","38691726","38695952","4226","2024-09"
"376930","노을","132270474800","3580","36947060","36947060","0","2024-09"
"006280","녹십자","1925403128600","168700","11413178","11686538","273360","2024-09"
"142280","녹십자엠에스","95076335880","4380","21706926","21741926","35000","2024-09"
"234690","녹십자웰빙","207440990540","11690","17745166","17752276","7110","2024-09"
"005250","녹십자홀딩스","727933878000","16200","44934190","47028210","2094020","2024-09"
"004370","농심","2177157559500","376500","5782623","6082642","300019","2024-09"
"072710","농심홀딩스","310268151000","66900","4637790","4637790","0","2024-09"
"054050","농우바이오","119748290670","7470","16030561","16030561","0","2024-09"
"069140","누리플랜","18462378668","1412","13075339","13102743","27404","2024-09"
"040160","누리플렉스","30617539350","2710","11297985","12055535","757550","2024-09"
"332290","누보","39256131463","1193","32905391","33384803","479412","2024-09"
"348340","뉴로메카","235773949500","22350","10549170","10549170","0","2024-09"
"060260","뉴보텍","15156916416","1136","13342356","13512009","169653","2024-09"
"123840","뉴온","69658910276","268","259921307","292370108","32448801","2024-09"
"012340","뉴인텍","27335229441","537","50903593","50907162","3569","2024-09"
"214870","뉴지랩파마","64715071880","6920","9351889","9359221","7332","2024-09"
"270870","뉴트리","81223459380","9030","8994846","9200224","205378","2024-09"
"144960","뉴파워프라즈마","200507954765","4955","40465783","43692624","3226841","2024-09"
"085670","뉴프렉스","147679715360","6040","24450284","24450761","477","2024-09"
"064260","다날","219081023600","3280","66792995","68949040","2156045","2024-09"
"340360","다보링크","117365113460","2705","43388212","43388212","0","2024-09"
"039560","다산네트웍스","132103360220","3415","38683268","39505981","822713","2024-09"
"154040","다산솔루에타","25830185266","1439","17950094","17950094","0","2024-09"
"058730","다스코","59452654800","3270","18181240","18796941","615701","2024-09"
"030210","다올투자증권","177719733000","3000","59239911","60911106","1671195","2024-09"
"023590","다우기술","789660536700","18300","43150849","44866617","1715768","2024-09"
"032190","다우데이타","430109000000","11230","38300000","38300000","0","2024-09"
"323350","다원넥스뷰","52306399600","6890","7591640","7596111","4471","2024-09"
"068240","다원시스","396899744800","10400","38163437","38163437","0","2024-09"
"145210","다이나믹디자인","46744006770","2705","17280594","17301093","20499","2024-09"
"019680","대교","145547448480","2160","67383078","84702850","17319772","2024-09"
"006370","대구백화점","60498111970","7270","8321611","10821611","2500000","2024-09"
"008060","대덕","209441127000","6180","33890150","33890150","0","2024-09"
"353200","대덕전자","889998819250","18010","49416925","49416925","0","2024-09"
"000490","대동","204340516290","8670","23568687","25640788","2072101","2024-09"
"020400","대동금속","20633904020","6470","3189166","3189166","0","2024-09"
"008830","대동기어","65608896000","7300","8987520","8987520","0","2024-09"
"048470","대동스틸","36020104410","3830","9404727","10000000","595273","2024-09"
"008110","대동전자","105136322880","15040","6990447","10490447","3500000","2024-09"
"004780","대륙제관","65680211870","4130","15903199","15903199","0","2024-09"
"005750","대림B&Co","58269478800","3495","16672240","16672240","0","2024-09"
"017650","대림제지","58345000000","7000","8335000","9000000","665000","2024-09"
"006570","대림통상","39468916640","2620","15064472","15225000","160528","2024-09"
"007720","대명소노시즌","108562084650","1077","100800450","100800450","0","2024-09"
"389260","대명에너지","230004500000","13490","17050000","17050000","0","2024-09"
"317850","대모","81246339200","9760","8324420","8324420","0","2024-09"
"290670","대보마그네틱","128210459520","17160","7471472","7857660","386188","2024-09"
"078140","대봉엘에스","228816732100","20900","10948169","11086579","138410","2024-09"
"065150","대산F&B","18113400725","145","124920005","125282405","362400","2024-09"
"001680","대상","696425302500","20100","34648025","34648025","0","2024-09"
"084690","대상홀딩스","304909569960","8420","36212538","36212538","0","2024-09"
"036480","대성미생물","38380000000","10100","3800000","3800000","0","2024-09"
"128820","대성산업","130924845930","3495","37460614","45235478","7774864","2024-09"
"117580","대성에너지","250461768660","9210","27194546","27500000","305454","2024-09"
"027830","대성창투","81648000000","1512","54000000","54000000","0","2024-09"
"104040","대성파인텍","45659610220","980","46591439","47224987","633548","2024-09"
"129920","대성하이텍","56848894685","4145","13715053","13715053","0","2024-09"
"016710","대성홀딩스","126936797460","7890","16088314","16089459","1145","2024-09"
"438220","대신밸런스제13호스팩","13282200000","2355","5640000","5640000","0","2024-09"
"442310","대신밸런스제14호스팩","15164600000","2260","6710000","6710000","0","2024-09"
"457390","대신밸런스제15호스팩","16672950000","2370","7035000","7035000","0","2024-09"
"457630","대신밸런스제16호스팩","16082000000","2200","7310000","7310000","0","2024-09"
"471050","대신밸런스제17호스팩","12938100000","2135","6060000","6060000","0","2024-09"
"478780","대신밸런스제18호스팩","16334150000","2065","7910000","7910000","0","2024-09"
"020180","대신정보통신","34586023500","900","38428915","38428915","0","2024-09"
"003540","대신증권","627197601570","16710","37534267","50773400","13239133","2024-09"
"045390","대아티아이","181468945775","2575","70473377","70473377","0","2024-09"
"009190","대양금속","74333591865","1755","42355323","42359986","4663","2024-09"
"108380","대양전기공업","113050597760","12230","9243712","9567333","323621","2024-09"
"014160","대영포장","100593602208","1056","95259093","108394549","13135456","2024-09"
"047040","대우건설","1569583450400","3820","410885720","415622638","4736918","2024-09"
"009320","대우부품","53736749300","1090","49299770","49299770","0","2024-09"
"003090","대웅","1089737421500","26650","40890710","58141980","17251270","2024-09"
"069620","대웅제약","1817990660000","158000","11506270","11586575","80305","2024-09"
"007680","대원","55802867100","4150","13446474","13446474","0","2024-09"
"000430","대원강업","239320000000","3860","62000000","62000000","0","2024-09"
"048910","대원미디어","101267389320","8380","12084414","12578946","494532","2024-09"
"005710","대원산업","117821088000","5880","20037600","20037600","0","2024-09"
"006340","대원전선","228686483750","3050","74979175","74979175","0","2024-09"
"003220","대원제약","336290657910","15690","21433439","22427583","994144","2024-09"
"024890","대원화성","48137078152","1181","40759592","41249152","489560","2024-09"
"290380","대유","56838037000","2300","24712190","24713612","1422","2024-09"
"002880","대유에이텍","49068759600","1050","46732152","46744020","11868","2024-09"
"000300","대유플러스","30475633069","241","126454909","126454909","0","2024-09"
"120240","대정화금","101500652650","14150","7173191","7190391","17200","2024-09"
"003310","대주산업","50009390550","1413","35392350","35392350","0","2024-09"
"078600","대주전자재료","1548375708000","103400","14974620","15480593","505973","2024-09"
"012800","대창","98605602792","1292","76320126","91140499","14820373","2024-09"
"015230","대창단조","129599651600","5140","25213940","28572230","3358290","2024-09"
"096350","대창솔루션","59205763788","372","159155279","163761009","4605730","2024-09"
"140520","대창스틸","47809248540","2265","21107836","21109243","1407","2024-09"
"131220","대한과학","36963889120","4960","7452397","7454490","2093","2024-09"
"010170","대한광통신","75405299992","1012","74511166","74511166","0","2024-09"
"054670","대한뉴팜","115791134250","8250","14035289","14354920","319631","2024-09"
"001070","대한방직","21384904800","5920","3612315","5300000","1687685","2024-09"
"023910","대한약품","151410000000","25750","5880000","6000000","120000","2024-09"
"006650","대한유화","627491760000","101600","6176100","6500000","323900","2024-09"
"001440","대한전선","2375833232260","12790","185757094","186447300","690206","2024-09"
"084010","대한제강","243901748460","13980","17446477","23414397","5967920","2024-09"
"001790","대한제당","264965194100","2995","88469180","89696580","1227400","2024-09"
"001130","대한제분","226872666300","137900","1645197","1690000","44803","2024-09"
"003490","대한항공","8413841007050","22850","368220613","368220661","48","2024-09"
"005880","대한해운","592712543220","1857","319177460","319177460","0","2024-09"
"003830","대한화섬","135601070000","121000","1120670","1328000","207330","2024-09"
"016090","대현","92550027900","2090","44282310","44282310","0","2024-09"
"069460","대호에이엘","70779659540","1049","67473460","67544896","71436","2024-09"
"021040","대호특수강","30076064092","1642","18316726","21704774","3388048","2024-09"
"067080","대화제약","381862970000","21800","17516650","18616650","1100000","2024-09"
"298540","더네이쳐홀딩스","148954547400","10200","14603387","14765856","162469","2024-09"
"032860","더라미","146652924600","3640","40289265","40395863","106598","2024-09"
"192080","더블유게임즈","1030928964000","52000","19825557","21495906","1670349","2024-09"
"393890","더블유씨피","583623691760","17320","33696518","33696518","0","2024-09"
"299170","더블유에스아이","46002816336","1532","30027948","30027963","15","2024-09"
"012510","더존비즈온","1327166189550","47350","28028853","30382784","2353931","2024-09"
"224060","더코디","22024029465","4665","4721121","4748398","27277","2024-09"
"043090","더테크놀로지","32592784938","438","74412751","74412751","0","2024-09"
"213420","덕산네오룩스","736887450000","30000","24562915","24831179","268264","2024-09"
"317330","덕산테코피아","828277822800","40450","20476584","20476584","0","2024-09"
"077360","덕산하이메탈","224004419860","4930","45437002","45437002","0","2024-09"
"004830","덕성","97850037250","7070","13840175","15680000","1839825","2024-09"
"090410","덕신이피씨","65715833910","1426","46084035","46084095","60","2024-09"
"024900","덕양산업","111226599400","3430","32427580","32564980","137400","2024-09"
"263600","덕우전자","96856284800","6080","15930310","15930310","0","2024-09"
"194480","데브시스터즈","383837047200","35550","10797104","12035480","1238376","2024-09"
"263800","데이타솔루션","76474376700","4715","16219380","16219380","0","2024-09"
"206560","덱스터","185644881540","7380","25155133","25411736","256603","2024-09"
"261200","덴티스","113667018000","7440","15277825","15809700","531875","2024-09"
"145720","덴티움","674388276200","78200","8623891","11068830","2444939","2024-09"
"067990","도이치모터스","141717501950","4775","29679058","30181550","502492","2024-09"
"002150","도화엔지니어링","223082027500","6700","33295825","33720000","424175","2024-09"
"006620","동구바이오제약","161887284060","5970","27116798","28464992","1348194","2024-09"
"100130","동국S&C","150759720715","2705","55733723","57143000","1409277","2024-09"
"005160","동국산업","344698309590","6690","51524411","54244482","2720071","2024-09"
"460850","동국씨엠","192522283200","6450","29848416","29898656","50240","2024-09"
"075970","동국알앤에스","47104000000","2560","18400000","18400000","0","2024-09"
"460860","동국제강","452391883460","9130","49550042","49608017","57975","2024-09"
"086450","동국제약","797585324800","18140","43968320","44460000","491680","2024-09"
"001230","동국홀딩스","251922498300","8100","31101543","31800483","698940","2024-09"
"023450","동남합성","114721290000","33100","3465900","3500000","34100","2024-09"
"004140","동방","119009066940","2490","47794806","47971766","176960","2024-09"
"099410","동방선기","40025177850","2870","13946055","14000000","53945","2024-09"
"007590","동방아그로","76543113470","6170","12405691","13617577","1211886","2024-09"
"005960","동부건설","95668365180","4170","22942054","22946345","4291","2024-09"
"026960","동서","1929047824650","19550","98672523","99700000","1027477","2024-09"
"002210","동성제약","104383235220","4565","22865988","26100970","3234982","2024-09"
"102260","동성케미컬","212846697060","4370","48706338","49689728","983390","2024-09"
"033500","동성화인텍","334461646080","11520","29033129","29989494","956365","2024-09"
"025950","동신건설","173040000000","20600","8400000","8400000","0","2024-09"
"000640","동아쏘시오홀딩스","771339218200","123400","6250723","6348913","98190","2024-09"
"170900","동아에스티","707453634400","78800","8977838","9167274","189436","2024-09"
"088130","동아엘텍","97885770840","9180","10662938","10662938","0","2024-09"
"028100","동아지질","168793279200","12740","13249080","14052646","803566","2024-09"
"041930","동아화성","107048759020","7210","14847262","15800000","952738","2024-09"
"001520","동양","149945209770","790","189804063","238684063","48880000","2024-09"
"084670","동양고속","22228680000","8520","2609000","2895569","286569","2024-09"
"082640","동양생명","860817851760","5520","155945263","161358585","5413322","2024-09"
"060380","동양에스텍","29143000000","1510","19300000","19700000","400000","2024-09"
"079960","동양이엔피","153717922490","19910","7720639","7860000","139361","2024-09"
"008970","동양철관","130184152991","829","157037579","157052160","14581","2024-09"
"228340","동양파일","40200000000","2010","20000000","20000000","0","2024-09"
"092780","동양피스톤","72191731040","5720","12620932","13168460","547528","2024-09"
"088910","동우팜투테이블","51572136820","2005","25721764","25831764","110000","2024-09"
"094170","동운아나텍","348292855680","18480","18847016","19067208","220192","2024-09"
"049770","동원F&B","640614584000","33200","19295620","19295620","0","2024-09"
"013120","동원개발","231560655000","2550","90808100","90808100","0","2024-09"
"018500","동원금속","60020329620","1284","46744805","46754933","10128","2024-09"
"006040","동원산업","1258965230250","34950","36021895","36021895","0","2024-09"
"030720","동원수산","26992069000","5800","4653805","4653805","0","2024-09"
"014820","동원시스템즈","1458261484600","50300","28991282","28991282","0","2024-09"
"111380","동인기연","121386067050","20450","5935749","6128000","192251","2024-09"
"163560","동일고무벨트","103972000000","7480","13900000","13900000","0","2024-09"
"109860","동일금속","74356587750","8790","8459225","9100000","640775","2024-09"
"032960","동일기연","41911461080","11090","3779212","3986323","207111","2024-09"
"004890","동일산업","88375696800","40800","2166071","2425215","259144","2024-09"
"002690","동일제강","29218974400","1540","18973360","20300360","1327000","2024-09"
"023790","동일철강","27237856092","1308","20824049","20841335","17286","2024-09"
"005290","동진쎄미켐","1416469309700","27550","51414494","51414494","0","2024-09"
"025900","동화기업","552552222240","12080","45741078","50557285","4816207","2024-09"
"000020","동화약품","220634722800","7960","27717930","27931470","213540","2024-09"
"000150","두산","2839823490000","210000","13522969","16523835","3000866","2024-09"
"454910","두산로보틱스","4018838760000","62000","64819980","64819980","0","2024-09"
"241560","두산밥캣","4023706801800","40200","100092209","100249166","156957","2024-09"
"034020","두산에너빌리티","13545838303200","21150","640465168","640561146","95978","2024-09"
"131970","두산테스나","494001541200","29200","16917861","17006566","88705","2024-09"
"336260","두산퓨얼셀","1168210993360","17840","65482679","65493726","11047","2024-09"
"016740","두올","111054163470","3565","31151238","32066680","915442","2024-09"
"073190","듀오백","29428745080","2660","11063438","11968040","904602","2024-09"
"030350","드래곤플라이","17555410169","253","69388973","69388973","0","2024-09"
"203650","드림시큐리티","159897372720","3280","48749199","50605754","1856555","2024-09"
"223250","드림씨아이에스","90080441340","3785","23799324","23799324","0","2024-09"
"060570","드림어스컴퍼니","131203429155","1735","75621573","75621573","0","2024-09"
"362990","드림인사이트","36893448000","2250","16397088","16800574","403486","2024-09"
"192650","드림텍","616433834610","9130","67517397","68883113","1365716","2024-09"
"217620","디딤이앤에프","21715711458","381","56996618","57747210","750592","2024-09"
"016670","디모아","20728520400","4200","4935362","4941846","6484","2024-09"
"187870","디바이스이엔지","93298389680","13880","6721786","7036609","314823","2024-09"
"024090","디씨엠","107972283360","12440","8679444","11400000","2720556","2024-09"
"003160","디아이","507066827810","19490","26016769","28300000","2283231","2024-09"
"092200","디아이씨","150527724375","3885","38745875","38888569","142694","2024-09"
"110990","디아이티","250916804490","13610","18436209","18900000","463791","2024-09"
"263690","디알젬","82203390000","7500","10960452","11325610","365158","2024-09"
"214680","디알텍","220443682160","2990","73726984","73727108","124","2024-09"
"347850","디앤디파마텍","538529051900","51100","10538729","10538729","0","2024-09"
"263720","디앤씨미디어","220075238430","17730","12412591","12524473","111882","2024-09"
"376300","디어유","555478700400","23400","23738406","23738406","0","2024-09"
"109740","디에스케이","131056796000","5200","25203230","25710390","507160","2024-09"
"196490","디에이테크놀로지","36209568780","203","178372260","178549360","177100","2024-09"
"066900","디에이피","41801170875","2375","17600493","22744503","5144010","2024-09"
"127120","디엔에이링크","83190219100","3700","22483843","22483843","0","2024-09"
"092070","디엔에프","126133252200","10900","11571858","11571858","0","2024-09"
"039840","디오","247128994800","17100","14451988","14981755","529767","2024-09"
"013570","디와이","117055311295","4745","24669191","26319633","1650442","2024-09"
"219550","디와이디","40427907365","515","78500791","78500791","0","2024-09"
"310870","디와이씨","22527366543","1089","20686287","20687271","984","2024-09"
"210540","디와이파워","138720647070","12570","11035851","11041708","5857","2024-09"
"104460","디와이피엔에프","114059059600","11800","9666022","10713625","1047603","2024-09"
"079810","디이엔티","170450740200","7800","21852659","22028094","175435","2024-09"
"113810","디젠스","28614800727","877","32628051","32628051","0","2024-09"
"043360","디지아이","18816914590","2110","8917969","9000000","82031","2024-09"
"197140","디지캡","35972390790","2835","12688674","13013154","324480","2024-09"
"068930","디지털대성","193120532000","7370","26203600","27675342","1471742","2024-09"
"033130","디지틀조선","59458657734","1602","37115267","37115267","0","2024-09"
"105740","디케이락","76467217760","7520","10168513","10168513","0","2024-09"
"263020","디케이앤디","51186618640","3440","14879831","15069831","190000","2024-09"
"290550","디케이티","174610737900","8730","20001230","20001230","0","2024-09"
"066670","디티씨","51959168540","3310","15697634","18691918","2994284","2024-09"
"187220","디티앤씨","36361163615","3155","11524933","11698021","173088","2024-09"
"383930","디티앤씨알오","89138173760","6980","12770512","12770512","0","2024-09"
"131180","딜리","28064729610","1010","27786861","29350000","1563139","2024-09"
"315640","딥노이드","135648671400","6050","22421268","22421268","0","2024-09"
"223310","딥마인드","52860960020","2315","22834108","22839375","5267","2024-09"
"317120","라닉스","33864529350","3515","9634290","9660000","25710","2024-09"
"462510","라메디텍","101473121550","11730","8650735","8650735","0","2024-09"
"042510","라온시큐어","106062855480","1962","54058540","56025871","1967331","2024-09"
"232680","라온테크","80013028480","6560","12197108","12534234","337126","2024-09"
"418420","라온텍","110517038720","3680","30031804","30108433","76629","2024-09"
"300120","라온피플","99397957180","4765","20860012","20860012","0","2024-09"
"171120","라이온켐텍","75709276500","2145","35295700","35901760","606060","2024-09"
"388790","라이콤","95408073600","3200","29815023","29913930","98907","2024-09"
"347700","라이프시맨틱스","80177612170","4010","19994417","19994417","0","2024-09"
"214260","라파스","168808543500","20100","8398435","8912435","514000","2024-09"
"115390","락앤락","374233582080","8640","43314072","43326411","12339","2024-09"
"200350","래몽래인","133247013250","13330","9996025","9996025","0","2024-09"
"171010","램테크놀러지","57623970560","4030","14298752","14298752","0","2024-09"
"084650","랩지노믹스","246105566850","3315","74239990","74239990","0","2024-09"
"217500","러셀","53577543278","1847","29007874","31812000","2804126","2024-09"
"038390","레드캡투어","131676473250","15750","8360411","8589480","229069","2024-09"
"294140","레몬","87231245865","4155","20994283","21000000","5717","2024-09"
"443250","레뷰코퍼레이션","89654323200","8320","10775760","11279386","503626","2024-09"
"228670","레이","145035577440","9360","15495254","15495254","0","2024-09"
"228850","레이언스","110784537600","7040","15736440","16591014","854574","2024-09"
"412350","레이저쎌","49743740400","5700","8726972","8726972","0","2024-09"
"199550","레이저옵텍","83219291820","7140","11655363","11656947","1584","2024-09"
"281740","레이크머티리얼즈","1030654396800","15680","65730510","65730548","38","2024-09"
"277810","레인보우로보틱스","2648080617000","136500","19399858","19399858","0","2024-09"
"215100","로보로보","68640669150","3390","20247985","20348454","100469","2024-09"
"090360","로보스타","214500000000","22000","9750000","9750000","0","2024-09"
"108490","로보티즈","238444118580","18490","12895842","13051842","156000","2024-09"
"067730","로지시스","25732632520","2660","9673922","9673922","0","2024-09"
"071280","로체시스템즈","274753990980","18420","14916069","15296603","380534","2024-09"
"032350","롯데관광개발","751294364380","9860","76196183","76196183","0","2024-09"
"089860","롯데렌탈","1086089483700","29900","36324063","36634063","310000","2024-09"
"000400","롯데손해보험","712498619150","2305","309110030","310336320","1226290","2024-09"
"023530","롯데쇼핑","1817802152000","64300","28270640","28288755","18115","2024-09"
"020150","롯데에너지머티리얼즈","1802933648500","39100","46110835","46110835","0","2024-09"
"280360","롯데웰푸드","1182077397900","133700","8841267","9434574","593307","2024-09"
"286940","롯데이노베이트","351001314400","23200","15129367","15129367","0","2024-09"
"004000","롯데정밀화학","1223833500000","48050","25470000","25800000","330000","2024-09"
"004990","롯데지주","1706407730000","24100","70805300","104909237","34103937","2024-09"
"005300","롯데칠성","1132951736400","122100","9278884","9278884","0","2024-09"
"011170","롯데케미칼","3744442653600","88800","42167147","42775419","608272","2024-09"
"071840","롯데하이마트","187861981440","8120","23135712","23607712","472000","2024-09"
"328130","루닛","1169362656000","40500","28873152","28873152","0","2024-09"
"038060","루멘스","61331412975","1275","48103069","48103069","0","2024-09"
"141080","리가켐바이오","4516991152000","124000","36427348","36567348","140000","2024-09"
"058470","리노공업","3010019496000","198300","15179120","15242370","63250","2024-09"
"016100","리더스코스메틱","52807181760","2880","18335827","19100894","765067","2024-09"
"012700","리드코프","113385194360","4430","25594852","26446135","851283","2024-09"
"302550","리메드","96969523200","3165","30638080","30638080","0","2024-09"
"073570","리튬포어스","67304336220","1860","36185127","36189497","4370","2024-09"
"377450","리파인","204052978800","13420","15205140","17330000","2124860","2024-09"
"277070","린드먼아시아","55935621750","4415","12669450","13692000","1022550","2024-09"
"042500","링네트","74148862680","4605","16101816","19070134","2968318","2024-09"
"193250","링크드","29065430043","459","63323377","63323377","0","2024-09"
"219420","링크제니시스","52334620050","4650","11254757","11469507","214750","2024-09"
"439090","마녀공장","334935417000","20450","16378260","16378260","0","2024-09"
"027740","마니커","60453159536","952","63501218","63511228","10010","2024-09"
"195500","마니커에프앤지","47694330000","2985","15978000","15978000","0","2024-09"
"377480","마음AI","66323184980","10630","6239246","6239246","0","2024-09"
"305090","마이크로디지탈","246068923200","14880","16536890","16536890","0","2024-09"
"098120","마이크로컨텍솔","46468361940","5590","8312766","8312766","0","2024-09"
"424980","마이크로투나노","53743521200","9080","5918890","5918890","0","2024-09"
"038290","마크로젠","183614648800","18400","9979057","10841400","862343","2024-09"
"001080","만호제강","105239723200","35600","2956172","4150000","1193828","2024-09"
"267980","매일유업","277120972800","38400","7216692","7843638","626946","2024-09"
"005990","매일홀딩스","105205584500","8420","12494725","13718304","1223579","2024-09"
"093520","매커스","90292314400","9200","9814382","16163092","6348710","2024-09"
"377030","맥스트","52939235810","2705","19570882","19570882","0","2024-09"
"100590","머큐리","57146383030","3610","15830023","15830023","0","2024-09"
"067280","멀티캠퍼스","181952115300","30700","5926779","5926779","0","2024-09"
"072870","메가스터디","127986562440","11220","11407002","11920959","513957","2024-09"
"215200","메가스터디교육","471241002600","43800","10758927","11461955","703028","2024-09"
"133750","메가엠디","45915968800","2080","22074985","23407077","1332092","2024-09"
"446540","메가터치","95650455000","4605","20771000","20771000","0","2024-09"
"235980","메드팩토","215252254950","6410","33580695","33580695","0","2024-09"
"041920","메디아나","91036064250","4905","18559850","18598223","38373","2024-09"
"014100","메디앙스","25370100685","2245","11300713","11800000","499287","2024-09"
"054180","메디콕스","22371066640","380","58871228","58878283","7055","2024-09"
"086900","메디톡스","1215672057600","180600","6731296","7298497","567201","2024-09"
"078160","메디포스트","218914199700","6420","34098785","34217785","119000","2024-09"
"138040","메리츠금융지주","19185642877700","103700","185011021","190720114","5709093","2024-09"
"408920","메쎄이상","95975449140","2230","43038318","43232455","194137","2024-09"
"021880","메이슨캐피탈","48699010560","320","152184408","152184408","0","2024-09"
"140410","메지온","930224403900","31050","29958918","29958918","0","2024-09"
"241770","메카로","75232226000","7640","9847150","10192640","345490","2024-09"
"090370","메타랩스","40838671560","1640","24901629","24904689","3060","2024-09"
"059210","메타바이오메드","90798298760","3970","22871108","23862351","991243","2024-09"
"118000","메타케어","58495199550","355","164775210","164777364","2154","2024-09"
"058110","멕아이씨에스","39441213850","2545","15497530","16050530","553000","2024-09"
"017180","명문제약","75046603095","2245","33428331","33953454","525123","2024-09"
"009900","명신산업","636462713290","12130","52470133","52470133","0","2024-09"
"012690","모나리자","113886814125","3115","36560775","36571255","10480","2024-09"
"005360","모나미","43180346495","2285","18897307","18897307","0","2024-09"
"070960","모나용평","192765768225","4075","47304483","48133333","828850","2024-09"
"434480","모니터랩","47116021500","4005","11764300","12253300","489000","2024-09"
"080420","모다이노칩","152906070996","1918","79721622","79721622","0","2024-09"
"417970","모델솔루션","62431792000","9760","6396700","6396700","0","2024-09"
"080160","모두투어","174680996010","10090","17312289","18900000","1587711","2024-09"
"087260","모바일어플라이언스","73406701555","2255","32552861","32552861","0","2024-09"
"101330","모베이스","74880638815","3235","23147029","23147029","0","2024-09"
"012860","모베이스전자","130751579056","1799","72680144","73233457","553313","2024-09"
"363260","모비데이즈","53554399520","1688","31726540","32163769","437229","2024-09"
"348030","모비릭스","50804102000","5290","9603800","9603800","0","2024-09"
"250060","모비스","123519546885","3855","32041387","32171314","129927","2024-09"
"288980","모아데이타","55290499200","1600","34556562","34556562","0","2024-09"
"142760","모아라이프플러스","53017409455","1405","37734811","37734811","0","2024-09"
"033200","모아텍","30006764540","3260","9204529","14331185","5126656","2024-09"
"333050","모코엠시스","29099040384","1266","22985024","24444326","1459302","2024-09"
"009680","모토닉","187727776320","8680","21627624","33000000","11372376","2024-09"
"118990","모트렉스","259355930120","10460","24795022","24861990","66968","2024-09"
"006920","모헨즈","28119000000","2575","10920000","10920000","0","2024-09"
"009580","무림P&P","178360405080","2860","62363778","62368324","4546","2024-09"
"001810","무림SP","36792525000","1662","22137500","22137500","0","2024-09"
"009200","무림페이퍼","86547364800","2080","41609310","41609310","0","2024-09"
"033920","무학","152034622320","5740","26486868","28500000","2013132","2024-09"
"008420","문배철강","46340834100","2420","19149105","20503505","1354400","2024-09"
"279600","미디어젠","52938025300","11300","4684781","4684781","0","2024-09"
"095500","미래나노텍","303584498100","10700","28372383","31009999","2637616","2024-09"
"254490","미래반도체","258873340000","17930","14438000","14438000","0","2024-09"
"025560","미래산업","33076696230","1062","31145665","31166865","21200","2024-09"
"218150","미래생명자원","93968642580","4820","19495569","20415802","920233","2024-09"
"007120","미래아이앤지","28088161192","1028","27323114","28878608","1555494","2024-09"
"442900","미래에셋드림스팩1호","76569600000","9970","7680000","7680000","0","2024-09"
"100790","미래에셋벤처투자","268790124680","5060","53120578","53124634","4056","2024-09"
"412930","미래에셋비전스팩1호","16242880000","2630","6176000","6176000","0","2024-09"
"446190","미래에셋비전스팩2호","10890000000","2200","4950000","4950000","0","2024-09"
"448830","미래에셋비전스팩3호","10676400000","2170","4920000","4920000","0","2024-09"
"477380","미래에셋비전스팩4호","16443000000","2030","8100000","8100000","0","2024-09"
"477470","미래에셋비전스팩5호","11508000000","2100","5480000","5480000","0","2024-09"
"478440","미래에셋비전스팩6호","14067900000","2030","6930000","6930000","0","2024-09"
"482680","미래에셋비전스팩7호","16314990000","1986","8215000","8215000","0","2024-09"
"085620","미래에셋생명","686324800000","5260","130480000","177016189","46536189","2024-09"
"006800","미래에셋증권","4024404796160","8960","449152321","595316408","146164087","2024-09"
"049950","미래컴퍼니","156947254200","19800","7926629","8817884","891255","2024-09"
"207760","미스터블루","122669351635","1489","82383715","83079783","696068","2024-09"
"002840","미원상사","931161097500","200500","4644195","4750000","105805","2024-09"
"268280","미원에스씨","723676753800","148200","4883109","5000000","116891","2024-09"
"107590","미원홀딩스","184078275000","79500","2315450","2320000","4550","2024-09"
"134380","미원화학","160003105800","79900","2002542","2199268","196726","2024-09"
"003650","미창석유","149028431500","98500","1512979","1739672","226693","2024-09"
"059090","미코","340472808570","10810","31496097","33416778","1920681","2024-09"
"214610","미코바이오메드","68824141140","1580","43559583","43568945","9362","2024-09"
"201490","미투온","71304295660","2330","30602702","31257770","655068","2024-09"
"452200","민테크","160420143000","7310","21945300","21945300","0","2024-09"
"418470","밀리의서재","128679235460","15140","8499289","8499289","0","2024-09"
"206640","바디텍메드","300637097280","13680","21976396","23486560","1510164","2024-09"
"018700","바른손","41691784848","1211","34427568","35119757","692189","2024-09"
"035620","바른손이앤에이","36093874266","486","74267231","74439675","172444","2024-09"
"053030","바이넥스","720541688800","23300","30924536","31761048","836512","2024-09"
"301300","바이브컴퍼니","53943337000","4360","12372325","12394861","22536","2024-09"
"377740","바이오노트","474479295900","4665","101710460","102056048","345588","2024-09"
"064550","바이오니아","667196022350","25850","25810291","25810291","0","2024-09"
"314930","바이오다인","616064284000","20900","29476760","29764103","287343","2024-09"
"208710","바이오로그디바이스","30577908096","464","65900664","65900664","0","2024-09"
"086820","바이오솔루션","118669310220","14790","8023618","8143426","119808","2024-09"
"038460","바이오스마트","97242810400","4220","23043320","23933216","889896","2024-09"
"251120","바이오에프디엔씨","146868501780","17220","8528949","8695700","166751","2024-09"
"199730","바이오인프라","48400451650","9950","4864367","4864367","0","2024-09"
"086040","바이오톡스텍","71844005730","4570","15720789","15958247","237458","2024-09"
"099430","바이오플러스","302341616490","5370","56301977","57930864","1628887","2024-09"
"032980","바이온","33440956470","747","44767010","44777990","10980","2024-09"
"308080","바이젠셀","72816937200","3780","19263740","19263740","0","2024-09"
"043150","바텍","349817728800","23550","14854256","14854256","0","2024-09"
"323990","박셀바이오","317370011900","13820","22964545","22993200","28655","2024-09"
"003610","방림","115208150295","3255","35394209","42314090","6919881","2024-09"
"267790","배럴","38693092500","4905","7888500","7888500","0","2024-09"
"001340","백광산업","441491070000","10000","44149107","44918407","769300","2024-09"
"046310","백금T&A","39079364490","2430","16082043","16418641","336598","2024-09"
"035150","백산","297775000000","13850","21500000","21500000","0","2024-09"
"331520","밸로프","35174918688","717","49058464","50864390","1805926","2024-09"
"199480","뱅크웨어글로벌","92009089600","9200","10000988","10000988","0","2024-09"
"438700","버넥트","41403266350","3715","11144890","11144890","0","2024-09"
"066410","버킷스튜디오","96977294204","1153","84108668","84109926","1258","2024-09"
"002410","범양건영","27536416768","1109","24829952","24831982","2030","2024-09"
"382900","범한퓨얼셀","130196525000","15170","8582500","8761000","178500","2024-09"
"206400","베노티앤알","129515622850","3995","32419430","32420452","1022","2024-09"
"019010","베뉴지","88641000000","2205","40200000","48200000","8000000","2024-09"
"177350","베셀","24530869275","275","89203161","89372043","168882","2024-09"
"424760","벨로크","20460243780","1055","19393596","19665002","271406","2024-09"
"007210","벽산","113643226550","2030","55981885","67560000","11578115","2024-09"
"225530","보광산업","141720348900","3900","36338551","36338727","176","2024-09"
"250000","보라티알","65819520300","10050","6549206","6750733","201527","2024-09"
"002760","보락","84638700000","1413","59900000","59900000","0","2024-09"
"003850","보령","759431636300","11530","65865710","68690000","2824290","2024-09"
"310210","보로노이","1972482833500","111500","17690429","18093830","403401","2024-09"
"006910","보성파워텍","156330787680","3195","48929824","49129824","200000","2024-09"
"000890","보해양조","60358806928","434","139075592","139120129","44537","2024-09"
"226340","본느","72367855500","1725","41952380","41952420","40","2024-09"
"003000","부광약품","347065181970","5070","68454671","68454671","0","2024-09"
"001270","부국증권","169264977000","28500","5939122","10369886","4430764","2024-09"
"026940","부국철강","52800000000","2640","20000000","20000000","0","2024-09"
"014470","부방","92413680282","1722","53666481","60052260","6385779","2024-09"
"011390","부산산업","56707200000","53700","1056000","1056000","0","2024-09"
"005030","부산주공","38288532168","486","78782988","78782988","0","2024-09"
"008470","부스타","32852561715","4065","8081811","8404800","322989","2024-09"
"338220","뷰노","428451494450","30850","13888217","13888217","0","2024-09"
"100120","뷰웍스","238270590450","25950","9181911","10001865","819954","2024-09"
"406820","뷰티스킨","51632324400","14610","3534040","3534040","0","2024-09"
"337930","브랜드엑스코퍼레이션","273183618040","9320","29311547","29311547","0","2024-09"
"099390","브레인즈컴퍼니","48369426120","6120","7903501","8208283","304782","2024-09"
"064480","브리지텍","80437750760","6940","11590454","11952500","362046","2024-09"
"288330","브릿지바이오테라퓨틱스","265840781500","5740","46313725","46313725","0","2024-09"
"365900","브이씨","26572940500","3635","7310300","7310300","0","2024-09"
"089970","브이엠","194306222880","8820","22030184","24075595","2045411","2024-09"
"251630","브이원텍","68529276050","4490","15262645","15942886","680241","2024-09"
"018290","브이티","1155281753850","32550","35492527","35798007","305480","2024-09"
"439580","블루엠텍","296569367550","26550","11170221","11170221","0","2024-09"
"033560","블루콤","60666953085","3555","17065247","17100000","34753","2024-09"
"369370","블리츠웨이스튜디오","79892855211","1677","47640343","49871911","2231568","2024-09"
"126340","비나텍","226417612100","38300","5911687","6085118","173431","2024-09"
"121800","비덴트","256296018720","3320","77197596","77201611","4015","2024-09"
"082800","비보존 제약","196961048880","4145","47517744","48242965","725221","2024-09"
"318410","비비씨","48052851950","8650","5555243","5555243","0","2024-09"
"002070","비비안","25861183320","868","29793990","29793990","0","2024-09"
"100220","비상교육","62850271950","5130","12251515","12996741","745226","2024-09"
"419540","비스토스","46900528200","2040","22990455","22992511","2056","2024-09"
"146320","비씨엔씨","186623908800","14700","12695504","12792923","97419","2024-09"
"200780","비씨월드제약","42192825000","5000","8438565","8892384","453819","2024-09"
"413640","비아이매트릭스","54700674600","7590","7206940","7206940","0","2024-09"
"141000","비아트론","74464778250","6750","11031819","12114710","1082891","2024-09"
"090460","비에이치","536635808100","17100","31382211","34464379","3082168","2024-09"
"083650","비에이치아이","313753238760","10140","30942134","30944375","2241","2024-09"
"445360","비엔케이제1호스팩","9051000000","2100","4310000","4310000","0","2024-09"
"473370","비엔케이제2호스팩","8525250000","2025","4210000","4210000","0","2024-09"
"065170","비엘팜텍","33808125760","380","88968752","88970559","1807","2024-09"
"086670","비엠티","85229125160","9340","9125174","9125174","0","2024-09"
"335890","비올","554909653400","9610","57742940","58419125","676185","2024-09"
"230980","비유테크놀러지","21370405721","229","93320549","93320557","8","2024-09"
"138580","비즈니스온","356042480800","15850","22463248","22556163","92915","2024-09"
"082920","비츠로셀","434601981600","19400","22402164","22872213","470049","2024-09"
"054220","비츠로시스","22122269550","450","49160599","49160599","0","2024-09"
"042370","비츠로테크","188640180000","7200","26200025","26200025","0","2024-09"
"050090","비케이홀딩스","15761404000","800","19701755","19784735","82980","2024-09"
"148780","비큐AI","33992828725","1081","31445725","31445725","0","2024-09"
"307870","비투엔","51594284181","1139","45297879","45297879","0","2024-09"
"357880","비트나인","22454505400","2150","10443956","10443956","0","2024-09"
"032850","비트컴퓨터","81569507360","5060","16120456","16623293","502837","2024-09"
"238200","비피도","36482800000","4460","8180000","8180000","0","2024-09"
"093190","빅솔론","68779592230","4570","15050239","19238905","4188666","2024-09"
"065450","빅텍","144123584000","5030","28652800","28652800","0","2024-09"
"210120","빅텐츠","72483260500","23050","3144610","3144610","0","2024-09"
"044480","빌리언스","26187440832","644","40663728","40663728","0","2024-09"
"005180","빙그레","567643624200","64200","8841801","9851241","1009440","2024-09"
"069540","빛과전자","59004554800","1390","42449320","42449320","0","2024-09"
"072950","빛샘전자","32402974080","4045","8010624","8052610","41986","2024-09"
"451250","삐아","115440323990","12170","9485647","9682187","196540","2024-09"
"143240","사람인","179128323000","16500","10856262","11709263","853001","2024-09"
"003960","사조대림","386626344300","46300","8350461","9164467","814006","2024-09"
"008040","사조동아원","142355655940","1010","140946194","141144600","198406","2024-09"
"007160","사조산업","307069500000","61500","4993000","5000000","7000","2024-09"
"014710","사조씨푸드","117430463260","6820","17218543","17218543","0","2024-09"
"006090","사조오양","83296986240","8840","9422736","9422739","3","2024-09"
"452430","사피엔반도체","104025427400","12850","8095364","8096454","1090","2024-09"
"419120","산돌","49458735560","6760","7316381","7774326","457945","2024-09"
"062040","산일전기","1355146336200","44600","30384447","30445200","60753","2024-09"
"122350","삼기","57321967680","1510","37961568","38339428","377860","2024-09"
"419050","삼기이브이","116966310800","2045","57196240","57196240","0","2024-09"
"014970","삼륭물산","59994287600","4030","14886920","15125000","238080","2024-09"
"018310","삼목에스폼","359905200600","25300","14225502","14700000","474498","2024-09"
"053700","삼보모터스","96362524260","4335","22228956","22877190","648234","2024-09"
"009620","삼보산업","21397515730","290","73784537","73785902","1365","2024-09"
"023600","삼보판지","145310976540","9270","15675402","16170000","494598","2024-09"
"001470","삼부토건","111582300176","499","223611824","223611824","0","2024-09"
"028050","삼성E&A","4027800000000","20550","196000000","196000000","0","2024-09"
"006400","삼성SDI","21854668426000","334000","65433139","68764530","3331391","2024-09"
"006660","삼성공조","87804756220","11170","7860766","8126314","265548","2024-09"
"028260","삼성물산","22314259145600","137600","162167581","177784107","15616526","2024-09"
"207940","삼성바이오로직스","73024524000000","1026000","71174000","71174000","0","2024-09"
"032830","삼성생명","17957477900000","100000","179574779","200000000","20425221","2024-09"
"425290","삼성스팩6호","11647200000","2110","5520000","5520000","0","2024-09"
"439250","삼성스팩7호","36245700000","10350","3502000","3502000","0","2024-09"
"448740","삼성스팩8호","46733280000","10020","4664000","4664000","0","2024-09"
"468510","삼성스팩9호","22321000000","2020","11050000","11050000","0","2024-09"
"018260","삼성에스디에스","11648938011600","150600","77350186","77377800","27614","2024-09"
"009150","삼성전기","9028557043200","124200","72693696","74693696","2000000","2024-09"
"005930","삼성전자","356396018235000","59700","5969782550","5969782550","0","2024-09"
"001360","삼성제약","178828562400","1900","94120296","94162079","41783","2024-09"
"010140","삼성중공업","8753864602750","10250","854035571","880000000","25964429","2024-09"
"016360","삼성증권","4188170000000","46900","89300000","89300000","0","2024-09"
"068290","삼성출판사","150500000000","15050","10000000","10000000","0","2024-09"
"029780","삼성카드","4332454217000","40600","106710695","115858891","9148196","2024-09"
"000810","삼성화재","13860247008000","348000","39828296","47374837","7546541","2024-09"
"006110","삼아알미늄","756192482400","51400","14711916","14711916","0","2024-09"
"009300","삼아제약","136714860800","22400","6103342","6370000","266658","2024-09"
"145990","삼양사","497817025000","51500","9666350","10313449","647099","2024-09"
"003230","삼양식품","4154177296000","557000","7458128","7533015","74887","2024-09"
"002170","삼양통상","129944500000","47950","2710000","3000000","290000","2024-09"
"272550","삼양패키징","254345484400","16400","15508871","15788671","279800","2024-09"
"000070","삼양홀딩스","550230330000","74000","7435545","8564271","1128726","2024-09"
"003720","삼영","156533820400","4720","33163945","34000000","836055","2024-09"
"002810","삼영무역","224229482880","12720","17628104","18466948","838844","2024-09"
"361670","삼영에스앤씨","40106956020","7190","5578158","5667658","89500","2024-09"
"054540","삼영엠텍","51613150000","4255","12130000","13000000","870000","2024-09"
"065570","삼영이엔씨","22884093461","1681","13613381","13613381","0","2024-09"
"005680","삼영전자","198173189120","9920","19977136","20000000","22864","2024-09"
"023000","삼원강재","101734287360","2560","39739956","40000000","260044","2024-09"
"004380","삼익THK","193959000000","9370","20700000","21000000","300000","2024-09"
"002450","삼익악기","82417511860","1084","76030915","90530915","14500000","2024-09"
"032280","삼일","23979573120","1546","15510720","16213590","702870","2024-09"
"002290","삼일기업공사","35898000000","2895","12400000","12400000","0","2024-09"
"004440","삼일씨엔에스","52328302170","4110","12731947","12731947","0","2024-09"
"000520","삼일제약","366904311760","17360","21135041","21597199","462158","2024-09"
"009770","삼정펄프","66999222800","26800","2499971","2499971","0","2024-09"
"037460","삼지전자","133101077040","8670","15351912","16318522","966610","2024-09"
"032750","삼진","39078501140","4330","9025058","9031122","6064","2024-09"
"054090","삼진엘앤디","23745920134","958","24786973","24959232","172259","2024-09"
"005500","삼진제약","237894946200","18990","12527380","13900000","1372620","2024-09"
"000250","삼천당제약","3302561024000","142000","23257472","23457472","200000","2024-09"
"004690","삼천리","308162250000","90000","3424025","4055025","631000","2024-09"
"024950","삼천리자전거","49620938800","4100","12102668","13273577","1170909","2024-09"
"038500","삼표시멘트","327965101360","3055","107353552","107916306","562754","2024-09"
"437730","삼현","90895025400","8600","10569189","10569189","0","2024-09"
"017480","삼현철강","73199298600","4740","15442890","15702890","260000","2024-09"
"010960","삼호개발","70881200000","3170","22360000","25000000","2640000","2024-09"
"046390","삼화네트웍스","53960333118","1363","39589386","43172933","3583547","2024-09"
"004450","삼화왕관","57377344200","31800","1804319","2154379","350060","2024-09"
"009470","삼화전기","269843856000","40800","6613820","6613820","0","2024-09"
"011230","삼화전자","50364705840","2980","16900908","16902700","1792","2024-09"
"001820","삼화콘덴서","362213300000","35300","10261000","10395000","134000","2024-09"
"000390","삼화페인트","171268264200","7260","23590670","27203469","3612799","2024-09"
"027580","상보","71710945339","1273","56332243","59181279","2849036","2024-09"
"038540","상상인","87668290152","1602","54724276","55328313","604037","2024-09"
"415580","상상인제3호스팩","11124450000","2095","5310000","5310000","0","2024-09"
"452670","상상인제4호스팩","10492200000","2010","5220000","5220000","0","2024-09"
"001290","상상인증권","50687852157","477","106263841","108337120","2073279","2024-09"
"041650","상신브레이크","67567481900","3490","19360310","21471450","2111140","2024-09"
"091580","상신이디피","141812250160","10640","13328219","13428219","100000","2024-09"
"263810","상신전자","47565230580","3340","14241087","14244718","3631","2024-09"
"089980","상아프론테크","342991946000","22000","15590543","15989037","398494","2024-09"
"042940","상지건설","23754904620","5970","3979046","3981814","2768","2024-09"
"042600","새로닉스","166960916850","13650","12231569","12423574","192005","2024-09"
"075180","새론오토모티브","75168000000","3915","19200000","19200000","0","2024-09"
"107600","새빗켐","117983425500","23900","4936545","4936545","0","2024-09"
"411080","샌즈랩","119298831600","8200","14548638","15248638","700000","2024-09"
"252990","샘씨엔에스","334671440380","5870","57013874","58388063","1374189","2024-09"
"007540","샘표","90494513200","44900","2015468","2875800","860332","2024-09"
"248170","샘표식품","132887943600","29100","4566596","4568286","1690","2024-09"
"378800","샤페론","128409312060","4260","30143031","30143031","0","2024-09"
"294630","서남","92560711740","3860","23979459","23979459","0","2024-09"
"038070","서린바이오","63500338880","7520","8444194","8900676","456482","2024-09"
"006730","서부T&D","402447252480","6240","64494752","66426923","1932171","2024-09"
"079650","서산","24980000000","1249","20000000","20000000","0","2024-09"
"100660","서암기계공업","48951000000","3885","12600000","12600000","0","2024-09"
"007860","서연","156292459200","7200","21707286","23479844","1772558","2024-09"
"200880","서연이화","383723064200","14200","27022751","27028437","5686","2024-09"
"019770","서연탑메탈","44037000000","3780","11650000","11650000","0","2024-09"
"017390","서울가스","205011417600","52800","3882792","5000000","1117208","2024-09"
"043710","서울리거","33030509694","658","50198343","50198880","537","2024-09"
"092190","서울바이오시스","188374424245","4165","45227953","45868383","640430","2024-09"
"046890","서울반도체","534495103200","9480","56381340","58305400","1924060","2024-09"
"004410","서울식품","60335620849","161","374755409","374755559","150","2024-09"
"063170","서울옥션","122405120860","7270","16837018","17774267","937249","2024-09"
"027040","서울전자통신","19206334368","276","69588168","69588847","679","2024-09"
"018680","서울제약","47103648760","4040","11659319","11659319","0","2024-09"
"021050","서원","61004848150","1285","47474590","47474590","0","2024-09"
"093920","서원인텍","107136000000","5760","18600000","18600000","0","2024-09"
"189860","서전기전","46311674500","4775","9698780","9698780","0","2024-09"
"178320","서진시스템","1631190666000","29000","56247954","56247954","0","2024-09"
"122690","서진오토모티브","50717283440","2335","21720464","21844410","123946","2024-09"
"140070","서플러스글로벌","115410762900","3350","34450974","36988000","2537026","2024-09"
"011370","서한","79636035515","811","98194865","100894865","2700000","2024-09"
"065710","서호전기","105021396600","21300","4930582","5150000","219418","2024-09"
"008490","서흥","186467525010","16770","11119113","11569113","450000","2024-09"
"035890","서희건설","288996237400","1495","193308520","229808457","36499937","2024-09"
"357550","석경에이티","251553750000","46250","5439000","5455000","16000","2024-09"
"003100","선광","99256200000","15780","6290000","6600000","310000","2024-09"
"007610","선도전기","50907057000","3000","16969019","18000000","1030981","2024-09"
"067370","선바이오","86137331000","7000","12305333","12313555","8222","2024-09"
"171090","선익시스템","415006007400","47400","8755401","9494405","739004","2024-09"
"136490","선진","169070168880","7110","23779208","23779604","396","2024-09"
"086710","선진뷰티사이언스","127909269000","10650","12010260","12203280","193020","2024-09"
"014620","성광벤드","376963966720","14080","26773009","28600000","1826991","2024-09"
"037350","성도이엔지","71015000000","5000","14203000","15470000","1267000","2024-09"
"014910","성문전자","25552183367","1231","20757257","22460985","1703728","2024-09"
"003080","성보화학","51614435335","2635","19588021","20020000","431979","2024-09"
"004980","성신양회","194608832790","8070","24115097","24516073","400976","2024-09"
"011300","성안머티리얼스","43728130056","534","81887884","81887884","0","2024-09"
"081580","성우전자","72222320250","4750","15204699","15508143","303444","2024-09"
"045300","성우테크론","27115917800","2770","9789140","10151583","362443","2024-09"
"015750","성우하이텍","518345522640","6480","79991593","80000000","8407","2024-09"
"365340","성일하이텍","677263962600","55800","12137347","12137347","0","2024-09"
"000180","성창기업지주","107068706000","1535","69751600","69751600","0","2024-09"
"080470","성창오토텍","30915500000","4235","7300000","7300000","0","2024-09"
"043260","성호전자","96749471754","1586","61002189","61002189","0","2024-09"
"148150","세경하이테크","226556345600","6400","35399429","35860429","461000","2024-09"
"002420","세기상사","32241318400","5800","5558848","5558848","0","2024-09"
"188260","세니젠","25766832630","3630","7098301","7228470","130169","2024-09"
"053060","세동","18769265566","1063","17656882","17657419","537","2024-09"
"340440","세림B&G","36891866700","1300","28378359","28378364","5","2024-09"
"017510","세명전기","86749740000","5690","15246000","15246000","0","2024-09"
"004360","세방","222960937320","12430","17937324","19308690","1371366","2024-09"
"004490","세방전지","987901297800","75100","13154478","14000000","845522","2024-09"
"011560","세보엠이씨","95209171200","9600","9917622","10530000","612378","2024-09"
"396300","세아메카닉스","86163455000","3290","26189500","26489500","300000","2024-09"
"001430","세아베스틸지주","733380333550","20450","35862119","35862119","0","2024-09"
"306200","세아제강","319211400000","114000","2800100","2836300","36200","2024-09"
"003030","세아제강지주","661423465700","163700","4040461","4141657","101196","2024-09"
"019440","세아특수강","114408153990","13710","8344869","8570000","225131","2024-09"
"058650","세아홀딩스","378263633900","97100","3895609","4000000","104391","2024-09"
"013000","세우글로벌","37199063376","1296","28702981","28705031","2050","2024-09"
"100700","세운메디칼","122297357500","2825","43291100","43800000","508900","2024-09"
"024830","세원물산","53189500000","6370","8350000","8350000","0","2024-09"
"091090","세원이앤씨","54828158060","1270","43171778","43180255","8477","2024-09"
"021820","세원정공","72400000000","7240","10000000","10000000","0","2024-09"
"067830","세이브존I&C","81277447715","2155","37715753","41040895","3325142","2024-09"
"258830","세종메디칼","22974088612","412","55762351","55786351","24000","2024-09"
"036630","세종텔레콤","98012014224","516","189945764","200000000","10054236","2024-09"
"039310","세중","30988050570","1710","18121667","18121667","0","2024-09"
"075580","세진중공업","430918876480","7580","56849456","56849456","0","2024-09"
"067770","세진티에스","20365916495","2455","8295689","8396593","100904","2024-09"
"053450","세코닉스","80455633500","5500","14628297","14792803","164506","2024-09"
"222810","세토피아","81189010800","1080","75175010","75659350","484340","2024-09"
"252500","세화피앤씨","40698148590","981","41486390","41486390","0","2024-09"
"321370","센서뷰","61644363300","2340","26343745","26343745","0","2024-09"
"347000","센코","78622935615","2415","32556081","33004976","448895","2024-09"
"331920","셀레믹스","35840609720","4390","8164148","8164148","0","2024-09"
"049180","셀루메드","195005067540","3820","51048447","51057455","9008","2024-09"
"299660","셀리드","125140653610","5930","21102977","21102977","0","2024-09"
"268600","셀리버리","248384003120","6680","37183234","37183234","0","2024-09"
"108860","셀바스AI","286906182160","10660","26914276","26914790","514","2024-09"
"208370","셀바스헬스케어","117272160240","4560","25717579","25740564","22985","2024-09"
"318160","셀바이오휴먼텍","27118813350","3090","8776315","9260901","484586","2024-09"
"308430","셀비온","341405441200","26800","12739009","12739009","0","2024-09"
"068270","셀트리온","38931327176700","188900","206094903","217021190","10926287","2024-09"
"068760","셀트리온제약","2727641923900","65900","41390621","41600387","209766","2024-09"
"068940","셀피글로벌","29334496224","778","37705008","38260597","555589","2024-09"
"060230","소니드","42927294228","938","45764706","46066730","302024","2024-09"
"290690","소룩스","430538295600","9450","45559608","45564340","4732","2024-09"
"032680","소프트센","47134292416","452","104279408","105590764","1311356","2024-09"
"258790","소프트캠프","21101213760","880","23978652","24991284","1012632","2024-09"
"066910","손오공","56623239379","1681","33684259","33784259","100000","2024-09"
"336370","솔루스첨단소재","917674734860","13070","70212298","70217344","5046","2024-09"
"248070","솔루엠","997755828000","20500","48671016","50005551","1334535","2024-09"
"035610","솔본","102411110550","3990","25666945","27345997","1679052","2024-09"
"357780","솔브레인","1591215681000","205500","7743142","7778566","35424","2024-09"
"036830","솔브레인홀딩스","1099196747600","53200","20661593","20964056","302463","2024-09"
"304100","솔트룩스","233513434000","19250","12130568","12130568","0","2024-09"
"328380","솔트웨어","31962890337","933","34258189","34262778","4589","2024-09"
"004430","송원산업","306960000000","12790","24000000","24000000","0","2024-09"
"086980","쇼박스","255371420000","4090","62438000","62638000","200000","2024-09"
"050960","수산아이앤티","68455140000","10140","6751000","6751000","0","2024-09"
"126720","수산인더스트리","313150393750","22250","14074175","14286000","211825","2024-09"
"017550","수산중공업","107076907080","1716","62399130","62399130","0","2024-09"
"084180","수성웹툰","73653986571","627","117470473","117470473","0","2024-09"
"253840","수젠텍","90514834560","5920","15289668","16743200","1453532","2024-09"
"298830","슈어소프트테크","264620517720","5070","52193396","52619061","425665","2024-09"
"236200","슈프리마","175590900700","25450","6899446","7193273","293827","2024-09"
"094840","슈프리마에이치큐","55745533620","6090","9153618","10471840","1318222","2024-09"
"192440","슈피겐코리아","133560778800","22150","6029832","6216363","186531","2024-09"
"424960","스마트레이더시스템","183659918400","11760","15617340","15617340","0","2024-09"
"099440","스맥","129380657240","3470","37285492","40243394","2957902","2024-09"
"053210","스카이라이프","237414534640","5020","47293732","47522955","229223","2024-09"
"276040","스코넥","43187390560","3440","12554474","12554474","0","2024-09"
"159910","스킨앤스킨","26228694750","725","36177510","36410098","232588","2024-09"
"060240","스타코링크","27377975210","901","30386210","31136323","750113","2024-09"
"115570","스타플렉스","24735206430","3135","7890018","7984508","94490","2024-09"
"330730","스톤브릿지벤처스","66166189320","3795","17435096","18150830","715734","2024-09"
"352090","스톰테크","93652398030","3485","26872998","26872998","0","2024-09"
"253450","스튜디오드래곤","1107655651300","36850","30058498","30058498","0","2024-09"
"408900","스튜디오미르","125918296350","3850","32706051","32706134","83","2024-09"
"204630","스튜디오산타클로스","18990846450","4650","4084053","4095906","11853","2024-09"
"415380","스튜디오삼익","34869818000","8600","4054630","4225498","170868","2024-09"
"026890","스틱인베스트먼트","293850663600","8040","36548590","41678175","5129585","2024-09"
"013810","스페코","63751294500","4350","14655470","14655470","0","2024-09"
"203690","스피어파워","70329086940","5340","13170241","13337850","167609","2024-09"
"049830","승일","41707133560","7060","5907526","6132112","224586","2024-09"
"020710","시공테크","69228182550","3670","18863265","20047970","1184705","2024-09"
"033170","시그네틱스","85728319000","1000","85728319","85728319","0","2024-09"
"048870","시너지이노베이션","243989614800","2950","82708344","82708344","0","2024-09"
"025320","시노펙스","616862972180","7390","83472662","83817936","345274","2024-09"
"134790","시디즈","49949000500","29750","1678958","2000000","321042","2024-09"
"269620","시스웍","131663951937","889","148103433","148582691","479258","2024-09"
"429270","시지트로닉스","32219687500","7150","4506250","4506250","0","2024-09"
"418250","시큐레터","52279100100","6550","7981542","7981542","0","2024-09"
"131090","시큐브","33628919020","866","38832470","44000000","5167530","2024-09"
"232830","시큐센","24234467040","2070","11707472","11707472","0","2024-09"
"462870","시프트업","3406747648000","58400","58334720","58334720","0","2024-09"
"016590","신대양제지","175445172760","5720","30672233","40297820","9625587","2024-09"
"290520","신도기연","35249007360","2240","15736164","15929362","193198","2024-09"
"029530","신도리코","350084827400","40600","8622779","10080029","1457250","2024-09"
"004970","신라교역","148536850000","9410","15785000","16000000","215000","2024-09"
"001000","신라섬유","24763090800","1020","24277540","24277540","0","2024-09"
"025870","신라에스지","25000000000","6250","4000000","4000000","0","2024-09"
"215600","신라젠","348721997500","2540","137292125","137367125","75000","2024-09"
"065350","신성델타테크","1397254927200","51400","27183948","27483948","300000","2024-09"
"416180","신성에스티","242176972900","27050","8952938","9039778","86840","2024-09"
"011930","신성이엔지","321023580423","1577","203565999","205848151","2282152","2024-09"
"005390","신성통상","321906793600","2240","143708390","143708390","0","2024-09"
"004170","신세계","1397799448500","151500","9226399","9845181","618782","2024-09"
"035510","신세계 I&C","127119982700","9670","13145810","17200000","4054190","2024-09"
"034300","신세계건설","137970237960","18180","7589122","7760554","171432","2024-09"
"031430","신세계인터내셔날","453639900000","13100","34629000","35700000","1071000","2024-09"
"031440","신세계푸드","140951392400","36400","3872291","3872480","189","2024-09"
"006880","신송홀딩스","70888335570","6570","10789701","11828858","1039157","2024-09"
"162300","신스틸","107471226240","2620","41019552","41471382","451830","2024-09"
"290560","신시웨이","24570251560","6340","3875434","3877972","2538","2024-09"
"002800","신신제약","96484380000","6360","15170500","15170500","0","2024-09"
"472220","신영스팩10호","10106950000","2155","4690000","4690000","0","2024-09"
"430220","신영스팩8호","14703000000","2175","6760000","6760000","0","2024-09"
"445970","신영스팩9호","11845600000","2210","5360000","5360000","0","2024-09"
"005800","신영와코루","82080000000","9120","9000000","9000000","0","2024-09"
"001720","신영증권","642410851200","83400","7702768","16440000","8737232","2024-09"
"009270","신원","90963455472","1212","75052356","102586356","27534000","2024-09"
"017000","신원종합개발","37728882180","3370","11195514","11668027","472513","2024-09"
"002700","신일전자","105086282860","1495","70291828","71047521","755693","2024-09"
"012790","신일제약","85425155790","7390","11559561","11986415","426854","2024-09"
"138070","신진에스엠","41647646700","2475","16827332","17503204","675872","2024-09"
"226330","신테카바이오","92161189000","6040","15258475","15258475","0","2024-09"
"002870","신풍","28703809680","1036","27706380","34958700","7252320","2024-09"
"019170","신풍제약","582876273070","11830","49271029","52984990","3713961","2024-09"
"418210","신한제10호스팩","7923900000","2165","3660000","3660000","0","2024-09"
"452980","신한제11호스팩","37015990000","1958","18905000","18905000","0","2024-09"
"474660","신한제12호스팩","11674800000","2115","5520000","5520000","0","2024-09"
"474930","신한제13호스팩","7819200000","2160","3620000","3620000","0","2024-09"
"055550","신한지주","28595694403200","56800","503445324","509393214","5947890","2024-09"
"056700","신화인터텍","50044131975","1725","29011091","29135091","124000","2024-09"
"187270","신화콘텍","31781138815","3455","9198593","10143845","945252","2024-09"
"004080","신흥","135034971500","14300","9443005","9500000","56995","2024-09"
"243840","신흥에스이씨","308613880000","8000","38576735","38919035","342300","2024-09"
"257720","실리콘투","2441016683400","40100","60873234","60873234","0","2024-09"
"222800","심텍","555392094880","17440","31845877","31854143","8266","2024-09"
"036710","심텍홀딩스","75389794630","1627","46336690","48350145","2013455","2024-09"
"160980","싸이맥스","122747340280","12010","10220428","10924243","703815","2024-09"
"356890","싸이버원","35625610800","2990","11914920","11916325","1405","2024-09"
"217330","싸이토젠","166792824810","7230","23069547","23129547","60000","2024-09"
"102280","쌍방울","70634046631","269","262580099","262592129","12030","2024-09"
"010280","쌍용정보통신","40376739880","620","65123774","65123786","12","2024-09"
"004770","써니전자","58283840636","1604","36336559","36702884","366325","2024-09"
"208640","썸에이지","36759427056","264","139240254","139240254","0","2024-09"
"222420","쎄노텍","37050085820","815","45460228","45460231","3","2024-09"
"037760","쎄니트","47033318787","1547","30402921","33832921","3430000","2024-09"
"099320","쎄트렉아이","409030233300","37350","10951278","10951278","0","2024-09"
"049960","쎌바이오텍","93145479000","13610","6843900","9400000","2556100","2024-09"
"088280","쏘닉스","43958484600","2540","17306490","17306490","0","2024-09"
"403550","쏘카","593203028160","18080","32809902","32809902","0","2024-09"
"050890","쏠리드","267854377960","4420","60600538","61095231","494693","2024-09"
"109670","씨싸이트","58411342990","10010","5835299","5836602","1303","2024-09"
"066790","씨씨에스","103732051115","1715","60485161","65152039","4666878","2024-09"
"222080","씨아이에스","585311308320","8160","71729327","71729327","0","2024-09"
"004920","씨아이테크","63283162352","1264","50065793","50065793","0","2024-09"
"352480","씨앤씨인터내셔널","787771795200","78800","9997104","10013941","16837","2024-09"
"264660","씨앤지하이테크","121818691080","13060","9327618","9627896","300278","2024-09"
"352700","씨앤투스","78810750480","3080","25587906","27276899","1688993","2024-09"
"458870","씨어스테크놀로지","175974553600","14020","12551680","12551680","0","2024-09"
"297090","씨에스베어링","157075200000","5760","27270000","27270000","0","2024-09"
"112610","씨에스윈드","2552056029600","61600","41429481","42171403","741922","2024-09"
"359090","씨엔알리서치","70788826680","1254","56450420","56450891","471","2024-09"
"115530","씨엔플러스","33505759000","493","67963000","67963000","0","2024-09"
"115480","씨유메디칼","36959660544","768","48124558","48224558","100000","2024-09"
"340810","씨유박스","33913161600","3200","10597863","10597863","0","2024-09"
"376290","씨유테크","55267975000","3130","17657500","17657500","0","2024-09"
"189330","씨이랩","43681676280","7170","6092284","6092284","0","2024-09"
"096530","씨젠","1110799947400","24050","46187108","52225994","6038886","2024-09"
"101240","씨큐브","52415971920","5070","10338456","10340947","2491","2024-09"
"060590","씨티씨바이오","192226551000","8040","23908775","24181020","272245","2024-09"
"308170","씨티알모빌리티","49077000000","5700","8610000","8610000","0","2024-09"
"260930","씨티케이","101944898490","5410","18843789","19341591","497802","2024-09"
"052300","씨티프라퍼티","64251611019","381","168639399","168651433","12034","2024-09"
"413630","씨피시스템","102352914685","2765","37017329","38703425","1686096","2024-09"
"013990","아가방컴퍼니","133746694650","4450","30055437","32887536","2832099","2024-09"
"123860","아나패스","227314031250","18750","12123415","12123415","0","2024-09"
"025980","아난티","417887988770","4715","88629478","88629478","0","2024-09"
"008700","아남전자","102031519590","1323","77121330","77124820","3490","2024-09"
"125210","아모그린텍","112508107800","6820","16496790","16496790","0","2024-09"
"002790","아모레G","1777139347500","23300","76272075","82458180","6186105","2024-09"
"090430","아모레퍼시픽","7180062571000","122900","58421990","58492759","70769","2024-09"
"357580","아모센스","81795724560","7290","11220264","11220264","0","2024-09"
"052710","아모텍","50413283700","3450","14612546","14615109","2563","2024-09"
"074430","아미노로직스","111276611348","1267","87826844","87826844","0","2024-09"
"092040","아미코젠","237628305030","4335","54816218","55018347","202129","2024-09"
"083930","아바코","197576247510","13610","14516991","14912798","395807","2024-09"
"149950","아바텍","158399471750","11450","13834015","15607500","1773485","2024-09"
"036010","아비코전자","72845278320","5480","13292934","13292934","0","2024-09"
"002030","아세아","422660337000","251500","1680558","2115648","435090","2024-09"
"183190","아세아시멘트","416527480150","11090","37558835","38501886","943051","2024-09"
"002310","아세아제지","329649787500","8250","39957550","42782510","2824960","2024-09"
"050860","아세아텍","44049495350","2225","19797526","22500000","2702474","2024-09"
"012170","아센디오","55306052124","534","103569386","103569488","102","2024-09"
"136410","아셈스","90982365360","8560","10628781","11019106","390325","2024-09"
"246720","아스타","64444675000","4750","13567300","13567300","0","2024-09"
"067390","아스트","193950527496","564","343883914","344017311","133397","2024-09"
"159010","아스플로","89310298900","6910","12924790","13334739","409949","2024-09"
"127710","아시아경제","46596949470","1335","34904082","34904082","0","2024-09"
"267850","아시아나IDT","199467000000","17970","11100000","11100000","0","2024-09"
"020560","아시아나항공","738164698880","9920","74411764","74411764","0","2024-09"
"154030","아시아종묘","26833979880","2315","11591352","11591352","0","2024-09"
"227610","아우딘퓨쳐스","53659327280","1520","35302189","35437349","135160","2024-09"
"143160","아이디스","153224436000","15200","10080555","10716390","635835","2024-09"
"054800","아이디스홀딩스","81250802800","9200","8831609","10347756","1516147","2024-09"
"332370","아이디피","48246461550","3825","12613454","13273726","660272","2024-09"
"122900","아이마켓코리아","264300456000","8400","31464340","33428840","1964500","2024-09"
"339950","아이비김영","78791970090","1817","43363770","44946655","1582885","2024-09"
"469750","아이비젼웍스","58834305666","1737","33871218","33936481","65263","2024-09"
"460470","아이빔테크놀로지","85687815300","5690","15059370","15059370","0","2024-09"
"099190","아이센스","566496713000","20500","27633986","27637273","3287","2024-09"
"461300","아이스크림미디어","193082782170","15090","12795413","13063433","268020","2024-09"
"289010","아이스크림에듀","32012093225","2555","12529195","12864037","334842","2024-09"
"214430","아이쓰리시스템","241570533600","34800","6941682","7106760","165078","2024-09"
"040910","아이씨디","92322246660","5660","16311351","18574275","2262924","2024-09"
"368600","아이씨에이치","63334327155","3685","17187063","17538346","351283","2024-09"
"456010","아이씨티케이","105114073200","7950","13221896","13221896","0","2024-09"
"052860","아이앤씨","27573426091","1699","16229209","17862854","1633645","2024-09"
"464500","아이언디바이스","94207514700","6900","13653263","13653263","0","2024-09"
"010780","아이에스동서","661094774400","21900","30186976","30186976","0","2024-09"
"038880","아이에이","67941546253","223","304670611","315334702","10664091","2024-09"
"307180","아이엘사이언스","89510645210","3310","27042491","27042828","337","2024-09"
"101390","아이엠","33959021670","3230","10513629","10548085","34456","2024-09"
"461030","아이엠비디엑스","240824945000","17180","14017750","14017750","0","2024-09"
"451220","아이엠티","80084793870","10170","7874611","7874611","0","2024-09"
"090150","아이윈","37174022496","936","39715836","41875293","2159457","2024-09"
"123010","아이윈플러스","23862597152","736","32422007","32658542","236535","2024-09"
"031310","아이즈비전","45439757220","1860","24429977","25334636","904659","2024-09"
"185490","아이진","82711139040","3060","27029784","27029784","0","2024-09"
"059100","아이컴포넌트","30586178180","4630","6606086","7070860","464774","2024-09"
"262840","아이퀘스트","43284040400","2300","18819148","19290000","470852","2024-09"
"175250","아이큐어","77728944800","2080","37369685","37558368","188683","2024-09"
"052460","아이크래프트","28459887680","2380","11957936","14607936","2650000","2024-09"
"119830","아이텍","125405768780","5890","21291302","21434297","142995","2024-09"
"052770","아이톡시","67886205156","1386","48979946","48979946","0","2024-09"
"124500","아이티센","147812836990","6370","23204527","23204527","0","2024-09"
"372800","아이티아이즈","35969508900","6110","5886990","6026990","140000","2024-09"
"084850","아이티엠반도체","393085699000","19000","20688721","22682934","1994213","2024-09"
"114840","아이패밀리에스씨","363383018400","21100","17221944","17221944","0","2024-09"
"027360","아주IB투자","232794665528","1966","118410308","120945406","2535098","2024-09"
"139990","아주스틸","137095960980","5170","26517594","26517744","150","2024-09"
"032080","아즈텍WB","24537343901","1169","20990029","21491029","501000","2024-09"
"013310","아진산업","108845057310","2805","38803942","38806582","2640","2024-09"
"059120","아진엑스텍","73698015650","8050","9155033","9748596","593563","2024-09"
"158430","아톤","90296378900","4225","21371924","22602474","1230550","2024-09"
"321820","아티스트유나이티드","227898143000","17050","13366460","13366460","0","2024-09"
"001540","안국약품","83990047350","7390","11365365","13042420","1677055","2024-09"
"053800","안랩","456003607500","52500","8685783","10013855","1328072","2024-09"
"065660","안트로젠","152782556100","15700","9731373","9731373","0","2024-09"
"297570","알로이스","36040687938","1041","34621218","34621218","0","2024-09"
"001780","알루코","238202124720","2460","96830132","96830132","0","2024-09"
"260660","알리코제약","62305572650","4150","15013391","15327021","313630","2024-09"
"354320","알멕","214430832550","33550","6391381","6391381","0","2024-09"
"361570","알비더블유","65861169300","2300","28635291","28635291","0","2024-09"
"131370","알서포트","152096311760","2920","52087778","53267083","1179305","2024-09"
"140670","알에스오토메이션","105226332760","11390","9238484","9303140","64656","2024-09"
"096610","알에프세미","51550708615","2965","17386411","17386411","0","2024-09"
"061040","알에프텍","97254499020","3115","31221348","32089259","867911","2024-09"
"148250","알엔투테크놀로지","30849597500","4300","7174325","7391186","216861","2024-09"
"347860","알체라","53727989920","2440","22019668","22019668","0","2024-09"
"196170","알테오젠","20399930880000","384000","53124820","53148528","23708","2024-09"
"123750","알톤","20637432437","1621","12731297","12746297","15000","2024-09"
"085810","알티캐스트","32971151300","1130","29178010","29957754","779744","2024-09"
"043100","알파녹스","21792742560","2735","7968096","7975920","7824","2024-09"
"117670","알파홀딩스","37743429465","945","39940137","39940137","0","2024-09"
"314140","알피바이오","57002458780","6590","8649842","8666361","16519","2024-09"
"291650","압타머사이언스","45846680400","2700","16980252","16980252","0","2024-09"
"293780","압타바이오","228754350000","9250","24730200","24730200","0","2024-09"
"018250","애경산업","437438985360","17020","25701468","26409935","708467","2024-09"
"161000","애경케미칼","536357758860","11110","48277026","48648709","371683","2024-09"
"196300","애니젠","82366469640","13720","6003387","6003387","0","2024-09"
"310200","애니플러스","129450785460","2910","44484806","45520979","1036173","2024-09"
"299910","애닉","32483121920","6880","4721384","4721384","0","2024-09"
"179530","애드바이오텍","32585682860","3565","9140444","9140444","0","2024-09"
"205500","액션스퀘어","56963573445","1097","51926685","51928120","1435","2024-09"
"052790","액토즈소프트","70244837210","6430","10924547","11330638","406091","2024-09"
"290740","액트로","53100940630","5690","9332327","10065011","732684","2024-09"
"238090","앤디포스","97415136880","4280","22760546","23541303","780757","2024-09"
"092600","앤씨앤","28113833496","1148","24489402","25083517","594115","2024-09"
"129890","앱코","59438350248","1241","47895528","50643410","2747882","2024-09"
"174900","앱클론","299014904760","17160","17425111","17425111","0","2024-09"
"255440","야스","103306094640","8560","12068469","13058000","989531","2024-09"
"030960","양지사","128432254500","9350","13736070","15980000","2243930","2024-09"
"102120","어보브반도체","174721804860","10590","16498754","17780753","1281999","2024-09"
"263540","어스앤에어로스페이스","85022108500","5950","14289430","14294091","4661","2023-12"
"238120","얼라인드","42921004560","2985","14378896","14378896","0","2024-09"
"019990","에너토크","59617467910","6230","9569417","9756088","186671","2024-09"
"011090","에넥스","33980367453","573","59302561","59991641","689080","2024-09"
"270660","에브리봇","202428710100","16550","12231342","12231342","0","2024-09"
"038680","에스넷","70168087460","3860","18178261","19549677","1371416","2024-09"
"137310","에스디바이오센서","1143948807100","9350","122347466","124477353","2129887","2024-09"
"217480","에스디생명공학","54756837359","499","109733141","109733141","0","2024-09"
"121890","에스디시스템","19777671648","1488","13291446","13291446","0","2024-09"
"304360","에스바이오메딕스","366468835200","31200","11745796","11745796","0","2024-09"
"389500","에스비비테크","96942347640","16260","5962014","6174904","212890","2024-09"
"042110","에스씨디","71431095592","1478","48329564","48329564","0","2024-09"
"298060","에스씨엠생명과학","42046553550","2055","20460610","20467248","6638","2024-09"
"065420","에스아이리소스","18967304510","265","71574734","71577299","2565","2024-09"
"103230","에스앤더블류","26280000000","3650","7200000","7200000","0","2024-09"
"260970","에스앤디","99800013000","34500","2892754","2892754","0","2024-09"
"101490","에스앤에스텍","495472230000","23650","20950200","21451447","501247","2024-09"
"095910","에스에너지","29551101380","1585","18644228","19504503","860275","2024-09"
"275630","에스에스알","18450855280","3410","5410808","6017989","607181","2024-09"
"031330","에스에이엠티","312631939735","3205","97545067","99995067","2450000","2024-09"
"060540","에스에이티","39460730340","1510","26132934","26133306","372","2024-09"
"351320","에스에이티이엔지","35643379444","1619","22015676","22015886","210","2024-09"
"056190","에스에프에이","670706278900","21350","31414814","35908760","4493946","2024-09"
"080000","에스엔유","61349334618","1793","34216026","34322870","106844","2024-09"
"005850","에스엘","1529041338400","33200","46055462","46448520","393058","2024-09"
"214310","에스엘에너지","22487615640","6120","3674447","3679130","4683","2024-09"
"246250","에스엘에스바이오","49421223320","3220","15348206","15348206","0","2024-09"
"041510","에스엠","1538523168000","67200","22894690","23353627","458937","2024-09"
"010580","에스엠벡셀","136660709640","1230","111106268","111251760","145492","2024-09"
"007820","에스엠코어","96399060660","4930","19553562","20033946","480384","2024-09"
"464080","에스오에스랩","102896051800","5870","17529140","17529140","0","2024-09"
"109610","에스와이","186017448950","3895","47758010","48907400","1149390","2024-09"
"365330","에스와이스틸텍","140959050000","4605","30610000","30610000","0","2024-09"
"012750","에스원","2021852292200","59800","33810239","37999178","4188939","2024-09"
"031860","에스유홀딩스","18100982210","1205","15021562","15026356","4794","2024-09"
"306040","에스제이그룹","57243783680","6080","9415096","9865828","450732","2024-09"
"457940","에스케이증권제10호스팩","7017200000","2120","3310000","3310000","0","2024-09"
"472230","에스케이증권제11호스팩","8683950000","2090","4155000","4155000","0","2024-09"
"473000","에스케이증권제12호스팩","6967550000","2105","3310000","3310000","0","2024-09"
"473950","에스케이증권제13호스팩","9127300000","2065","4420000","4420000","0","2024-09"
"435870","에스케이증권제8호스팩","7830600000","2105","3720000","3720000","0","2024-09"
"455910","에스케이증권제9호스팩","10767900000","2145","5020000","5020000","0","2024-09"
"096630","에스코넥","58813662570","754","78002205","79052205","1050000","2024-09"
"069510","에스텍","89818800000","10680","8410000","10910000","2500000","2024-09"
"234300","에스트래픽","123015361050","4470","27520215","27809848","289633","2024-09"
"039440","에스티아이","317583362850","21550","14737047","15830000","1092953","2024-09"
"098660","에스티오","41448701920","3415","12137248","12500976","363728","2024-09"
"052020","에스티큐브","296657423640","6360","46644249","46694249","50000","2024-09"
"237690","에스티팜","2087178222000","103800","20107690","20107690","0","2024-09"
"050760","에스폴리텍","25079056856","1624","15442769","16334678","891909","2024-09"
"288620","에스퓨얼셀","78098546040","11190","6979316","6979316","0","2024-09"
"443670","에스피소프트","177867045300","7350","24199598","24201392","1794","2024-09"
"317830","에스피시스템스","55837241820","5490","10170718","10773818","603100","2024-09"
"058610","에스피지","512297016000","23100","22177360","22177360","0","2024-09"
"043340","에쎈테크","47215000000","497","95000000","95000000","0","2024-09"
"023960","에쓰씨엔지니어링","59036815288","1796","32871278","32871280","2","2024-09"
"298690","에어부산","279796761600","2400","116581984","116640000","58016","2024-09"
"054630","에이디칩스","12594094838","158","79709461","79709461","0","2024-09"
"200710","에이디테크놀로지","220876629050","17050","12954641","13440822","486181","2024-09"
"096690","에이루트","43346333240","1295","33472072","33477189","5117","2024-09"
"078520","에이블씨엔씨","185220804960","7120","26014158","26014161","3","2024-09"
"298380","에이비엘바이오","1938728286150","40350","48047789","48047789","0","2024-09"
"203400","에이비온","232067902400","9200","25224772","25224772","0","2024-09"
"195990","에이비프로바이오","142628640906","501","284687906","284689721","1815","2024-09"
"003800","에이스침대","295066612750","27950","10556945","11090000","533055","2024-09"
"088800","에이스테크","115463500679","911","126743689","127068928","325239","2024-09"
"241840","에이스토리","65978560350","7110","9279685","9539994","260309","2024-09"
"453860","에이에스텍","142289178750","25250","5635215","5657215","22000","2024-09"
"312610","에이에프더블류","33829002960","1670","20256888","20256888","0","2024-09"
"015260","에이엔피","32616798774","723","45113138","45116894","3756","2024-09"
"172670","에이엘티","84779912250","9570","8858925","8960259","101334","2024-09"
"445090","에이직랜드","396936629100","36850","10771686","10771686","0","2024-09"
"295310","에이치브이엠","190430896000","16000","11901931","11901931","0","2024-09"
"072990","에이치시티","79291049600","11200","7079558","7287341","207783","2024-09"
"239610","에이치엘사이언스","88922924460","17460","5092951","5392115","299164","2024-09"
"462020","에이치엠씨제6호스팩","8842075000","2035","4345000","4345000","0","2024-09"
"477340","에이치엠씨제7호스팩","14997470000","1997","7510000","7510000","0","2024-09"
"148930","에이치와이티씨","45402020200","4670","9722060","10175213","453153","2024-09"
"044780","에이치케이","24233065560","1320","18358383","18505787","147404","2024-09"
"357230","에이치피오","124426671165","3015","41269211","42089487","820276","2024-09"
"355690","에이텀","42375043200","7840","5404980","5404980","0","2024-09"
"071670","에이테크솔루션","65800000000","6580","10000000","10000000","0","2024-09"
"045660","에이텍","113228745540","15010","7543554","8260000","716446","2024-09"
"224110","에이텍모빌리티","67165727410","13690","4906189","5340000","433811","2024-09"
"021080","에이티넘인베스트","114986437500","2500","45994575","48000000","2005425","2024-09"
"200470","에이팩트","124753230405","2945","42361029","42362093","1064","2024-09"
"262260","에이프로","107320609950","7450","14405451","14468152","62701","2024-09"
"007460","에이프로젠","317981242550","1195","266093090","286851768","20758678","2024-09"
"003060","에이프로젠바이오로직스","177617952594","899","197572806","198407845","835039","2024-09"
"397030","에이프릴바이오","526008384000","24000","21917016","21917016","0","2024-09"
"244920","에이플러스에셋","95743579855","4235","22607693","22607693","0","2024-09"
"278470","에이피알","1984308631500","266500","7445811","7622678","176867","2024-09"
"230240","에치에프알","131762690960","10040","13123774","13309000","185226","2024-09"
"230360","에코마케팅","322861977540","10260","31468029","31468029","0","2024-09"
"038870","에코바이오","56821753965","4055","14012763","14014949","2186","2024-09"
"097780","에코볼트","60686382848","896","67730338","67730338","0","2024-09"
"448280","에코아이","206430198700","20900","9877043","9877043","0","2024-09"
"101360","에코앤드림","686990340900","39150","17547646","17786114","238468","2024-09"
"128540","에코캡","36933799294","1421","25991414","26690460","699046","2024-09"
"086520","에코프로","10618574057000","80600","131744095","133138340","1394245","2024-09"
"450080","에코프로머티","7860234052400","113800","69070598","69070598","0","2024-09"
"247540","에코프로비엠","16250637478400","166400","97660081","97801344","141263","2024-09"
"383310","에코프로에이치엔","712754053000","46750","15246076","15304932","58856","2024-09"
"038110","에코플라스틱","117723702340","2930","40178738","41169370","990632","2024-09"
"073540","에프알텍","15390000000","1350","11400000","11400000","0","2024-09"
"064850","에프앤가이드","143770183200","12600","11410332","11410332","0","2024-09"
"036810","에프에스티","403111038400","20200","19955992","21756789","1800797","2024-09"
"173940","에프엔씨엔터","55009278335","3685","14927891","15392808","464917","2024-09"
"083500","에프엔에스테크","79614264000","9960","7993400","8575722","582322","2024-09"
"054940","엑사이엔씨","24747466808","746","33173548","33173548","0","2024-09"
"373110","엑셀세라퓨틱스","77411895580","7090","10918462","10918462","0","2024-09"
"205100","엑셈","130962497120","1820","71957416","71963431","6015","2024-09"
"356680","엑스게이트","141810908540","4970","28533382","28543492","10110","2024-09"
"070300","엑스큐어","46351479900","5550","8351618","8351618","0","2024-09"
"317770","엑스페릭스","78795142110","3435","22938906","22938906","0","2024-09"
"373200","엑스플러스","42319025684","559","75704876","75705657","781","2024-09"
"069920","엑시온그룹","52332199920","1495","35004816","35194116","189300","2024-09"
"092870","엑시콘","151654221170","12130","12502409","13050797","548388","2024-09"
"317870","엔바이오니아","163329600000","19200","8506750","8506750","0","2024-09"
"067570","엔브이에이치코리아","107620943075","2575","41794541","42170000","375459","2024-09"
"236810","엔비티","59350120000","3680","16127750","16975426","847676","2024-09"
"333620","엔시스","107041685240","10360","10332209","10556344","224135","2024-09"
"101400","엔시트론","27723915716","446","62161246","62162413","1167","2024-09"
"036570","엔씨소프트","3794340627000","189900","19980730","21954022","1973292","2024-09"
"078860","엔에스이엔엠","94913040200","9020","10522510","10531054","8544","2024-09"
"422040","엔에이치스팩23호","15071800000","2105","7160000","7160000","0","2024-09"
"437780","엔에이치스팩24호","10638450000","2115","5030000","5030000","0","2024-09"
"438580","엔에이치스팩25호","6674200000","2210","3020000","3020000","0","2024-09"
"439410","엔에이치스팩26호","18304000000","2080","8800000","8800000","0","2024-09"
"440820","엔에이치스팩27호","16263000000","2085","7800000","7800000","0","2024-09"
"451700","엔에이치스팩29호","28771750000","2005","14350000","14350000","0","2024-09"
"466910","엔에이치스팩30호","18154500000","1995","9100000","9100000","0","2024-09"
"481890","엔에이치스팩31호","12848625000","2025","6345000","6345000","0","2024-09"
"265740","엔에프씨","56091704000","6280","8931800","8931800","0","2024-09"
"354200","엔젠바이오","39956603700","3100","12889227","12889227","0","2024-09"
"455900","엔젤로보틱스","372887255950","24950","14945381","14945381","0","2024-09"
"419080","엔젯","95424370650","9450","10097817","10517817","420000","2024-09"
"208860","엔지스테크널러지","41831348265","2205","18971133","18971133","0","2024-09"
"183490","엔지켐생명과학","121272772117","1519","79837243","85065562","5228319","2024-09"
"085310","엔케이","61999933092","786","78880322","79983352","1103030","2024-09"
"182400","엔케이맥스","172744574320","2020","85517116","85518831","1715","2024-09"
"348370","엔켐","3866367678000","186000","20786923","20786923","0","2024-09"
"069410","엔텔스","35647710830","3595","9915914","10244824","328910","2024-09"
"227950","엔투텍","46505412970","449","103575530","103575530","0","2024-09"
"291230","엔피","96569720970","2190","44095763","44095775","12","2024-09"
"198080","엔피디","55022397675","2555","21535185","21535185","0","2024-09"
"048830","엔피케이","22079263857","1181","18695397","18723923","28526","2024-09"
"096870","엘디티","15794416000","2365","6678400","6678400","0","2024-09"
"290650","엘앤씨바이오","438952640850","19350","22684891","22684891","0","2024-09"
"066970","엘앤에프","3463157426400","103200","33557727","36296338","2738611","2024-09"
"156100","엘앤케이바이오","134373580420","6740","19936733","19936743","10","2024-09"
"073110","엘엠에스","36905926640","6380","5784628","8895755","3111127","2024-09"
"083310","엘오티베큠","162932791330","10070","16180019","17810033","1630014","2024-09"
"037950","엘컴텍","101203281993","1199","84406407","84447519","41112","2024-09"
"170920","엘티씨","94163234900","10150","9277166","9805620","528454","2024-09"
"058630","엠게임","123335065620","6630","18602574","19543877","941303","2024-09"
"058970","엠로","570756521700","48150","11853718","11853718","0","2024-09"
"019590","엠벤처투자","104963185182","921","113966542","113966542","0","2024-09"
"169330","엠브레인","39242788780","2210","17756918","18256918","500000","2024-09"
"097520","엠씨넥스","307192952280","17790","17267732","17977732","710000","2024-09"
"373170","엠아이큐브솔루션","42772025700","8490","5037930","5037930","0","2024-09"
"179290","엠아이텍","279639457920","8640","32365678","32365678","0","2024-09"
"009780","엠에스씨","94864000000","5390","17600000","17600000","0","2024-09"
"123040","엠에스오토텍","180696145545","3285","55006437","69172213","14165776","2024-09"
"323230","엠에프엠코리아","6967193212","161","43274492","43274492","0","2024-06"
"032790","엠젠솔루션","64027052672","1496","42798832","42798832","0","2024-09"
"033160","엠케이전자","163255007300","7810","20903330","22066331","1163001","2024-09"
"347890","엠투아이","92262718320","5640","16358638","16913204","554566","2024-09"
"033310","엠투엔","83518982160","2110","39582456","40342231","759775","2024-09"
"259630","엠플러스","122531825150","10150","12072101","12282402","210301","2024-09"
"105550","엣지파운드리","132909217875","2325","57165255","57165255","0","2024-09"
"060850","영림원소프트랩","56429140000","6940","8131000","8131000","0","2024-09"
"014440","영보화학","66105000000","3390","19500000","20000000","500000","2024-09"
"143540","영우디에스피","35298934400","808","43686800","44599895","913095","2024-09"
"111770","영원무역","1839023871000","43000","42767997","44311468","1543471","2024-09"
"009970","영원무역홀딩스","1039798860800","89600","11604898","13635592","2030694","2024-09"
"003520","영진약품","473691455860","2590","182892454","182892731","277","2024-09"
"000670","영풍","656231121000","381500","1720134","1842040","121906","2024-09"
"036560","영풍정밀","485887500000","30850","15750000","15750000","0","2024-09"
"006740","영풍제지","59184510300","1340","44167545","46482148","2314603","2024-09"
"012280","영화금속","38883459840","768","50629505","51664505","1035000","2024-09"
"265560","영화테크","96543538000","9100","10609180","10690180","81000","2024-09"
"012160","영흥","32653575137","479","68170303","101310372","33140069","2024-09"
"036000","예림당","52402980175","2275","23034277","23034277","0","2024-09"
"250930","예선테크","18791211025","575","32680367","33000440","320073","2024-09"
"053280","예스24","180896120480","7240","24985652","25000000","14348","2024-09"
"015360","예스코홀딩스","202491300000","47300","4281000","6000000","1719000","2024-09"
"122640","예스티","385591453750","19130","20156375","20930108","773733","2024-09"
"045060","오공","45912749540","2710","16941974","16941974","0","2024-09"
"080520","오디텍","36067965680","3485","10349488","11746609","1397121","2024-09"
"007310","오뚜기","1410124070000","410000","3439327","4007830","568503","2024-09"
"039830","오로라","57225407100","5790","9883490","10762890","879400","2024-09"
"322310","오로스테크놀로지","161467813260","17530","9210942","9366542","155600","2024-09"
"046120","오르비텍","64004483840","2360","27120544","27449486","328942","2024-09"
"014940","오리엔탈정공","172396488865","3785","45547289","45573661","26372","2024-09"
"002630","오리엔트바이오","54422769834","459","118568126","118583005","14879","2024-09"
"065500","오리엔트정공","38611216218","1217","31726554","31742912","16358","2024-09"
"271560","오리온","3913350012000","99000","39528788","39536132","7344","2024-09"
"001800","오리온홀딩스","960100181880","15960","60156653","62645422","2488769","2024-09"
"010470","오리콤","74154256650","6390","11604735","11975050","370315","2024-09"
"417860","오브젠","44084609300","9950","4430614","4430614","0","2024-09"
"352910","오비고","84041383300","6650","12637802","12637802","0","2024-09"
"053980","오상자이엘","72093706360","3820","18872698","18982783","110085","2024-09"
"036220","오상헬스케어","179896415040","13120","13711617","14489416","777799","2024-09"
"052420","오성첨단소재","152752888197","1833","83334909","86315192","2980283","2024-09"
"039200","오스코텍","1527854831200","39950","38244176","38244176","0","2024-09"
"226400","오스테오닉","123563974560","6240","19801919","20661601","859682","2024-09"
"031510","오스템","34995081128","1336","26193923","28000000","1806077","2024-09"
"368970","오에스피","31496559200","3370","9346160","9346160","0","2024-09"
"138080","오이솔루션","105910257200","10390","10193480","10624095","430615","2024-09"
"080580","오킨스전자","104076849250","6050","17202785","17679298","476513","2024-09"
"067170","오텍","50856366620","3580","14205689","15391605","1185916","2024-09"
"353590","오토앤","67854253900","5270","12875570","12875570","0","2024-09"
"173130","오파스넷","92866758080","7120","13043084","13046473","3389","2024-09"
"440320","오픈놀","46132525000","4705","9805000","9805000","0","2024-09"
"049480","오픈베이스","67494456000","2250","29997536","31422383","1424847","2024-09"
"394280","오픈엣지테크놀로지","290178982560","13280","21850827","21850827","0","2024-09"
"309930","오하임앤컴퍼니","41172729135","2005","20535027","21290990","755963","2024-09"
"244460","올리패스","18290883206","454","40288289","40290730","2441","2024-09"
"226950","올릭스","514212416900","30100","17083469","17083469","0","2024-09"
"057540","옴니시스템","48306092516","814","59344094","61449355","2105261","2024-09"
"131030","옵투스제약","107530811520","7040","15274263","16153162","878899","2024-09"
"082210","옵트론텍","61099464810","2190","27899299","28566538","667239","2024-09"
"109080","옵티시스","34388822610","7230","4756407","5636000","879593","2024-09"
"380540","옵티코어","34909538432","1216","28708502","29779596","1071094","2024-09"
"153710","옵티팜","82445163960","5620","14669958","14669958","0","2024-09"
"432430","와이랩","87202519200","5310","16422320","16422320","0","2024-09"
"338840","와이바이오로직스","188015938680","12730","14769516","14769516","0","2024-09"
"122990","와이솔","172393650590","6230","27671533","28186941","515408","2024-09"
"232140","와이씨","1000396946180","12470","80224294","82045350","1821056","2024-09"
"112290","와이씨켐","191695933200","18960","10110545","10110545","0","2024-09"
"065530","와이어블","71088395874","1486","47838759","52860000","5021241","2024-09"
"067900","와이엔텍","118190773270","6530","18099659","18199659","100000","2024-09"
"007530","와이엠","52125527100","2740","19023915","19174452","150537","2024-09"
"155650","와이엠씨","77244060880","4270","18089944","19474358","1384414","2024-09"
"273640","와이엠텍","123734241950","11710","10566545","10966000","399455","2024-09"
"251370","와이엠티","135736340480","8320","16314464","16314464","0","2024-09"
"066430","와이오엠","22312719540","570","39145122","39153476","8354","2024-09"
"273060","와이즈버즈","47633838800","944","50459575","50459582","7","2024-09"
"019210","와이지-원","173576644230","5170","33573819","33573819","0","2024-09"
"122870","와이지엔터테인먼트","719618866400","38800","18546878","18691049","144171","2024-09"
"011690","와이투솔루션","100381251690","2745","36568762","36574394","5632","2024-09"
"332570","와이팜","110569531840","2680","41257288","42233850","976562","2024-09"
"079000","와토스코리아","35960200540","5060","7106759","7200000","93241","2024-09"
"403490","우듬지팜","86623864060","1916","45210785","45212464","1679","2024-09"
"316140","우리금융지주","12192466669520","16420","742537556","742591501","53945","2024-09"
"032820","우리기술","378875042100","2385","158857460","158859048","1588","2024-09"
"041190","우리기술투자","596493054960","7660","77871156","84000000","6128844","2024-09"
"115440","우리넷","82853012880","7920","10461239","10754239","293000","2024-09"
"046970","우리로","48997648253","1129","43399157","43824999","425842","2024-09"
"082850","우리바이오","191425917790","4055","47207378","48456578","1249200","2024-09"
"215360","우리산업","111138423710","12170","9132163","9132163","0","2024-09"
"072470","우리산업홀딩스","58350722610","3090","18883729","18887341","3612","2024-09"
"073560","우리손에프앤지","96655749628","1396","69237643","69237643","0","2024-09"
"037400","우리엔터프라이즈","32496120240","1340","24250836","26223346","1972510","2024-09"
"153490","우리이앤엘","43346288700","857","50579100","51480000","900900","2024-09"
"101170","우림피티에스","70578256680","5340","13216902","13500000","283098","2024-09"
"006980","우성","43249838600","16850","2566756","3090000","523244","2024-09"
"066590","우수AMS","116033811000","3000","38677937","39073104","395167","2024-09"
"017370","우신시스템","126874960320","8160","15548402","18314054","2765652","2024-09"
"103840","우양","66202201260","4045","16366428","16366428","0","2024-09"
"046940","우원개발","44372529250","2455","18074350","18074350","0","2024-09"
"215380","우정바이오","34427973840","2190","15720536","15879576","159040","2024-09"
"065680","우주일렉트로","119532063770","14870","8038471","9530000","1491529","2024-09"
"105840","우진","163297485440","8240","19817656","20323614","505958","2024-09"
"018620","우진비앤지","30851498628","1068","28887171","28889293","2122","2024-09"
"010400","우진아이엔에스","23725078080","3520","6740079","7622000","881921","2024-09"
"457550","우진엔텍","171148917940","18460","9271339","9271339","0","2024-09"
"049800","우진플라임","46200000000","2310","20000000","20000000","0","2024-09"
"016880","웅진","72042218442","927","77715446","79927080","2211634","2024-09"
"095720","웅진씽크빅","193814913080","1720","112683089","115505985","2822896","2024-09"
"396470","워트","157492400000","9770","16120000","16120000","0","2024-09"
"005820","원림","32456777400","15780","2056830","2297970","241140","2024-09"
"307280","원바이오젠","47888385300","1350","35472878","36959013","1486135","2024-09"
"032940","원익","71317269520","3920","18193181","18193230","49","2024-09"
"240810","원익IPS","1483998545000","30500","48655690","49083901","428211","2024-09"
"074600","원익QnC","624340000000","23750","26288000","26288000","0","2024-09"
"104830","원익머트리얼즈","277376000000","22000","12608000","12608000","0","2024-09"
"014190","원익큐브","56632113600","1600","35395071","35399906","4835","2024-09"
"217820","원익피앤이","135601601270","3065","44241958","47454559","3212601","2024-09"
"030530","원익홀딩스","182173466925","2385","76383005","77237981","854976","2024-09"
"012620","원일특강","32868000000","7470","4400000","4400000","0","2024-09"
"382840","원준","235281962690","15490","15189281","15271581","82300","2024-09"
"336570","원텍","544061270340","6090","89336826","89340619","3793","2024-09"
"376980","원티드랩","41525146350","4650","8930139","9754994","824855","2024-09"
"008370","원풍","52807439685","4835","10921911","12000000","1078089","2024-09"
"008290","원풍물산","22734620893","569","39955397","40693679","738282","2024-09"
"101160","월덱스","326917661400","19800","16510993","16510993","0","2024-09"
"336060","웨이버스","69825040000","1450","48155200","48155200","0","2024-09"
"095270","웨이브일렉트로","60104112180","4710","12760958","14971256","2210298","2024-09"
"010600","웰바이오텍","49552926545","545","90922801","90923407","606","2024-09"
"065950","웰크론","62394533090","2290","27246521","28231302","984781","2024-09"
"076080","웰크론한텍","33484560477","1517","22072881","22594156","521275","2024-09"
"043590","웰킵스하이텍","19814166176","742","26703728","27136762","433034","2024-09"
"196700","웹스","19463415120","1355","14364144","14364144","0","2024-09"
"069080","웹젠","493569151250","16750","29466815","34950884","5484069","2024-09"
"053580","웹케시","93729860810","7330","12787157","13636248","849091","2024-09"
"071460","위니아","21802751835","613","35567295","35967295","400000","2024-09"
"377460","위니아에이드","26030247855","1691","15393405","15393405","0","2024-09"
"044340","위닉스","101170585600","6400","15807904","17873425","2065521","2024-09"
"330350","위더스제약","95169692800","7210","13199680","13202139","2459","2024-09"
"348350","위드텍","79850312000","8170","9773600","10183600","410000","2024-09"
"112040","위메이드","1151317894250","34250","33615121","33948483","333362","2024-09"
"101730","위메이드맥스","332116403540","10060","33013559","33295292","281733","2024-09"
"123420","위메이드플레이","81128119800","7800","10401041","11469842","1068801","2024-09"
"065370","위세아이텍","31252923000","4500","6945094","7383954","438860","2024-09"
"038620","위즈코프","38459641212","612","62842551","66546465","3703914","2024-09"
"299900","위지윅스튜디오","221108608620","1305","169431884","171048884","1617000","2024-09"
"036090","위지트","83033586240","704","117945435","118392284","446849","2024-09"
"136540","윈스","154531800000","12500","12362544","13644162","1281618","2024-09"
"097800","윈팩","188300020293","1617","116450229","116450229","0","2024-09"
"192390","윈하이텍","41514965800","3800","10924991","10924991","0","2024-09"
"008600","윌비스","28293737700","430","65799390","67236039","1436649","2024-09"
"335870","윙스풋","19533945162","1171","16681422","16681422","0","2024-09"
"033270","유나이티드제약","325119044900","22100","14711269","16333822","1622553","2024-09"
"014830","유니드","478002888000","72000","6638929","6767600","128671","2024-09"
"446070","유니드비티플러스","45911215350","4490","10225215","10611215","386000","2024-09"
"036200","유니셈","205912371000","7000","29416053","30664223","1248170","2024-09"
"018000","유니슨","122083883900","725","168391564","168391564","0","2024-09"
"000910","유니온","67988600745","4355","15611619","15611619","0","2024-09"
"047400","유니온머티리얼","97860000000","2330","42000000","42000000","0","2024-09"
"203450","유니온커뮤니티","35157106665","2855","12314223","14079007","1764784","2024-09"
"011330","유니켐","143487260791","1597","89848003","96997167","7149164","2024-09"
"077500","유니퀘스트","102168482460","4730","21600102","21794015","193913","2024-09"
"011320","유니크","78635228650","4070","19320695","19320695","0","2024-09"
"086390","유니테스트","191738464310","9430","20332817","21134126","801309","2024-09"
"241690","유니테크노","96047521050","3925","24470706","24470706","0","2024-09"
"142210","유니트론텍","96726970270","5110","18928957","19246092","317135","2024-09"
"088340","유라클","56334184680","13010","4330068","4330068","0","2024-09"
"048430","유라테크","77421955520","6760","11452952","11520000","67048","2024-09"
"206650","유바이오로직스","448275946890","12270","36534307","36534307","0","2024-09"
"089850","유비벨록스","100810224900","6930","14546930","14730199","183269","2024-09"
"084440","유비온","18884862400","958","19712800","19712800","0","2024-09"
"032620","유비케어","196374024540","3870","50742642","52197139","1454497","2024-09"
"264450","유비쿼스","133270892600","13400","9945589","10245706","300117","2024-09"
"078070","유비쿼스홀딩스","162321944620","9830","16512914","18150700","1637786","2024-09"
"002920","유성기업","54116225000","2110","25647500","25947500","300000","2024-09"
"024800","유성티엔에스","67131845280","2010","33398928","37051812","3652884","2024-09"
"000700","유수홀딩스","128619309000","5250","24498916","26041812","1542896","2024-09"
"054930","유신","68700000000","22900","3000000","3000000","0","2024-09"
"069330","유아이디","18099654353","1283","14107291","14191091","83800","2024-09"
"049520","유아이엘","106710830640","4990","21384936","21784936","400000","2024-09"
"435380","유안타제10호스팩","12061650000","2105","5730000","5730000","0","2024-09"
"444920","유안타제11호스팩","10820600000","2065","5240000","5240000","0","2024-09"
"446150","유안타제12호스팩","9802350000","2055","4770000","4770000","0","2024-09"
"449020","유안타제13호스팩","19605950000","2015","9730000","9730000","0","2024-09"
"450940","유안타제14호스팩","9579400000","2110","4540000","4540000","0","2024-09"
"473050","유안타제15호스팩","14230300000","2030","7010000","7010000","0","2024-09"
"474490","유안타제16호스팩","11130200000","2020","5510000","5510000","0","2024-09"
"430700","유안타제9호스팩","11030200000","2105","5240000","5240000","0","2024-09"
"003470","유안타증권","567442903335","2945","192680103","199596576","6916473","2024-09"
"263770","유에스티","49964400375","2125","23512659","23700172","187513","2024-09"
"072130","유엔젤","57438412620","4805","11953884","13195454","1241570","2024-09"
"000220","유유제약","75168516085","4645","16182673","17032351","849678","2024-09"
"388720","유일로보틱스","391707442800","34200","11453434","11453434","0","2024-09"
"340930","유일에너테크","82021202250","2405","34104450","34204450","100000","2024-09"
"023410","유진기업","239200471330","3490","68538817","77310863","8772046","2024-09"
"056080","유진로봇","216820238560","5780","37512152","37512152","0","2024-09"
"468760","유진스팩10호","9031200000","2130","4240000","4240000","0","2024-09"
"442130","유진스팩9호","7767700000","2245","3460000","3460000","0","2024-09"
"084370","유진테크","798530521000","35900","22243190","22916042","672852","2024-09"
"240600","유진테크놀로지","48474005650","7070","6856295","6928151","71856","2024-09"
"001200","유진투자증권","395367519225","4305","91839145","96866418","5027273","2024-09"
"221800","유투바이오","32168508600","2850","11287196","11287196","0","2024-09"
"179900","유티아이","370225276200","23400","15821593","16286895","465302","2024-09"
"263050","유틸렉스","89227584000","2425","36794880","36798858","3978","2024-09"
"000100","유한양행","11349507203000","153800","73793935","80209064","6415129","2024-09"
"003460","유화증권","104323691400","2280","45756005","56702415","10946410","2024-09"
"191410","육일씨엔에쓰","19204093070","1714","11204255","11204255","0","2024-09"
"372170","윤성에프앤씨","439645544800","55100","7979048","7979048","0","2024-09"
"146060","율촌","30449674652","1268","24013939","24015595","1656","2024-09"
"008730","율촌화학","654720000000","26400","24800000","24800000","0","2024-09"
"072770","율호","158387240220","2255","70238244","70238244","0","2024-09"
"008250","이건산업","52859961880","5170","10224364","10952635","728271","2024-09"
"039020","이건홀딩스","71150540985","3285","21659221","22584709","925488","2024-09"
"025820","이구산업","157171708300","4700","33440789","33442000","1211","2024-09"
"067920","이글루","52877383450","5050","10470769","10996119","525350","2024-09"
"044960","이글벳","63215719550","5150","12274897","12641883","366986","2024-09"
"303530","이노뎁","53551778700","7530","7111790","7339299","227509","2024-09"
"296640","이노룰스","29522087680","5840","5055152","5178252","123100","2024-09"
"302430","이노메트리","95326992500","9700","9827525","9833208","5683","2024-09"
"214320","이노션","800000000000","20000","40000000","40000000","0","2024-09"
"462350","이노스페이스","196889574000","21000","9375694","9375694","0","2024-09"
"274400","이노시뮬레이션","43087241260","5510","7819826","7819826","0","2024-09"
"056090","이노시스","123250989750","1310","94084725","94084725","0","2024-09"
"073490","이노와이어리스","127440458960","16760","7603846","7603846","0","2024-09"
"215790","이노인스트루먼트","19617542436","487","40282428","40283149","721","2024-09"
"344860","이노진","22660410000","1895","11958000","12030000","72000","2024-09"
"088390","이녹스","112723866340","12010","9385834","9385844","10","2024-09"
"272290","이녹스첨단소재","476052757700","24700","19273391","20227658","954267","2024-09"
"053350","이니텍","70271030510","4190","16771129","19790916","3019787","2024-09"
"452400","이닉스","112485707200","12400","9071428","9071428","0","2024-09"
"264850","이랜시스","184494187080","6090","30294612","30294612","0","2024-09"
"054210","이랜텍","147081466710","5910","24886881","25291210","404329","2024-09"
"009730","이렘","47333724412","1028","46044479","46056774","12295","2024-09"
"164060","이루다","148702994160","7090","20973624","21200934","227310","2024-06"
"065440","이루온","34208284932","1294","26436078","27275020","838942","2024-09"
"139480","이마트","1682308568400","62800","26788353","27875819","1087466","2024-09"
"115610","이미지스","54998892550","3490","15758995","15758995","0","2024-09"
"478110","이베스트스팩6호","10115300000","2015","5020000","5020000","0","2024-09"
"131400","이브이첨단소재","136749121830","2295","59585674","59589882","4208","2024-09"
"351330","이삭엔지니어링","68463175200","8260","8288520","8288520","0","2024-09"
"080010","이상네트웍스","49802198250","5250","9486133","9835071","348938","2024-09"
"457190","이수스페셜티케미컬","1372678620250","45850","29938465","30208280","269815","2024-09"
"086890","이수앱지스","238746118800","6650","35901672","35901672","0","2024-09"
"007660","이수페타시스","2884036706400","45600","63246419","63246419","0","2024-09"
"005950","이수화학","181488607320","8220","22078906","22722739","643833","2024-09"
"015020","이스타코","27573689931","709","38890959","42851600","3960641","2024-09"
"047560","이스트소프트","133813167180","13020","10277509","11603992","1326483","2024-09"
"239340","이스트에이드","47726845178","1769","26979562","26979634","72","2024-09"
"067010","이씨에스","32572683000","2860","11389050","12294000","904950","2024-09"
"093230","이아이디","354065768064","1392","254357592","254384360","26768","2024-09"
"418620","이에이트","147845307640","15320","9650477","9650477","0","2024-09"
"456070","이엔셀","256210782750","24050","10653255","10653255","0","2024-09"
"102710","이엔에프테크놀로지","270897370560","18960","14287836","14287836","0","2024-09"
"074610","이엔플러스","119454058812","1628","73374729","73374729","0","2024-09"
"041520","이엘씨","66679289700","5700","11698121","12188730","490609","2024-09"
"063760","이엘피","21410955500","2425","8829260","9325130","495870","2024-09"
"123570","이엠넷","54450478950","2550","21353129","22276078","922949","2024-09"
"083470","이엠앤아이","28786205778","1349","21338922","21340329","1407","2024-09"
"095190","이엠코리아","99930097260","2205","45319772","45319772","0","2024-09"
"091120","이엠텍","469279718900","28550","16437118","17132936","695818","2024-09"
"102460","이연제약","289237428070","15770","18340991","18586811","245820","2024-09"
"039030","이오테크닉스","2104564406700","173900","12102153","12319550","217397","2024-09"
"294090","이오플로우","166787411320","5480","30435659","30435659","0","2024-09"
"088290","이원컴포텍","37472166628","1196","31331243","31331669","426","2024-09"
"084680","이월드","250987731060","1770","141800978","141806193","5215","2024-09"
"353810","이지바이오","117399391200","3510","33447120","34191720","744600","2024-09"
"099750","이지케어텍","116473439620","17330","6720914","6834776","113862","2024-09"
"377330","이지트로닉스","47454720000","6000","7909120","8139954","230834","2024-09"
"035810","이지홀딩스","172900786920","2680","64515219","65145845","630626","2024-09"
"160600","이큐셀","106346383500","3100","34305285","34482552","177267","2024-09"
"092130","이크레더블","154037644000","12790","12043600","12043600","0","2024-09"
"096040","이트론","245561522409","271","906131079","906131295","216","2024-09"
"134060","이퓨쳐","15809476680","4110","3846588","4769250","922662","2024-09"
"001840","이화공영","52281942240","2640","19803766","19805760","1994","2024-09"
"000760","이화산업","33740000000","12050","2800000","2800000","0","2024-09"
"024810","이화전기","196810080587","899","218921113","218948640","27527","2024-09"
"014990","인디에프","54905402690","731","75109990","75112995","3005","2024-09"
"041830","인바디","311992985650","23950","13026847","13683782","656935","2024-09"
"352940","인바이오","24126360600","2220","10867730","10867730","0","2024-09"
"101140","인바이오젠","93257770480","9340","9984772","10044216","59444","2024-09"
"079950","인베니아","17432000000","800","21790000","23200000","1410000","2024-09"
"389470","인벤티지랩","227728079800","22700","10032074","10032074","0","2024-09"
"277410","인산가","53825863896","1428","37693182","38356789","663607","2024-09"
"060150","인선이엔티","262214497350","5850","44822991","46563612","1740621","2024-09"
"033230","인성정보","105976518615","2115","50107101","50515380","408279","2024-09"
"450520","인스웨이브시스템즈","52348297680","3560","14704578","14704578","0","2024-09"
"006490","인스코비","261807899730","2210","118465113","119368998","903885","2024-09"
"037330","인지디스플레","63918884620","1585","40327372","43885224","3557852","2024-09"
"100030","인지소프트","50739121700","18470","2747110","3283714","536604","2024-09"
"023800","인지컨트롤스","98899904440","6520","15168697","15809197","640500","2024-09"
"034590","인천도시가스","105110974500","25500","4121999","4374754","252755","2024-09"
"211050","인카금융서비스","254464584910","5210","48841571","51379800","2538229","2024-09"
"083640","인콘","27297356304","354","77111176","77720351","609175","2024-09"
"064090","인크레더블버즈","209408245960","4210","49740676","49742745","2069","2024-09"
"216050","인크로스","80508167300","6670","12070190","12843222","773032","2024-09"
"049070","인탑스","338017438750","21250","15906703","17200000","1293297","2024-09"
"119610","인터로조","312050211300","24900","12532137","13216478","684341","2024-09"
"017250","인터엠","21136267548","1044","20245467","21045467","800000","2024-09"
"129260","인터지스","63058585020","2235","28214132","29747874","1533742","2024-09"
"051370","인터플렉스","239339862720","10260","23327472","23327472","0","2024-09"
"064290","인텍플러스","186874737920","15080","12392224","12863962","471738","2024-09"
"189300","인텔리안테크","529750324800","50800","10428156","10733334","305178","2024-09"
"150840","인트로메딕","251537720850","5850","42997901","42997901","0","2024-09"
"048530","인트론바이오","200247471000","6120","32720175","34150762","1430587","2024-09"
"023810","인팩","73500000000","7350","10000000","10000000","0","2024-09"
"115310","인포바인","42851020000","20000","2142551","3192883","1050332","2024-09"
"039290","인포뱅크","52047908640","6240","8341011","8693978","352967","2024-09"
"071200","인피니트헬스케어","112253566065","4605","24376453","24396458","20005","2024-09"
"101930","인화정공","234270099700","24650","9503858","9615733","111875","2024-09"
"249420","일동제약","416750900720","14920","27932366","28062501","130135","2024-09"
"000230","일동홀딩스","93272663400","8260","11292090","11540400","248310","2024-09"
"013360","일성건설","68557572720","1269","54024880","54024880","0","2024-09"
"003120","일성아이에스","108914454540","15980","6815673","13300000","6484327","2024-09"
"333430","일승","92348843790","3010","30680679","30726747","46068","2024-09"
"068330","일신바이오","52304331290","1255","41676758","44216140","2539382","2024-09"
"003200","일신방직","171684528600","8060","21300810","23280000","1979190","2024-09"
"007110","일신석재","104684021520","1352","77429010","77456610","27600","2024-09"
"007570","일양약품","233287255520","12980","17972824","19085664","1112840","2024-09"
"178780","일월지엠엘","124101377000","8650","14346980","14349195","2215","2024-09"
"008500","일정실업","14888374200","12600","1181617","1200000","18383","2024-09"
"019540","일지테크","55759391720","4220","13213126","13513500","300374","2024-09"
"081000","일진다이아","181878045300","12810","14198130","14202975","4845","2024-09"
"020760","일진디스플","48929812557","951","51450907","51513741","62834","2024-09"
"103590","일진전기","1244376720900","26100","47677269","47685390","8121","2024-09"
"094820","일진파워","142493800050","9450","15078709","15078709","0","2024-09"
"271940","일진하이솔루스","755314352000","20800","36313190","36313190","0","2024-09"
"015860","일진홀딩스","179573521985","3905","45985537","49347483","3361946","2024-09"
"226320","잇츠한불","215628224400","12240","17616685","21929315","4312630","2024-09"
"049550","잉크테크","78229045230","3990","19606277","19606277","0","2024-09"
"389020","자람테크놀로지","212501450700","34650","6132798","6197730","64932","2024-09"
"254120","자비스","60871520940","1982","30712170","30754270","42100","2024-09"
"043910","자연과환경","71548745474","631","113389454","113391457","2003","2024-09"
"234920","자이글","52426659505","3905","13425521","13530910","105389","2024-09"
"289220","자이언트스텝","180955874100","8180","22121745","22121745","0","2024-09"
"317400","자이에스앤디","152640642600","4005","38112520","38782520","670000","2024-09"
"033240","자화전자","344132006400","16320","21086520","22155870","1069350","2024-09"
"174880","장원테크","11454988050","2650","4322637","4381265","58628","2024-09"
"049630","재영솔루텍","53873313172","644","83654213","83654213","0","2024-09"
"417840","저스템","59858640640","8440","7092256","7249175","156919","2024-09"
"000950","전방","22686847700","19910","1139470","1680000","540530","2024-09"
"079900","전진건설로봇","252982298400","17420","14522520","15360574","838054","2024-09"
"110020","전진바이오팜","22646905000","2500","9058762","9058762","0","2024-09"
"208140","정다운","84161907700","2575","32684236","32684246","10","2024-09"
"040420","정상제이엘에스","96803048160","6480","14938742","15677552","738810","2024-09"
"045510","정원엔시스","27702362160","880","31479957","32209292","729335","2024-09"
"217190","제너셈","66908797620","7630","8769174","8769174","0","2024-09"
"095700","제넥신","425234989300","9350","45479678","45540494","60816","2024-09"
"072520","제넨바이오","28838655818","389","74135362","74163194","27832","2024-09"
"122310","제노레이","81833202740","6070","13481582","14553844","1072262","2024-09"
"361390","제노코","115737174270","15430","7500789","7500789","0","2024-09"
"187420","제노포커스","75406024785","3185","23675361","23675361","0","2024-09"
"225220","제놀루션","54980596125","3045","18056025","19190021","1133996","2024-09"
"123330","제닉","146321628200","18700","7824686","7968680","143994","2024-09"
"381620","제닉스","137956792000","31550","4372640","4372640","0","2024-09"
"159580","제로투세븐","87041803420","4345","20032636","20032636","0","2024-09"
"147830","제룡산업","124487863500","6500","19151979","20000000","848021","2024-09"
"033100","제룡전기","983019430800","61200","16062409","16062409","0","2024-09"
"079370","제우스","382309694060","12460","30682961","31016990","334029","2024-09"
"054950","제이브이엠","244756820000","21250","11517968","12089892","571924","2024-09"
"023440","제이스코홀딩스","103994267720","1772","58687510","58687510","0","2024-09"
"090470","제이스텍","91956065300","5300","17350201","17476594","126393","2024-09"
"287410","제이시스메디칼","959370754160","12880","74485307","75692193","1206886","2024-06"
"137950","제이씨케미칼","103602868800","4800","21583931","22267814","683883","2024-09"
"033320","제이씨현시스템","69050080905","3655","18891951","19114432","222481","2024-09"
"417500","제이아이테크","115508760320","3655","31602944","32784744","1181800","2024-09"
"204270","제이앤티씨","1423862093950","24950","57068621","57848466","779845","2024-09"
"194370","제이에스코퍼레이션","208702305300","15670","13318590","13335601","17011","2024-09"
"026040","제이에스티나","24967636617","1743","14324519","16503790","2179271","2024-09"
"452160","제이엔비","61162192920","6360","9616697","9617527","830","2024-09"
"126880","제이엔케이글로벌","88965592320","3840","23168123","23204903","36780","2024-09"
"322510","제이엘케이","193220012160","12180","15863712","16195712","332000","2024-09"
"033050","제이엠아이","30183682944","948","31839328","32579342","740014","2024-09"
"094970","제이엠티","56988376940","3410","16712134","16748240","36106","2024-09"
"418550","제이오","541225665900","18300","29575173","31772273","2197100","2024-09"
"025620","제이준코스메틱","23714097400","5300","4474358","4484846","10488","2024-09"
"420570","제이투케이바이오","99306817280","17380","5713856","5732807","18951","2024-09"
"089790","제이티","45604208800","4990","9139120","10315513","1176393","2024-09"
"030000","제일기획","1835170497000","18120","101278725","115041225","13762500","2024-09"
"052670","제일바이오","56184286080","2080","27011676","29129064","2117388","2024-09"
"271980","제일약품","221195628060","15180","14571517","14704872","133355","2024-09"
"412540","제일엠앤에스","249062039850","12090","20600665","20600665","0","2024-09"
"001560","제일연마","55468900000","8150","6806000","9900000","3094000","2024-09"
"199820","제일일렉트릭","224644200000","10110","22220000","22220000","0","2024-09"
"038010","제일테크노스","54968760000","6610","8316000","9000000","684000","2024-09"
"002620","제일파마홀딩스","137392568750","8950","15351125","15973355","622230","2024-09"
"276730","제주맥주","30391769600","2560","11871785","11886605","14820","2024-09"
"080220","제주반도체","454721904000","13500","33683104","34442833","759729","2024-09"
"006220","제주은행","270524277080","8420","32128774","32128774","0","2024-09"
"089590","제주항공","713054332350","8850","80571111","80640985","69874","2024-09"
"216080","제테마","366104559500","20500","17858759","17858759","0","2024-09"
"229000","젠큐릭스","39558192975","2595","15244005","15244005","0","2024-09"
"082270","젬백스","900734093200","22700","39679916","39994174","314258","2024-09"
"044060","조광ILI","70075958688","732","95732184","95732184","0","2024-09"
"004910","조광페인트","64887097720","6340","10234558","12800000","2565442","2024-09"
"004700","조광피혁","190081380500","53500","3552923","6649138","3096215","2024-09"
"001550","조비","57733127360","11120","5191828","5192239","411","2024-09"
"462520","조선내화","204042087480","17220","11849134","11855168","6034","2024-09"
"120030","조선선재","91918716500","94900","968585","1257651","289066","2024-09"
"034940","조아제약","43619596416","1408","30979827","30979827","0","2024-09"
"067000","조이시티","118206727186","1691","69903446","69903446","0","2024-09"
"018470","조일알미늄","217300033236","1716","126631721","126631721","0","2024-09"
"002600","조흥","103320000000","172200","600000","600000","0","2024-09"
"185750","종근당","1445814571800","114600","12616183","13174420","558237","2024-09"
"063160","종근당바이오","169790431050","30950","5485959","5485962","3","2024-09"
"001630","종근당홀딩스","280872922000","59000","4760558","5009861","249303","2024-09"
"033340","좋은사람들","61369703214","633","96950558","96950558","0","2024-09"
"036930","주성엔지니어링","1337693484300","28300","47268321","47268321","0","2024-09"
"109070","주성코퍼레이션","216476814300","4100","52799223","52810230","11007","2024-09"
"044380","주연테크","20618874360","360","57274651","59199244","1924593","2024-09"
"072020","중앙백신","101507437440","10590","9585216","9658687","73471","2024-09"
"000440","중앙에너비스","98874520500","22300","4433835","6227130","1793295","2024-09"
"051980","중앙첨단소재","1293559707500","12970","99734750","99961003","226253","2024-09"
"228760","지노믹트리","415028937600","17300","23990112","24362333","372221","2024-09"
"314130","지놈앤컴퍼니","131361528750","4250","30908595","30908595","0","2024-09"
"013890","지누스","425586426150","20850","20411819","20735204","323385","2024-09"
"389030","지니너스","50127823035","1503","33351845","33351845","0","2024-09"
"043610","지니뮤직","134537238970","2315","58115438","58115438","0","2024-09"
"263860","지니언스","84284510130","9770","8626869","9444600","817731","2024-09"
"303030","지니틱스","44026939264","1232","35736152","35745668","9516","2024-09"
"036180","지더블유바이텍","53929030348","577","93464524","93464524","0","2024-09"
"208350","지란지교시큐리티","24687332340","3155","7824828","8838549","1013721","2024-09"
"144510","지씨셀","560512359300","37300","15027141","15800344","773203","2024-09"
"358570","지아이이노베이션","673879439640","15240","44217811","44217811","0","2024-09"
"382480","지아이텍","95325746760","2440","39067929","39357140","289211","2024-09"
"382800","지앤비에스 에코","110076022680","3480","31631041","31631041","0","2024-09"
"051160","지어소프트","139022720100","9570","14526930","15474430","947500","2024-09"
"053050","지에스이","109604667035","3655","29987597","29987597","0","2024-09"
"119850","지엔씨에너지","82181357970","5510","14914947","16448909","1533962","2024-09"
"065060","지엔코","34839289694","323","107861578","108008044","146466","2024-09"
"204840","지엘팜텍","86780794994","1129","76865186","76865206","20","2024-09"
"013870","지엠비코리아","74763337600","3920","19072280","19072280","0","2024-09"
"071320","지역난방공사","526253914800","45450","11578744","11578744","0","2024-09"
"270520","지오릿에너지","168635814732","1062","158790786","158790786","0","2024-09"
"311320","지오엘리먼트","89437230400","7090","12614560","12614560","0","2024-09"
"388050","지투파워","98313330870","5270","18655281","18709437","54156","2024-09"
"088790","진도","22953639936","1844","12447744","12447744","0","2024-09"
"018120","진로발효","117465311000","17750","6617764","6621120","3356","2024-09"
"109820","진매트릭스","69974391315","3505","19964163","20393640","429477","2024-09"
"086060","진바이오텍","30223160370","3510","8610587","8610587","0","2024-09"
"036890","진성티이씨","176871604200","8850","19985492","22482268","2496776","2024-09"
"363250","진시스템","67299025920","9920","6784176","7006491","222315","2024-09"
"003780","진양산업","84110000000","6470","13000000","13000000","0","2024-09"
"007370","진양제약","65265237000","5750","11350476","12574867","1224391","2024-09"
"010640","진양폴리","65900000000","6590","10000000","10000000","0","2024-09"
"100250","진양홀딩스","177188075640","3170","55895292","55895292","0","2024-09"
"051630","진양화학","42976000000","2720","15800000","15800000","0","2024-09"
"272450","진에어","523066385100","10150","51533634","52200000","666366","2024-09"
"285800","진영","44566992600","2550","17477252","17477270","18","2024-09"
"011000","진원생명과학","187200343995","2345","79829571","80039035","209464","2024-09"
"002780","진흥기업","118075854568","812","145413614","145471745","58131","2024-09"
"085660","차바이오텍","1017038840580","18060","56314443","56314443","0","2024-09"
"261780","차백신연구소","110517961760","4120","26824748","26824748","0","2024-09"
"351870","차이커뮤니케이션","141458995400","12710","11129740","11131089","1349","2024-09"
"009310","참엔지니어링","33589768792","398","84396404","84867419","471015","2024-09"
"094850","참좋은여행","63848439090","4770","13385417","14000000","614583","2024-09"
"004650","창해에탄올","73293810660","9660","7587351","9190885","1603534","2024-09"
"278280","천보","570975000000","57500","9930000","10000000","70000","2024-09"
"000650","천일고속","59008682900","41350","1427054","1429220","2166","2024-09"
"362320","청담글로벌","134827691200","6700","20123536","20551290","427754","2024-09"
"012600","청호ICT","116119947330","2490","46634517","46634517","0","2024-09"
"066360","체리부로","37498475730","782","47952015","47952015","0","2024-09"
"033250","체시스","43104000000","1347","32000000","32000000","0","2024-09"
"047820","초록뱀미디어","131865872400","5400","24419606","24453930","34324","2024-09"
"094360","칩스앤미디어","279947908000","13840","20227450","20823124","595674","2024-09"
"016920","카스","29145142334","1186","24574319","26493538","1919219","2024-09"
"284620","카이노스메드","121508758960","4370","27805208","28180793","375585","2024-09"
"035720","카카오","16392074550300","37350","438877498","443530908","4653410","2024-09"
"293490","카카오게임즈","1365464260730","16690","81813317","82667326","854009","2024-09"
"323410","카카오뱅크","10672061187200","22400","476431303","476963637","532334","2024-09"
"377300","카카오페이","3298091657000","24500","134615986","134615986","0","2024-09"
"140430","카티스","53417915920","3340","15993388","17922947","1929559","2024-09"
"042000","카페24","609289858800","25200","24178169","24253054","74885","2024-09"
"006380","카프로","618528628380","3660","168996893","168999996","3103","2024-09"
"313760","캐리","50420992440","6890","7317996","7417913","99917","2024-09"
"317530","캐리소프트","26781011400","3900","6866926","6971196","104270","2024-09"
"071850","캐스텍코리아","53859282360","2220","24260938","24529188","268250","2024-09"
"050110","캠시스","82833197031","1131","73238901","73824118","585217","2024-09"
"452300","캡스톤파트너스","40104201100","2845","14096380","14096380","0","2024-09"
"451760","컨텍","145774584660","9890","14739594","14940476","200882","2024-09"
"078340","컴투스","452873220150","39650","11421771","12737755","1315984","2024-09"
"063080","컴투스홀딩스","141461677500","21450","6594950","6595192","242","2024-09"
"307930","컴퍼니케이","85542800000","5480","15610000","15610000","0","2024-09"
"079190","케스피온","22637154214","601","37665814","38355514","689700","2024-09"
"263700","케어랩스","58878936265","3035","19399979","19414200","14221","2024-09"
"214370","케어젠","853478981420","17420","48994201","53715000","4720799","2024-09"
"221980","케이디켐","46661217260","12460","3744881","4034800","289919","2024-09"
"038530","케이바이오","32108121798","278","115496841","115714347","217506","2024-09"
"001620","케이비아이동국실업","63770906763","573","111293031","111293031","0","2024-09"
"424140","케이비제21호스팩","16692150000","2165","7710000","7710000","0","2024-09"
"192250","케이사인","65517422949","957","68461257","70671257","2210000","2024-09"
"431190","케이쓰리아이","47838364380","6390","7486442","7486442","0","2024-09"
"029460","케이씨","235843309100","20300","11617897","13554044","1936147","2024-09"
"115500","케이씨에스","83760000000","6980","12000000","12000000","0","2024-09"
"281820","케이씨텍","765132095200","38200","20029636","20861556","831920","2024-09"
"089150","케이씨티","39359250000","2295","17150000","17150000","0","2024-09"
"025880","케이씨피드","46013671440","2915","15785136","16715858","930722","2024-09"
"093320","케이아이엔엑스","364213826100","75300","4836837","4880000","43163","2024-09"
"093640","케이알엠","150865401600","4630","32584320","32584320","0","2024-09"
"073010","케이에스피","172298394200","4300","40069394","40191250","121856","2024-09"
"105330","케이엔더블유","66655692600","4200","15870403","16060028","189625","2024-09"
"053080","케이엔솔","211871409600","16350","12958496","12999807","41311","2024-09"
"199430","케이엔알시스템","88789215210","8170","10867713","10867713","0","2024-09"
"432470","케이엔에스","145906031920","16820","8674556","8674556","0","2024-09"
"272110","케이엔제이","136892254500","17100","8005395","8005395","0","2024-09"
"039420","케이엘넷","55461289770","2595","21372366","24154730","2782364","2024-09"
"083550","케이엠","38694006780","3355","11533236","12374226","840990","2024-09"
"032500","케이엠더블유","283922895790","7130","39820883","39820883","0","2024-09"
"225430","케이엠제약","20692162162","742","27887011","27887050","39","2024-09"
"102370","케이옥션","123228260400","4760","25888290","27229210","1340920","2024-09"
"068100","케이웨더","35772839550","3675","9734106","9939614","205508","2024-09"
"381970","케이카","646121598930","13410","48182073","48182073","0","2024-09"
"036030","케이티알파","213723454760","4360","49019141","49019283","142","2024-09"
"064820","케이프","144809968320","5190","27901728","30901728","3000000","2024-09"
"256940","케이피에스","108929702980","5810","18748658","18748658","0","2024-09"
"024880","케이피에프","82335892430","4255","19350386","20682798","1332412","2024-09"
"042040","케이피엠테크","56869471632","326","174446232","174460917","14685","2024-09"
"054410","케이피티유","23020304880","4020","5726444","5726444","0","2024-09"
"258610","케일럼","41517072765","1565","26528481","26787133","258652","2024-09"
"274090","켄코아에어로스페이스","130423582600","10100","12913226","12913226","0","2024-09"
"089010","켐트로닉스","313014051000","21000","14905431","15334346","428915","2024-09"
"220260","켐트로스","135712872120","5110","26558292","26558307","15","2024-09"
"052400","코나아이","204759071680","14020","14604784","14899999","295215","2024-09"
"402030","코난테크놀로지","173396724320","15140","11452888","11452888","0","2024-09"
"391710","코닉오토메이션","90263517900","2175","41500468","41503222","2754","2024-09"
"046070","코다코","144219271360","10280","14029112","14064588","35476","2024-09"
"047770","코데즈컴바인","53679446298","1422","37749259","37842602","93343","2024-09"
"080530","코디","70770782240","1640","43152916","43300427","147511","2024-09"
"104540","코렌텍","84513741400","6610","12785740","12785740","0","2024-09"
"027050","코리아나","79560000000","2600","30600000","40000000","9400000","2024-09"
"007810","코리아써키트","245419602890","10390","23620751","23620751","0","2024-09"
"190650","코리아에셋투자증권","36092200000","5650","6388000","6388000","0","2024-09"
"123410","코리아에프티","146443970340","5260","27841059","27841064","5","2024-09"
"003690","코리안리","1242937919440","8440","147267526","165367526","18100000","2024-09"
"036690","코맥스","45885746130","2885","15904938","15904938","0","2024-09"
"049430","코메론","97929633000","10900","8984370","9048000","63630","2024-09"
"183300","코미코","560558272000","54400","10304380","10460684","156304","2024-09"
"041960","코미팜","299302819200","4320","69283060","70622233","1339173","2024-09"
"089890","코세스","154485136320","9420","16399696","16584962","185266","2024-09"
"360350","코셈","44581684200","7860","5671970","5671970","0","2024-09"
"082660","코스나인","47827116000","480","99639825","99640869","1044","2024-09"
"192820","코스맥스","1548682863000","136500","11345662","11349509","3847","2024-09"
"044820","코스맥스비티아이","82649357350","8650","9554839","9603921","49082","2024-09"
"222040","코스맥스엔비티","61870056360","3010","20554836","20628000","73164","2024-09"
"241710","코스메카코리아","821292000000","76900","10680000","10680000","0","2024-09"
"005070","코스모신소재","3574889560000","110000","32498996","32510756","11760","2024-09"
"005420","코스모화학","842097680050","21950","38364359","38408228","43869","2024-09"
"355150","코스텍시스","62535453480","8280","7552591","7797350","244759","2024-09"
"071950","코아스","31689633600","9630","3290720","3290720","0","2024-09"
"166480","코아스템켐온","370761163380","15220","24360129","32870376","8510247","2024-09"
"045970","코아시아","115082732320","4640","24802313","26314876","1512563","2024-09"
"196450","코아시아씨엠","45127037916","996","45308271","45319582","11311","2024-09"
"384470","코어라인소프트","101627103600","7920","12831705","12832064","359","2024-09"
"029960","코엔텍","356582484800","7340","48580720","50000000","1419280","2024-09"
"002020","코오롱","186113519240","14740","12626426","12626426","0","2024-09"
"138490","코오롱ENP","227240000000","5980","38000000","38000000","0","2024-09"
"003070","코오롱글로벌","172364158220","9140","18858223","18932713","74490","2024-09"
"450140","코오롱모빌리티그룹","142288574240","2320","61331282","62777250","1445968","2024-09"
"102940","코오롱생명과학","238653264270","19210","12423387","12423387","0","2024-09"
"120110","코오롱인더","901022290250","32750","27512131","27519091","6960","2024-09"
"021240","코웨이","4796339171100","66700","71909133","73799619","1890486","2024-09"
"033290","코웰패션","131944661760","2490","52989824","56156301","3166477","2024-09"
"056360","코위버","44808081120","4840","9257868","9796800","538932","2024-09"
"282880","코윈테크","157834734550","14450","10922819","11141807","218988","2024-09"
"121850","코이즈","29638598016","976","30367416","30614175","246759","2024-09"
"448710","코츠테크놀로지","93204699000","21000","4438319","5166069","727750","2024-09"
"126730","코칩","113826919300","13900","8188987","8503460","314473","2024-09"
"015710","코콤","67802572645","4085","16597937","17530500","932563","2024-09"
"052330","코텍","100075802520","7960","12572337","15574552","3002215","2024-09"
"322780","코퍼스코리아","37595750250","1019","36894750","37932613","1037863","2024-09"
"036420","콘텐트리중앙","199069483940","10420","19104557","19262308","157751","2024-09"
"200130","콜마비앤에이치","429182988080","14740","29116892","29415558","298666","2024-09"
"024720","콜마홀딩스","242817513720","7080","34296259","34296259","0","2024-09"
"031820","콤텍시스템","69120387086","571","121051466","121051466","0","2024-09"
"294570","쿠콘","139097760120","13640","10197783","10254685","56902","2024-09"
"192400","쿠쿠홀딩스","711695016500","22900","31078385","35562185","4483800","2024-09"
"284740","쿠쿠홈시스","526925930000","23500","22422380","22437330","14950","2024-09"
"317690","퀀타매트릭스","138748878290","8390","16537411","16537411","0","2024-09"
"078940","퀀타피아","151577916950","2855","53092090","53094278","2188","2024-09"
"227100","퀀텀온","19161710308","1222","15680614","15680614","0","2024-09"
"432720","퀄리타스반도체","151780604080","10990","13810792","13810792","0","2024-09"
"365270","큐라클","82133890560","5920","13873968","13873968","0","2024-09"
"348080","큐라티스","34185280110","811","42152010","42152010","0","2024-09"
"060280","큐렉소","287629930000","7000","41089990","41089990","0","2024-09"
"372320","큐로셀","472723693750","33550","14090125","14090125","0","2024-09"
"051780","큐로홀딩스","19414297474","143","135764318","136422450","658132","2024-09"
"115180","큐리언트","169508230500","5250","32287282","32292671","5389","2024-09"
"445680","큐리옥스바이오시스템즈","416905514200","25900","16096738","16096738","0","2024-09"
"182360","큐브엔터","200972354060","14470","13888898","14571557","682659","2024-09"
"405100","큐알티","168503750250","14290","11791725","12289301","497576","2024-09"
"066310","큐에스아이","61685965500","6900","8939995","9271621","331626","2024-09"
"016600","큐캐피탈","50436286358","289","174520022","178247112","3727090","2024-09"
"355390","크라우드웍스","51755724860","12260","4221511","4224606","3095","2024-09"
"264900","크라운제과","102377759880","8520","12016169","12523850","507681","2024-09"
"005740","크라운해태홀딩스","87447028800","6080","14382735","14847347","464612","2024-09"
"259960","크래프톤","15203837500500","334500","45452429","47897003","2444574","2024-09"
"096240","크레버스","133535658810","15830","8435607","11138180","2702573","2024-09"
"040350","크레오에스지","110117961558","726","151677633","152074086","396453","2024-09"
"110790","크리스에프앤씨","134279491710","6630","20253317","23430960","3177643","2024-09"
"045520","크린앤사이언스","32725950000","5350","6117000","6500000","383000","2024-09"
"036170","클라우드에어","53522164704","888","60272708","61365626","1092918","2024-09"
"214150","클래시스","3955170274200","61800","63999519","63999519","0","2024-09"
"352770","클리노믹스","25644239712","667","38447136","38886113","438977","2024-09"
"237880","클리오","453887735700","25900","17524623","18071353","546730","2024-09"
"139670","키네마스터","42427024050","3005","14118810","14118810","0","2024-09"
"020120","키다리스튜디오","137689758280","3715","37063192","37063766","574","2024-09"
"413600","키움제6호스팩","8986600000","2620","3430000","3430000","0","2024-09"
"433530","키움제7호스팩","9400450000","2290","4105000","4105000","0","2024-09"
"446840","키움제8호스팩","13112400000","2230","5880000","5880000","0","2024-09"
"039490","키움증권","3289104504300","136300","24131361","25526706","1395345","2024-09"
"054780","키이스트","87633603525","4485","19539265","19547793","8528","2024-09"
"219130","타이거일렉","133862948000","21200","6314290","6314290","0","2024-09"
"360070","탑머티리얼","296249528000","37000","8006744","8076743","69999","2024-09"
"065130","탑엔지니어링","65474127120","4220","15515196","17189982","1674786","2024-09"
"134580","탑코미디어","50759518250","2345","21645850","22025767","379917","2024-09"
"014580","태경비케이","123572288000","4480","27583100","27583100","0","2024-09"
"015890","태경산업","152574075000","5220","29228750","29228750","0","2024-09"
"006890","태경케미컬","132493279310","11690","11333899","11600000","266101","2024-09"
"023160","태광","367056163980","14190","25867242","26500000","632758","2024-09"
"003240","태광산업","542851995000","645000","841631","1113400","271769","2024-09"
"011280","태림포장","151101870595","2195","68839121","70805940","1966819","2024-09"
"323280","태성","1066396149000","41300","25820730","25820730","0","2024-09"
"053620","태양","50632157160","6360","7961031","8600000","638969","2024-09"
"004100","태양금속","108360983500","2975","36423860","36700000","276140","2024-09"
"009410","태영건설","1330097939940","4620","287899987","287905337","5350","2024-09"
"044490","태웅","277302300660","13860","20007381","20007381","0","2024-09"
"124560","태웅로직스","106504699880","2945","36164584","38416584","2252000","2024-09"
"001420","태원물산","28012468740","3820","7333107","7600000","266893","2024-09"
"191420","테고사이언스","121699803200","15200","8006566","8108834","102268","2024-09"
"073640","테라사이언스","59577565530","654","91097195","95587404","4490209","2024-09"
"066700","테라젠이텍스","120020171250","3750","32005379","32474435","469056","2024-09"
"095610","테스","295569658100","16850","17541226","19768226","2227000","2024-09"
"055490","테이팩스","82562641500","17310","4769650","4769650","0","2024-09"
"064520","테크엘","53629252800","2400","22345522","22351062","5540","2024-09"
"089030","테크윙","1241981471500","34750","35740474","37353645","1613171","2024-09"
"054450","텔레칩스","197948979360","13410","14761296","15144233","382937","2024-09"
"078000","텔코웨어","50710509460","9820","5164003","9240077","4076074","2024-09"
"200230","텔콘RF제약","72150141000","600","120250235","120250235","0","2024-09"
"214420","토니모리","201260321420","8420","23902651","24054799","152148","2024-09"
"393210","토마토시스템","104740898550","6810","15380455","15614544","234089","2024-09"
"215480","토박스코리아","24417286200","2725","8960472","9400000","439528","2024-09"
"051360","토비스","305464120000","20000","15273206","16167058","893852","2024-09"
"045340","토탈소프트","43389262800","5070","8558040","8558040","0","2024-09"
"108230","톱텍","198938310480","5460","36435588","38023245","1587657","2024-09"
"079970","투비소프트","9202647300","1100","8366043","9290500","924457","2024-09"
"199800","툴젠","467126486400","58800","7944328","7946828","2500","2024-09"
"417790","트루엔","92645260350","8850","10468391","10999650","531259","2024-09"
"290090","트윔","60702666870","8670","7001461","7432268","430807","2024-09"
"026150","특수건설","98083990290","5590","17546331","17546331","0","2024-09"
"464280","티디에스팜","94135300000","17800","5288500","5530000","241500","2024-09"
"322180","티라유텍","100438408000","6080","16519475","16519475","0","2024-09"
"117730","티로보틱스","140912774000","7900","17837060","17837060","0","2024-09"
"033830","티비씨","77802839950","823","94535650","100000000","5464350","2024-09"
"057680","티사이언티픽","69538536976","976","71248501","71248501","0","2024-09"
"204610","티쓰리","78245769105","1335","58611063","63851720","5240657","2024-09"
"064760","티씨케이","1049582500000","89900","11675000","11675000","0","2024-09"
"246710","티앤알바이오팹","159446527200","7400","21546828","21546828","0","2024-09"
"340570","티앤엘","620737645900","76900","8072011","8128000","55989","2024-09"
"043220","티에스넥스젠","71670643282","511","140255662","140255662","0","2024-09"
"277880","티에스아이","132859882880","6590","20160832","20160832","0","2024-09"
"131290","티에스이","566239800000","52500","10785520","11061429","275909","2024-09"
"019180","티에이치엔","59400000000","3300","18000000","18000000","0","2024-09"
"425420","티에프이","209027280000","18480","11311000","11381000","70000","2024-09"
"131100","티엔엔터테인먼트","43018748942","1534","28043513","28048252","4739","2024-09"
"356860","티엘비","123428316900","12630","9772630","9832630","60000","2024-09"
"062860","티엘아이","42843237000","5800","7386765","9872720","2485955","2024-09"
"363280","티와이홀딩스","124447643525","3515","35404735","50429268","15024533","2024-09"
"321550","티움바이오","163700350970","6290","26025493","26025493","0","2024-09"
"091810","티웨이항공","617548188950","2870","215173585","215378976","205391","2024-09"
"004870","티웨이홀딩스","73998214992","663","111611184","111611693","509","2024-09"
"425040","티이엠씨","207300311400","9800","21153093","21316062","162969","2024-09"
"241790","티이엠씨씨엔에스","59640503180","6140","9713437","10002634","289197","2024-09"
"104480","티케이케미칼","133434497112","1468","90895434","90895434","0","2024-09"
"081150","티플랙스","72441179970","2985","24268402","24268402","0","2024-09"
"130740","티피씨글로벌","22226334309","1971","11276679","11276679","0","2024-09"
"084730","팅크웨어","107202686580","10230","10479246","11109424","630178","2024-09"
"440110","파두","972775111000","19750","49254436","49334436","80000","2024-09"
"034230","파라다이스","924055477500","10700","86360325","91771623","5411298","2024-09"
"033540","파라텍","57068536275","1525","37421991","37751063","329072","2024-09"
"388870","파로스아이바이오","135907480240","10520","12918962","12918962","0","2024-09"
"043200","파루","23153173528","554","41792732","41804315","11583","2024-09"
"214450","파마리서치","2327445000000","225000","10344200","10464152","119952","2024-09"
"208340","파멥신","233760977175","2915","80192445","80201108","8663","2024-09"
"005690","파미셀","321621515040","5360","60004014","60016964","12950","2024-09"
"177830","파버나인","37362473780","3140","11898877","14288753","2389876","2024-09"
"037070","파세코","122229772200","6120","19972185","20000000","27815","2024-09"
"150900","파수","56475805000","5000","11295161","11676422","381261","2024-09"
"037030","파워넷","55011452615","2515","21873341","21878974","5633","2024-09"
"047310","파워로직스","195135324150","5330","36610755","36610755","0","2024-09"
"368770","파이버프로","133065495750","4070","32694225","32854225","160000","2024-09"
"170790","파이오링크","54843694890","8210","6680109","6856330","176221","2024-09"
"049120","파인디앤씨","57617112020","1235","46653532","46653532","0","2024-09"
"038950","파인디지털","31573669050","3850","8200953","10210765","2009812","2024-09"
"441270","파인엠텍","261767091240","7080","36972753","36987901","15148","2024-09"
"106240","파인테크닉스","17363817028","1094","15871862","15923057","51195","2024-09"
"131760","파인텍","33529182076","772","43431583","43431583","0","2024-09"
"065690","파커스","14277176487","1071","13330697","14049331","718634","2024-09"
"140860","파크시스템스","1467391653000","211500","6938022","6983609","45587","2024-09"
"091700","파트론","357736649600","7040","50814865","58918214","8103349","2024-09"
"032800","판타지오","37249153971","163","228522417","229785294","1262877","2024-09"
"318010","팜스빌","42272805460","5470","7728118","7929338","201220","2024-09"
"036580","팜스코","79667851900","2275","35018836","36727943","1709107","2024-09"
"027710","팜스토리","147322211652","1332","110602261","111416600","814339","2024-09"
"004720","팜젠사이언스","87327801225","4815","18136615","18178525","41910","2024-09"
"225590","패션플랫폼","22457235514","877","25606882","26636713","1029831","2024-09"
"054300","팬스타엔터프라이즈","33147070110","495","66963778","66985895","22117","2024-09"
"068050","팬엔터테인먼트","58681202930","2170","27042029","27694076","652047","2024-09"
"028670","팬오션","1935141633440","3620","534569512","534569512","0","2024-09"
"222110","팬젠","54733404985","4795","11414683","11414683","0","2024-09"
"271830","팸텍","65142419270","2270","28697101","29490202","793101","2024-09"
"010820","퍼스텍","138252311265","2845","48594837","48771938","177101","2024-09"
"016800","퍼시스","393753888000","44000","8948952","11500000","2551048","2024-09"
"263750","펄어비스","2244879435500","36550","61419410","64247855","2828445","2024-09"
"251970","펌텍코리아","464319555700","37450","12398386","12400000","1614","2024-09"
"001020","페이퍼코리아","129348917414","727","177921482","177983313","61831","2024-09"
"168360","펨트론","136457900440","6410","21288284","21288284","0","2024-09"
"087010","펩트론","2070688933400","100600","20583389","20657350","73961","2024-09"
"090080","평화산업","55396379331","1009","54902259","54902259","0","2024-09"
"010770","평화홀딩스","40289090800","2800","14388961","14625466","236505","2024-09"
"064800","포니링크","184031773600","1460","126049160","127807298","1758138","2024-09"
"119500","포메탈","32639124160","2755","11847232","11847232","0","2024-09"
"389140","포바이포","63897270420","5790","11035798","11112735","76937","2024-09"
"105760","포스뱅크","66503694550","7030","9459985","9459985","0","2024-09"
"022100","포스코DX","4251030532000","28000","151822519","152034729","212210","2024-09"
"058430","포스코스틸리온","228541008500","38150","5990590","6000000","9410","2024-09"
"009520","포스코엠텍","694964239710","16690","41639559","41642703","3144","2024-09"
"047050","포스코인터내셔널","8897202221400","52200","170444487","175922788","5478301","2024-09"
"003670","포스코퓨처엠","18119851776000","234000","77435264","77463220","27956","2024-09"
"189690","포시에스","63093790155","2315","27254337","27321969","67632","2024-09"
"318020","포인트모바일","54340301920","4360","12463372","12662272","198900","2024-09"
"256630","포인트엔지니어링","78374808144","1377","56917072","57997072","1080000","2024-09"
"331380","포커스에이치엔에스","90126774440","4045","22281032","22725452","444420","2024-09"
"472850","폰드그룹","217621125210","6730","32335977","32343933","7956","2024-09"
"039980","폴라리스AI","175089291485","2455","71319467","72152777","833310","2024-09"
"041910","폴라리스AI파마","88108842360","7060","12480006","12698263","218257","2024-09"
"234100","폴라리스세원","72750465781","1337","54413213","54413213","0","2024-09"
"041020","폴라리스오피스","250406316720","5040","49683793","49725498","41705","2024-09"
"114630","폴라리스우노","41416071095","545","75992791","77757548","1764757","2024-09"
"290720","푸드나무","40903443275","3275","12489601","13403058","913457","2024-09"
"005670","푸드웰","49404066680","5240","9428257","10000000","571743","2024-09"
"094940","푸른기술","52251144430","6610","7904863","8361386","456523","2024-09"
"057880","푸른소나무","215672327790","8790","24536101","24580368","44267","2024-09"
"007330","푸른저축은행","103705362000","8850","11718120","15082800","3364680","2024-09"
"017810","풀무원","392226097200","10640","36863355","38120542","1257187","2024-09"
"093380","풍강","29004371550","3025","9588222","9879313","291091","2024-08"
"023900","풍국주정","129528000000","10280","12600000","12600000","0","2024-09"
"103140","풍산","1769965214400","64800","27314278","28024278","710000","2024-09"
"005810","풍산홀딩스","367600170000","26250","14003816","14417292","413476","2024-09"
"371950","풍원정밀","250381807200","11900","21040488","21040488","0","2024-09"
"370090","퓨런티어","125918363700","15390","8181830","8181830","0","2024-09"
"445180","퓨릿","116210472840","6930","16769188","16769188","0","2024-09"
"151910","퓨처코어","121645902080","640","190071722","190071722","0","2024-09"
"220100","퓨쳐켐","656278761600","29700","22096928","22102155","5227","2024-09"
"035200","프럼파스트","23996880180","2835","8464508","9730590","1266082","2024-09"
"334970","프레스티지바이오로직스","464951105640","7560","61501469","61501469","0","2024-09"
"321260","프로이천","63432119250","2250","28192053","28192084","31","2024-09"
"053610","프로텍","300600000000","33400","9000000","11000000","2000000","2024-09"
"303360","프로티아","36764448825","2855","12877215","12877215","0","2024-09"
"377220","프롬바이오","57186200000","2020","28310000","28310000","0","2024-09"
"335810","프리시젼바이오","42451092530","3655","11614526","11614526","0","2024-09"
"053160","프리엠스","64744982720","12080","5359684","6000000","640316","2024-09"
"405000","플라즈맵","52675224880","2020","26076844","26076844","0","2024-09"
"041590","플래스크","103917099150","789","131707350","131707350","0","2024-09"
"367000","플래티어","41244264910","5090","8102999","8388207","285208","2024-09"
"075130","플랜티넷","32540760780","2090","15569742","16622320","1052578","2024-09"
"009810","플레이그램","52245992440","344","151877885","151887500","9615","2024-09"
"237820","플레이디","72601612400","5660","12827140","12827140","0","2024-09"
"023770","플레이위드","41204054000","4700","8766820","8766820","0","2024-09"
"019570","플루토스","21090839952","402","52464776","52470040","5264","2024-09"
"300080","플리토","93941422850","17090","5496865","5501817","4952","2024-09"
"033790","피노","193200828000","8510","22702800","22822800","120000","2024-09"
"032580","피델릭스","45466067081","1373","33114397","33132064","17667","2024-09"
"051380","피씨디렉트","39175991450","2650","14783393","15340072","556679","2024-09"
"241820","피씨엘","68698653687","1161","59171967","59171967","0","2024-09"
"237750","피앤씨테크","31021265000","4775","6496600","6496600","0","2024-09"
"460940","피앤에스미캐닉스","81932228400","12660","6471740","6471740","0","2024-09"
"319660","피에스케이","644509386500","22250","28966714","28966714","0","2024-09"
"031980","피에스케이홀딩스","1175150527500","54500","21562395","21562395","0","2024-09"
"002230","피에스텍","61485852600","3720","16528455","19370673","2842218","2024-09"
"043370","피에이치에이","200996761770","10290","19533213","21000000","1466787","2024-09"
"239890","피엔에이치테크","76405955950","7690","9935755","9935755","0","2024-09"
"347740","피엔케이피부임상연구센타","73792976005","2555","28881791","30010576","1128785","2024-09"
"137400","피엔티","1250706676800","53800","23247336","23743086","495750","2024-09"
"257370","피엔티엠에스","73956596980","6020","12285149","12504861","219712","2024-09"
"147760","피엠티","39600709560","3660","10819866","10819866","0","2024-09"
"128660","피제이메탈","85447606205","3445","24803369","24803369","0","2024-09"
"006140","피제이전자","79230450000","5330","14865000","15000000","135000","2024-09"
"376180","피코그램","54821206440","2980","18396378","18491378","95000","2024-09"
"304840","피플바이오","82233626380","3910","21031618","21089464","57846","2024-09"
"087600","픽셀플러스","46202977530","7130","6480081","8166558","1686477","2024-09"
"291810","핀텔","24135138000","2125","11357712","11357712","0","2024-09"
"378340","필에너지","364414299840","17120","21285882","21285882","0","2024-09"
"161580","필옵틱스","534530412000","23400","22843180","22843180","0","2024-09"
"347770","핌스","53828333910","2355","22857042","22857042","0","2024-09"
"163730","핑거","102523226040","11160","9186669","9360608","173939","2024-09"
"417180","핑거스토리","47369884250","2830","16738475","16739405","930","2024-09"
"446750","하나26호스팩","12904200000","2140","6030000","6030000","0","2024-09"
"448370","하나27호스팩","11998700000","2135","5620000","5620000","0","2024-09"
"454750","하나28호스팩","15016170000","2085","7202000","7202000","0","2024-09"
"454640","하나29호스팩","11531135000","2135","5401000","5401000","0","2024-09"
"469880","하나30호스팩","15230925000","2085","7305000","7305000","0","2024-09"
"469900","하나31호스팩","11686425000","2085","5605000","5605000","0","2024-09"
"475240","하나32호스팩","6960000000","2175","3200000","3200000","0","2024-09"
"475250","하나33호스팩","7881000000","2130","3700000","3700000","0","2024-09"
"406760","하나금융21호스팩","15449850000","2085","7410000","7410000","0","2024-09"
"418170","하나금융22호스팩","13522500000","2250","6010000","6010000","0","2024-09"
"435620","하나금융25호스팩","44568720000","10360","4302000","4302000","0","2024-09"
"086790","하나금융지주","18250485143400","65700","277785162","287240880","9455718","2024-09"
"299030","하나기술","236649336000","29600","7994910","7994910","0","2024-09"
"067310","하나마이크론","764613140480","11630","65744896","65744896","0","2024-09"
"166090","하나머티리얼즈","594382597000","30500","19487954","19777674","289720","2024-09"
"293480","하나제약","191332315160","11060","17299486","17772946","473460","2024-09"
"039130","하나투어","765202640800","49400","15489932","16039185","549253","2024-09"
"136480","하림","303164404610","2855","106187182","106209702","22520","2024-09"
"003380","하림지주","524237765590","5390","97261181","112005621","14744440","2024-09"
"450330","하스","69035239290","8810","7836009","7836009","0","2024-09"
"101670","하이드로리튬","90186811240","1828","49336330","51086330","1750000","2024-09"
"365590","하이딥","131737985203","913","144291331","144447309","155978","2024-09"
"149980","하이로닉","124130966750","7430","16706725","18591363","1884638","2024-09"
"013030","하이록코리아","301965234250","24950","12102815","12856050","753235","2024-09"
"352820","하이브","7972552833700","192100","41502097","41652097","150000","2024-09"
"126700","하이비젼시스템","216011656070","16970","12729031","14942112","2213081","2024-09"
"106080","하이소닉","109668482230","6970","15734359","15735465","1106","2024-09"
"071090","하이스틸","66101129525","3275","20183551","20191471","7920","2024-09"
"450050","하이제8호스팩","10504330000","2095","5014000","5014000","0","2024-09"
"160190","하이젠알앤엠","239557920000","8590","27888000","30888000","3000000","2024-09"
"221840","하이즈항공","34147224386","1826","18700561","18700561","0","2024-09"
"106190","하이텍팜","151514521500","14250","10632598","10633173","575","2024-09"
"019490","하이트론","126125853000","4200","30029965","30044269","14304","2024-09"
"000080","하이트진로","1376421011350","20050","68649427","70133611","1484184","2024-09"
"000140","하이트진로홀딩스","195289106220","9140","21366423","23206765","1840342","2024-09"
"065650","하이퍼코퍼레이션","146133846600","1372","106511550","106681728","170178","2024-09"
"066130","하츠","65066075620","5420","12004811","12800000","795189","2024-09"
"004590","한국가구","55875000000","3725","15000000","15000000","0","2024-09"
"036460","한국가스공사","3569565250600","40900","87275434","92313000","5037566","2024-09"
"039340","한국경제TV","116534161840","5480","21265358","23000000","1734642","2024-09"
"005430","한국공항","164531751800","53800","3058211","3166355","108144","2024-09"
"071050","한국금융지주","4060865501000","77000","52738513","55725992","2987479","2024-09"
"034950","한국기업평가","380066209200","85200","4460871","4540514","79643","2024-09"
"010040","한국내화","79379108480","2240","35437102","41067062","5629960","2024-09"
"025540","한국단자","745774500000","72300","10315000","10415000","100000","2024-09"
"222980","한국맥널티","44369701360","4085","10861616","11031483","169867","2024-09"
"010100","한국무브넥스","110991780900","3645","30450420","30450420","0","2024-09"
"256840","한국비엔씨","384047198560","5780","66444152","67912443","1468291","2024-09"
"219750","한국비티비","63245329550","967","65403650","65426885","23235","2024-09"
"004090","한국석유","216888525910","17210","12602471","12694120","91649","2024-09"
"025550","한국선재","62054633520","2805","22122864","23300000","1177136","2024-09"
"002200","한국수출포장","98494450050","2650","37167717","40000000","2832283","2024-09"
"002960","한국쉘석유","416000000000","320000","1300000","1300000","0","2024-09"
"017890","한국알콜","190576291180","9260","20580593","21605760","1025167","2024-09"
"000240","한국앤컴퍼니","1593159182080","16820","94718144","94935240","217096","2024-09"
"080720","한국유니온제약","15410411825","2725","5655197","7912828","2257631","2024-09"
"123890","한국자산신탁","360370976975","2945","122367055","123977752","1610697","2024-09"
"015760","한국전력","13256558190050","20650","641964077","641964077","0","2024-09"
"063570","한국전자금융","155291484160","5120","30330368","34147728","3817360","2024-09"
"041460","한국전자인증","66624360000","3520","18927375","19000000","72625","2024-09"
"006200","한국전자홀딩스","32891915250","750","43855887","46803136","2947249","2024-09"
"101680","한국정밀기계","21595116330","2570","8402769","8404000","1231","2024-09"
"039740","한국정보공학","21128476095","2635","8018397","8018397","0","2024-09"
"053300","한국정보인증","165931861720","4040","41072243","42441361","1369118","2024-09"
"025770","한국정보통신","293163427110","8210","35708091","37444271","1736180","2024-09"
"458610","한국제12호스팩","9221400000","2180","4230000","4230000","0","2024-09"
"464440","한국제13호스팩","9244800000","2140","4320000","4320000","0","2024-09"
"477530","한국제14호스팩","10942750000","2275","4810000","4810000","0","2024-09"
"479880","한국제15호스팩","14083500000","2050","6870000","6870000","0","2024-09"
"027970","한국제지","201940064640","1062","190150720","190178237","27517","2024-09"
"023350","한국종합기술","46297421750","4450","10403915","10950000","546085","2024-09"
"025890","한국주강","22200075072","1992","11144616","11309259","164643","2024-09"
"000970","한국주철관","139821305000","6500","21510970","22800500","1289530","2024-09"
"104700","한국철강","273642124140","7980","34290993","42450000","8159007","2024-09"
"062970","한국첨단소재","19440765730","1970","9868409","9868409","0","2024-09"
"017960","한국카본","545332625680","11080","49217746","51908452","2690706","2024-09"
"023760","한국캐피탈","178574868325","571","312740575","315609576","2869001","2024-09"
"054040","한국컴퓨터","67637180000","5000","13527436","16071290","2543854","2024-09"
"161890","한국콜마","1673599959300","70900","23605077","23605077","0","2024-09"
"021650","한국큐빅","39975218940","2460","16250089","16350563","100474","2024-09"
"161390","한국타이어앤테크놀로지","4611174863400","37800","121988753","123875069","1886316","2024-09"
"034830","한국토지신탁","227943161934","1058","215447223","252489230","37042007","2024-09"
"007280","한국특강","91524033055","1505","60813311","60813311","0","2024-09"
"032300","한국파마","224132705550","20550","10906701","10906701","0","2024-09"
"037230","한국팩키지","59421852038","1994","29800327","29800327","0","2024-09"
"047810","한국항공우주","5205170713800","53400","97475107","97475107","0","2024-09"
"123690","한국화장품","110862789900","6900","16067071","16068000","929","2024-09"
"003350","한국화장품제조","284200548800","78400","3625007","4532000","906993","2024-09"
"030520","한글과컴퓨터","428432739000","17800","24069255","24179744","110489","2024-09"
"052600","한네트","52499198000","4540","11563700","11563700","0","2024-09"
"011500","한농화성","295327526200","19310","15294020","15637042","343022","2024-09"
"002390","한독","225997211860","16420","13763533","13763533","0","2024-09"
"256150","한독크린텍","55506329870","7130","7784899","8395000","610101","2024-09"
"092460","한라IMS","107868288000","6600","16343680","17109680","766000","2024-09"
"053690","한미글로벌","151149233000","14860","10171550","10957550","786000","2024-09"
"042700","한미반도체","11127165552600","116300","95676402","96993634","1317232","2024-09"
"008930","한미사이언스","2234552298000","33000","67713706","68391550","677844","2024-09"
"128940","한미약품","4083028908000","322000","12680214","12810991","130777","2024-09"
"452190","한빛레이저","121363058360","5240","23160889","23162757","1868","2024-09"
"047080","한빛소프트","36886029932","1486","24822362","24822362","0","2024-09"
"009240","한샘","849936486400","51200","16600322","23533928","6933606","2024-09"
"452280","한선엔지니어링","166794525000","9810","17002500","17002500","0","2024-09"
"020000","한섬","350504542080","16320","21476994","23398500","1921506","2024-09"
"003680","한성기업","29426366550","5210","5648055","6209515","561460","2024-09"
"066980","한성크린텍","126974351250","2445","51932250","51935125","2875","2024-09"
"105630","한세실업","637608163410","16190","39382839","40000000","617161","2024-09"
"069640","한세엠케이","44475482365","1621","27437065","30106502","2669437","2024-09"
"016450","한세예스24홀딩스","216040698500","5500","39280127","40000000","719873","2024-09"
"010420","한솔PNS","21722592720","1060","20493012","20493012","0","2024-09"
"009180","한솔로지스틱스","65076774880","2320","28050334","28057025","6691","2024-09"
"114810","한솔아이원스","208910945880","7560","27633723","29113174","1479451","2024-09"
"070590","한솔인티큐브","15862134636","1161","13662476","13879521","217045","2024-09"
"213500","한솔제지","225166939960","9470","23776868","23800576","23708","2024-09"
"014680","한솔케미칼","1425967531000","125800","11335195","11335195","0","2024-09"
"004710","한솔테크닉스","140279213405","4465","31417517","32109878","692361","2024-09"
"004150","한솔홀딩스","96002288460","2340","41026619","42008577","981958","2024-09"
"025750","한솔홈데코","58248602727","723","80565149","80565149","0","2024-09"
"226440","한송네오텍","100580954580","1530","65739186","65739186","0","2024-09"
"042520","한스바이오메드","122726951550","9450","12986979","13526367","539388","2024-09"
"004960","한신공영","79606429760","6880","11570702","11570702","0","2024-09"
"011700","한신기계","111917682460","3460","32346151","32446151","100000","2024-09"
"430690","한싹","58071970320","5330","10895304","10895327","23","2024-09"
"078350","한양디지텍","187547352480","12640","14837607","15244382","406775","2024-09"
"045100","한양이엔지","287074492200","17100","16787982","18000000","1212018","2024-09"
"001750","한양증권","161906952480","12720","12728534","12728534","0","2024-09"
"018880","한온시스템","2051955113350","3845","533668430","533800000","131570","2024-09"
"009420","한올바이오파마","2259142974000","44550","50710280","52240638","1530358","2024-09"
"320000","한울반도체","82079103505","2935","27965623","27965627","4","2024-09"
"091440","한울소재과학","73070348000","5200","14051990","14606671","554681","2024-09"
"014130","한익스프레스","41713000000","3535","11800000","12000000","200000","2024-09"
"024740","한일단조","64495632880","2065","31232752","31532546","299794","2024-09"
"005860","한일사료","167268642825","4245","39403685","39403685","0","2024-09"
"300720","한일시멘트","969661560000","14000","69261540","69261540","0","2024-09"
"002220","한일철강","48829248700","2005","24353740","26697460","2343720","2024-09"
"006390","한일현대시멘트","265562213280","13740","19327672","19327672","0","2024-09"
"003300","한일홀딩스","409133261880","13270","30831444","30832884","1440","2024-09"
"007770","한일화학","43278300000","12330","3510000","3510000","0","2024-09"
"051600","한전KPS","1989000000000","44200","45000000","45000000","0","2024-09"
"052690","한전기술","2636414896500","69300","38043505","38220000","176495","2024-09"
"130660","한전산업","446946000000","13710","32600000","32600000","0","2024-09"
"198940","한주라이트메탈","40514624868","1041","38918948","38922978","4030","2024-09"
"058450","한주에이알티","36242226340","2510","14439134","14452469","13335","2024-09"
"107640","한중엔시에스","394648518600","44100","8948946","8948946","0","2024-09"
"002320","한진","285333156440","19720","14469227","14947628","478401","2024-09"
"003480","한진중공업홀딩스","89878341280","3445","26089504","29529812","3440308","2024-09"
"180640","한진칼","6174600450900","93100","66322239","66762279","440040","2024-09"
"005110","한창","22551214950","1254","17983425","18606407","622982","2024-09"
"079170","한창산업","39962917310","7730","5169847","5200000","30153","2024-09"
"009460","한창제지","45585959304","764","59667486","59667486","0","2024-09"
"372910","한컴라이프케어","112911576480","4080","27674406","27674406","0","2024-09"
"054920","한컴위드","65430752190","2630","24878613","28217081","3338468","2024-09"
"002680","한탑","23479716843","757","31016799","32316799","1300000","2024-09"
"000880","한화","1925184888000","27750","69376032","74958735","5582703","2024-09"
"452260","한화갤러리아","270319234455","1395","193777229","193859610","82381","2024-09"
"088350","한화생명","2194059530000","2920","751390250","868530000","117139750","2024-09"
"000370","한화손해보험","576945925740","4990","115620426","116738915","1118489","2024-09"
"009830","한화솔루션","3598650928750","21250","169348279","171892536","2544257","2024-09"
"272210","한화시스템","3530432767680","18880","186993261","188919389","1926128","2024-09"
"012450","한화에어로스페이스","17868353364000","393000","45466548","45581161","114613","2024-09"
"082740","한화엔진","1346488134900","16140","83425535","83447142","21607","2024-09"
"042660","한화오션","9605551812450","31350","306397187","306413394","16207","2024-09"
"489790","한화인더스트리얼솔루션즈","2125932272400","42200","50377542","50488390","110848","2024-09"
"003530","한화투자증권","742130246360","3470","213870388","214547775","677387","2024-09"
"430460","한화플러스제3호스팩","12580000000","2125","5920000","5920000","0","2024-09"
"455310","한화플러스제4호스팩","10575400000","2090","5060000","5060000","0","2024-09"
"195870","해성디에스","485350000000","28550","17000000","17000000","0","2024-09"
"034810","해성산업","212180299200","7160","29634120","32556857","2922737","2024-09"
"059270","해성에어로보틱스","74866169280","6720","11140799","11140799","0","2024-09"
"076610","해성옵틱스","29793572564","1172","25421137","25453198","32061","2024-09"
"101530","해태제과식품","154597969460","5830","26517662","29116822","2599160","2024-09"
"220180","핸디소프트","60747040000","3130","19408000","19408000","0","2024-09"
"143210","핸즈코퍼레이션","43524752625","2025","21493705","21875747","382042","2024-09"
"214180","헥토이노베이션","153471551200","12400","12376738","13257185","880447","2024-09"
"234340","헥토파이낸셜","141435417080","17020","8309954","9453000","1143046","2024-09"
"084990","헬릭스미스","161854811320","3515","46046888","46092797","45909","2024-09"
"187660","현대ADM","73294898985","3465","21152929","21836250","683321","2024-09"
"000720","현대건설","3357376314750","30150","111355765","111355765","0","2024-09"
"170030","현대공업","82636902730","5510","14997623","15340000","342377","2024-09"
"453340","현대그린푸드","397067362050","11730","33850585","33880914","30329","2024-09"
"086280","현대글로비스","8977500000000","119700","75000000","75000000","0","2024-09"
"064350","현대로템","7323447860300","67100","109142293","109142293","0","2024-09"
"079430","현대리바트","165539882460","8230","20114202","20535282","421080","2024-09"
"012330","현대모비스","21782091606000","242000","90008643","92995094","2986451","2024-09"
"319400","현대무벡스","368447771360","3160","116597396","117741058","1143662","2024-09"
"048410","현대바이오","719137497120","18060","39819352","39821608","2256","2024-09"
"052260","현대바이오랜드","160500000000","5350","30000000","30000000","0","2024-09"
"069960","현대백화점","1015173389700","46450","21855186","23402441","1547255","2024-09"
"004560","현대비앤지스틸","203262372280","13480","15078811","15078811","0","2024-09"
"016790","현대사료","187340898626","994","188471729","188471729","0","2024-09"
"004310","현대약품","113167572340","4330","26135698","32000000","5864302","2024-08"
"041440","현대에버다임","144517867200","8100","17841712","17915944","74232","2024-09"
"039010","현대에이치티","46536310000","5990","7769000","8625000","856000","2024-09"
"017800","현대엘리베이","1592233234200","44100","36105062","39092385","2987323","2024-09"
"307950","현대오토에버","3916020964800","142800","27423116","27423982","866","2024-09"
"011210","현대위아","1286990352900","48300","26645763","27195083","549320","2024-09"
"090850","현대이지웰","119681659440","5040","23746361","23746361","0","2024-09"
"004020","현대제철","3578044100800","27200","131545739","133445785","1900046","2024-09"
"005440","현대지에프홀딩스","710923612560","4560","155904301","155904301","0","2024-09"
"005380","현대차","48003349975500","235500","203835881","209416191","5580310","2024-09"
"001500","현대차증권","287315811720","9060","31712562","31712562","0","2024-09"
"011760","현대코퍼레이션","223283857940","18590","12010966","13228966","1218000","2024-09"
"227840","현대코퍼레이션홀딩스","93686464620","10620","8821701","9100836","279135","2024-09"
"126560","현대퓨처넷","441714953550","4010","110153355","110202945","49590","2024-09"
"001450","현대해상","2430849500000","31000","78414500","89400000","10985500","2024-09"
"057050","현대홈쇼핑","547202450000","47800","11447750","12000000","552250","2024-09"
"460930","현대힘스","377719080990","10690","35333871","35333871","0","2024-09"
"092300","현우산업","54801279055","2995","18297589","18672816","375227","2024-09"
"138360","협진","40731185478","843","48316946","48348248","31302","2024-09"
"011080","형지I&C","15960619322","626","25496197","25503364","7167","2024-09"
"093240","형지엘리트","48081076460","1420","33859913","34164255","304342","2024-09"
"003010","혜인","55461346680","5160","10748323","12712747","1964424","2024-09"
"111110","호전실업","71174067760","7730","9207512","9749984","542472","2024-09"
"008770","호텔신라","1677513069200","45200","37113121","39248121","2135000","2024-09"
"060560","홈센타홀딩스","99520966272","784","126940008","127669525","729517","2024-09"
"064240","홈캐스트","93804833850","2730","34360745","35038012","677267","2024-09"
"039610","화성밸브","112015904000","10760","10410400","10410400","0","2024-09"
"378850","화승알앤에이","79951209060","4210","18990786","18993623","2837","2024-09"
"241590","화승엔터프라이즈","535609199840","8840","60589276","60589276","0","2024-09"
"006060","화승인더","201583090225","4075","49468243","55320000","5851757","2024-09"
"013520","화승코퍼레이션","84014717864","1892","44405242","50051252","5646010","2024-09"
"010690","화신","350264285280","10080","34748441","34920410","171969","2024-09"
"126640","화신정공","47500758050","1355","35055910","36373887","1317977","2024-09"
"133820","화인베스틸","28421680796","922","30826118","30826118","0","2024-09"
"127980","화인써키트","81693474600","6900","11839634","11840684","1050","2024-09"
"061250","화일약품","110912026176","1488","74537652","76877652","2340000","2024-09"
"010660","화천기계","62810000000","2855","22000000","22000000","0","2024-09"
"000850","화천기공","61600000000","28000","2200000","2200000","0","2024-09"
"016580","환인제약","210380224600","13780","15267070","18600070","3333000","2024-09"
"032560","황금에스티","91399647160","5380","16988782","17000000","11218","2024-09"
"004800","효성","835080283800","49950","16718324","16740407","22083","2024-09"
"094280","효성ITX","138200329800","12520","11038365","11558200","519835","2024-09"
"097870","효성오앤비","48839100000","6190","7890000","8490000","600000","2024-09"
"298040","효성중공업","3785222716500","406500","9311741","9324548","12807","2024-09"
"298020","효성티앤씨","1296864845000","300500","4315690","4327682","11992","2024-09"
"298000","효성화학","155525602000","41150","3779480","3791811","12331","2024-09"
"093370","후성","670345225000","6250","107255236","107255330","94","2024-09"
"081660","휠라홀딩스","2422541411400","40700","59521902","60095839","573937","2024-09"
"290270","휴네시온","33664325970","3630","9273919","9607672","333753","2024-09"
"005870","휴니드","102105822000","7800","13090490","14116015","1025525","2024-09"
"353190","휴럼","32604577452","828","39377509","39378420","911","2024-09"
"192410","휴림네트웍스","38893286300","2735","14220580","14235530","14950","2024-09"
"090710","휴림로봇","149571796920","1365","109576408","109623165","46757","2024-09"
"078590","휴림에이텍","33561838750","625","53698942","54210339","511397","2024-09"
"205470","휴마시스","174596375120","1543","113153840","129375009","16221169","2024-09"
"115160","휴맥스","73866997599","1713","43121423","43970124","848701","2024-09"
"028080","휴맥스홀딩스","32754174000","3000","10918058","12577506","1659448","2024-09"
"175140","휴먼테크놀로지","104349166200","4850","21515292","21515292","0","2024-09"
"200670","휴메딕스","334517931550","32450","10308719","11229930","921211","2024-09"
"079980","휴비스","92313447600","2805","32910320","34500000","1589680","2024-09"
"065510","휴비츠","98988844500","9100","10877895","12159371","1281476","2024-09"
"215090","휴센텍","149904424845","1505","99604269","99649272","45003","2024-09"
"005010","휴스틸","229528286375","4085","56188075","56188075","0","2024-09"
"263920","휴엠앤씨","50271262350","1025","49045134","49045134","0","2024-09"
"243070","휴온스","350777849400","29700","11810702","11979665","168963","2024-09"
"084110","휴온스글로벌","462258334000","38000","12164693","12621492","456799","2024-09"
"145020","휴젤","3222772046000","293000","10999222","12604033","1604811","2024-09"
"024060","흥구석유","247775521680","17040","14540817","15000000","459183","2024-09"
"010240","흥국","55187419560","4985","11070696","12322696","1252000","2024-09"
"189980","흥국에프엔비","70808642010","1830","38693247","40137827","1444580","2024-09"
"000540","흥국화재","223243191375","3475","64242645","64242645","0","2024-09"
"003280","흥아해운","492542926100","2050","240264842","240424899","160057","2024-09"
"037440","희림","61544535000","4875","12624520","13922475","1297955","2024-09"
"238490","힘스","51059724000","4600","11099940","11312236","212296","2024-09"