종목코드,종목명,자기주식 제외 시가총액(A*B),종가,자기주식 제외 발행주식수(B=C-D),총발행주식수(C),자기주식수(D),자기주식수 반영시점
"060310","3S","103446400050","2025","51084642","51084642","0","2024-09"
"095570","AJ네트웍스","217490103000","4860","44751050","45252759","501709","2024-09"
"006840","AK홀딩스","166069151350","12730","13045495","13247561","202066","2024-09"
"054620","APS","109016664000","6000","18169444","19894221","1724777","2024-09"
"265520","AP시스템","264053955720","17580","15020134","15281421","261287","2024-09"
"211270","AP위성","147313216350","10350","14233161","15082304","849143","2024-09"
"109960","AP헬스케어","63906034640","560","114117919","114153169","35250","2024-09"
"139050","BF랩스","24234697905","2805","8639821","8644551","4730","2024-09"
"027410","BGF","344073013770","3595","95708766","95716791","8025","2024-09"
"282330","BGF리테일","1972806713000","114200","17275015","17283906","8891","2024-09"
"126600","BGF에코머티리얼즈","213638490000","3450","61924200","62766899","842699","2024-09"
"138930","BNK금융지주","3069217123160","9640","318383519","320436727","2053208","2024-09"
"001460","BYC","201963314500","32350","6243070","6246150","3080","2024-09"
"013720","CBI","48761356656","1094","44571624","44628136","56512","2024-09"
"083790","CG인바이츠","184546036800","2400","76894182","76894182","0","2024-09"
"001040","CJ","2903372221500","107300","27058455","29176998","2118543","2024-09"
"079160","CJ CGV","923936416740","5580","165580003","165580003","0","2024-09"
"035760","CJ ENM","1281090454200","61800","20729619","21929154","1199535","2024-09"
"311690","CJ 바이오사이언스","106434023360","11680","9112502","9112502","0","2024-09"
"000120","CJ대한통운","1737220735900","87100","19945129","22812344","2867215","2024-09"
"011150","CJ씨푸드","111744704030","3110","35930773","35930773","0","2024-09"
"097950","CJ제일제당","4056338604000","276000","14696879","15054186","357307","2024-09"
"051500","CJ프레시웨이","218081034820","18370","11871586","11871586","0","2024-09"
"058820","CMG제약","298618324600","2150","138892244","138892244","0","2024-09"
"023460","CNH","8701027896","264","32958439","37200000","4241561","2024-09"
"056730","CNT85","56676132172","814","69626698","74111186","4484488","2024-09"
"000480","CR홀딩스","233512084320","5660","41256552","46890490","5633938","2024-09"
"065770","CS","19469363390","1003","19411130","19411130","0","2024-09"
"083660","CSA 코스믹","49526724984","836","59242494","61247181","2004687","2024-09"
"000590","CS홀딩스","72676737200","69800","1041214","1154482","113268","2024-09"
"012030","DB","309851524526","1622","191030533","201173933","10143400","2024-09"
"456440","DB금융스팩11호","12118200000","2280","5315000","5315000","0","2024-09"
"477760","DB금융스팩12호","12088800000","2070","5840000","5840000","0","2024-09"
"016610","DB금융투자","225646355060","5540","40730389","42446389","1716000","2024-09"
"005830","DB손해보험","6820938078400","113600","60043469","70800000","10756531","2024-09"
"000990","DB하이텍","1530582619200","36800","41591919","44398588","2806669","2024-09"
"139130","DGB금융지주","1357765509120","8160","166392832","169145833","2753001","2024-09"
"099520","DGI","58000622016","1284","45171824","45281824","110000","2024-09"
"060900","DGP","30708363008","1216","25253588","25258229","4641","2024-09"
"290120","DH오토리드","42433902430","2735","15515138","15515138","0","2024-09"
"025440","DH오토웨어","32320284150","210","153906115","153906120","5","2024-09"
"001530","DI동일","725437171550","37450","19370819","25215672","5844853","2024-09"
"000210","DL","868625170500","41500","20930727","20955884","25157","2024-09"
"375500","DL이앤씨","1207674395200","31400","38460968","38693623","232655","2024-09"
"068790","DMS","128940542080","5480","23529296","24573061","1043765","2024-09"
"007340","DN오토모티브","875083095450","17410","50263245","59065865","8802620","2024-09"
"004840","DRB동일","87400170740","4535","19272364","19930000","657636","2024-09"
"241520","DSC인베스트먼트","74131848000","2835","26148800","27496125","1347325","2024-09"
"155660","DSR","62400000000","3900","16000000","16000000","0","2024-09"
"069730","DSR제강","52200000000","3625","14400000","14400000","0","2024-09"
"017860","DS단석","392714068000","67000","5861404","5861404","0","2024-09"
"180400","DXVX","115910029080","2355","49218696","49219432","736","2024-09"
"017940","E1","435944025400","75400","5781751","6860000","1078249","2024-09"
"245620","EDGC","57441040175","415","138412145","138493951","81806","2024-09"
"037370","EG","60978552040","7070","8624972","8624972","0","2024-09"
"050120","ES큐브","23345928501","1743","13394107","13564086","169979","2024-09"
"383220","F&F","2337300287400","61800","37820393","38307075","486682","2024-09"
"007700","F&F홀딩스","523536566200","13400","39069893","39114367","44474","2024-09"
"214270","FSN","66827503140","2010","33247514","33250463","2949","2024-09"
"130500","GH신소재","44216900320","3040","14545033","14545052","19","2024-09"
"114090","GKL","666185565900","10770","61855670","61855670","0","2024-09"
"078930","GS","3943413762750","42450","92895495","92915378","19883","2024-09"
"083450","GST","281433583900","15130","18601030","18618260","17230","2024-09"
"006360","GS건설","1574689002250","18550","84888895","85581490","692595","2024-09"
"001250","GS글로벌","276771402710","3355","82495202","82533764","38562","2024-09"
"007070","GS리테일","2141171899200","20700","103438256","104717922","1279666","2024-09"
"297890","HB솔루션","291100837720","3980","73140914","73140914","0","2024-09"
"440290","HB인베스트먼트","51503319000","1900","27107010","27107010","0","2024-09"
"078150","HB테크놀러지","211029717750","2375","88854618","92715916","3861298","2024-09"
"012630","HDC","543836817820","10870","50030986","59741721","9710735","2024-09"
"039570","HDC랩스","183105593410","7970","22974353","25957601","2983248","2024-09"
"089470","HDC현대EP","103161054740","3980","25919863","31900000","5980137","2024-09"
"294870","HDC현대산업개발","1363598262500","21250","64169330","65907330","1738000","2024-09"
"009540","HD한국조선해양","13782281387000","194900","70714630","70773116","58486","2024-09"
"267250","HD현대","5702942301000","80700","70668430","78993085","8324655","2024-09"
"267270","HD현대건설기계","955502784900","54100","17661789","18305586","643797","2024-09"
"443060","HD현대마린솔루션","5516245000000","124100","44450000","44450000","0","2024-09"
"071970","HD현대마린엔진","732703816800","21600","33921473","33921495","22","2024-09"
"010620","HD현대미포","4291550464800","107600","39884298","39942149","57851","2024-09"
"322000","HD현대에너지솔루션","245280000000","21900","11200000","11200000","0","2024-09"
"042670","HD현대인프라코어","1450210470960","7530","192591032","192655867","64835","2024-09"
"267260","HD현대일렉트릭","11859595968000","329500","35992704","36047135","54431","2024-09"
"329180","HD현대중공업","17213107192400","193900","88773116","88773116","0","2024-09"
"097230","HJ중공업","200676699400","2410","83268340","83274281","5941","2024-09"
"195940","HK이노엔","1340003844300","47300","28329891","28329891","0","2024-09"
"014790","HL D&I","93321451465","2465","37858601","37858601","0","2024-09"
"028300","HLB","9069375268800","69300","130871216","131127236","256020","2024-09"
"003580","HLB글로벌","201093600785","4235","47483731","47489591","5860","2024-09"
"278650","HLB바이오스텝","191123834940","2270","84195522","86730589","2535067","2024-09"
"067630","HLB생명과학","1075786813570","9070","118609351","118679271","69920","2024-09"
"024850","HLB이노베이션","315618584240","3460","91219244","91226268","7024","2024-09"
"047920","HLB제약","661427790400","20800","31799413","31799994","581","2024-09"
"115450","HLB테라퓨틱스","726207636700","9100","79803037","80139933","336896","2024-09"
"046210","HLB파나진","127754833185","3015","42373079","42373079","0","2024-09"
"204320","HL만도","1751500576000","37300","46957120","46957120","0","2024-09"
"060980","HL홀딩스","341464639950","35950","9498321","10169410","671089","2024-09"
"011200","HMM","12853517751360","17160","749039496","749039496","0","2024-09"
"403870","HPSP","2338400152400","29200","80082197","82934144","2851947","2024-09"
"036640","HRS","83744448600","5240","15981765","16354800","373035","2024-09"
"035000","HS애드","103566845160","6390","16207644","16567409","359765","2024-09"
"002460","HS화성","84520029970","8930","9464729","10150000","685271","2024-09"
"487570","HS효성","148990325400","40200","3706227","3725927","19700","2024-09"
"298050","HS효성첨단소재","1148281654000","257000","4468022","4479948","11926","2024-09"
"439730","IBKS제20호스팩","9546650000","2215","4310000","4310000","0","2024-09"
"442770","IBKS제21호스팩","9283050000","2205","4210000","4210000","0","2024-09"
"448760","IBKS제22호스팩","9723850000","2195","4430000","4430000","0","2024-09"
"467930","IBKS제23호스팩","9179100000","2170","4230000","4230000","0","2024-09"
"469480","IBKS제24호스팩","9284850000","2195","4230000","4230000","0","2024-09"
"003560","IHQ","63618682920","10760","5912517","5994566","82049","2024-09"
"095340","ISC","1184876716800","57900","20464192","21197058","732866","2024-09"
"175330","JB금융지주","3307973125500","17250","191766558","195083198","3316640","2024-09"
"234080","JW생명과학","171104321700","11050","15484554","15834554","350000","2024-09"
"067290","JW신약","81260066279","1603","50692493","50841502","149009","2024-09"
"001060","JW중외제약","662029027200","28800","22987119","23285930","298811","2024-09"
"096760","JW홀딩스","223419802400","3100","72070904","73924942","1854038","2024-09"
"035900","JYP Ent.","1703039232600","51400","33133059","35532492","2399433","2024-09"
"318000","KBG","49238383260","5660","8699361","8740223","40862","2024-09"
"024840","KBI메탈","96849865180","2780","34838081","34909199","71118","2024-09"
"105560","KB금융","35495996429000","94100","377215690","393528423","16312733","2024-09"
"024120","KB오토시스","40652500000","3535","11500000","11500000","0","2024-09"
"455250","KB제25호스팩","11365200000","2640","4305000","4305000","0","2024-09"
"458320","KB제26호스팩","12331200000","2240","5505000","5505000","0","2024-09"
"464680","KB제27호스팩","25719665000","1993","12905000","12905000","0","2024-09"
"476470","KB제28호스팩","11505450000","2090","5505000","5505000","0","2024-09"
"478390","KB제29호스팩","12751000000","2050","6220000","6220000","0","2024-09"
"486630","KB제30호스팩","10726200000","2020","5310000","5310000","0","2024-09"
"002380","KCC","1915761545500","260500","7354171","8886471","1532300","2024-09"
"021320","KCC건설","84768103000","4250","19945436","21400000","1454564","2024-09"
"344820","KCC글라스","629761653500","39500","15943333","15970512","27179","2024-09"
"036670","KCI","81885122000","7610","10760200","11270000","509800","2024-09"
"009070","KCTC","135921633750","4545","29905750","30000000","94250","2024-09"
"009440","KC그린홀딩스","18761983040","848","22124980","22434980","310000","2024-09"
"119650","KC코트렐","27804804457","433","64214329","64214329","0","2024-09"
"044180","KD","12367281433","463","26711191","26717799","6608","2024-09"
"092220","KEC","177675379785","885","200763141","200763141","0","2024-09"
"046440","KG모빌리언스","162696751470","4385","37103022","38825568","1722546","2024-09"
"003620","KG모빌리티","985949355080","5020","196404254","196404254","0","2024-09"
"016380","KG스틸","649867973040","6520","99673002","100008897","335895","2024-09"
"151860","KG에코솔루션","219035052360","5220","41960738","49603002","7642264","2024-09"
"035600","KG이니시스","246221014000","9250","26618488","27904434","1285946","2024-09"
"001390","KG케미칼","272849124400","3985","68469040","68469040","0","2024-09"
"226360","KH 건설","60474013950","2555","23668890","23756732","87842","2024-09"
"111870","KH 미래물산","43747975260","8910","4909986","4930249","20263","2024-09"
"033180","KH 필룩스","125157155370","6630","18877399","18903579","26180","2024-09"
"060720","KH바텍","196573982640","8920","22037442","23677442","1640000","2024-09"
"015590","KIB플러그에너지","91237893285","385","236981541","236981544","3","2024-09"
"001940","KISCO홀딩스","238949345360","18920","12629458","16176380","3546922","2024-09"
"058400","KNN","101176306080","764","132429720","132429720","0","2024-09"
"025000","KPX케미칼","224921953300","47300","4755221","4840000","84779","2024-09"
"092230","KPX홀딩스","219754583100","55900","3931209","4224646","293437","2024-09"
"000040","KR모터스","32224995360","536","60121260","60132868","11608","2024-09"
"044450","KSS해운","202068848750","8950","22577525","23085880","508355","2024-09"
"101000","KS인더스트리","65839818400","2185","30132640","30149619","16979","2024-09"
"030200","KT","10816334100000","44000","245825775","252021685","6195910","2024-09"
"033780","KT&G","11838361039700","107900","109716043","130322497","20606454","2024-09"
"058850","KTcs","107556296715","2835","37938729","42685000","4746271","2024-09"
"058860","KTis","81142422300","2650","30619782","34802000","4182218","2024-09"
"122450","KX","150713410980","3630","41518846","45335964","3817118","2024-09"
"052900","KX하이텍","52660033680","969","54344720","55107517","762797","2024-09"
"376190","LB루셈","112668000000","4580","24600000","24600000","0","2024-09"
"061970","LB세미콘","200533431360","4580","43784592","43784592","0","2024-09"
"309960","LB인베스트먼트","91981772000","4000","22995443","23217239","221796","2024-09"
"093050","LF","417208368720","15070","27684696","29240000","1555304","2024-09"
"003550","LG","11702261109600","77400","151192004","157300993","6108989","2024-09"
"034220","LG디스플레이","5220000000000","10440","500000000","500000000","0","2024-09"
"051900","LG생활건강","5094275287500","347500","14659785","15618197","958412","2024-09"
"373220","LG에너지솔루션","89271000000000","381500","234000000","234000000","0","2024-09"
"032640","LG유플러스","4276792102400","9950","429828352","436611361","6783009","2024-09"
"011070","LG이노텍","4713969794400","199200","23664507","23667107","2600","2024-09"
"066570","LG전자","15685790639400","96300","162884638","163647814","763176","2024-09"
"037560","LG헬로비전","199812911700","2580","77446865","77446865","0","2024-09"
"051910","LG화학","22448365074000","318000","70592343","70592343","0","2024-09"
"079550","LIG넥스원","5775505400000","265000","21794360","22000000","205640","2024-09"
"225190","LK삼양","126871100000","2500","50748440","50748440","0","2024-09"
"006260","LS","3112149824400","113800","27347538","32200000","4852462","2024-09"
"010120","LS ELECTRIC","4578739102400","154400","29655046","30000000","344954","2024-09"
"000680","LS네트웍스","252957674940","3210","78803014","78803016","2","2024-09"
"060370","LS마린솔루션","443246677200","16200","27360906","28706781","1345875","2024-09"
"417200","LS머트리얼즈","1072971171740","15860","67652659","67652659","0","2024-09"
"229640","LS에코에너지","876466946400","28900","30327576","30624879","297303","2024-09"
"078020","LS증권","215232304840","4270","50405692","55481190","5075498","2024-09"
"108320","LX세미콘","1019771610000","62700","16264300","16264300","0","2024-09"
"001120","LX인터내셔널","1066448294300","29650","35967902","38760000","2792098","2024-09"
"108670","LX하우시스","357544310250","39950","8949795","8967670","17875","2024-09"
"383800","LX홀딩스","542792694480","7120","76234929","76280690","45761","2024-09"
"476080","M83","102762000000","13200","7785000","7785000","0","2024-09"
"086960","MDS테크","99597778524","1073","92821788","92821788","0","2024-09"
"023150","MH에탄올","37527217650","5850","6414909","7378526","963617","2024-09"
"038340","MIT","39924432729","1233","32379913","32424892","44979","2024-09"
"035420","NAVER","25893134412800","171200","151244944","160784508","9539564","2024-09"
"160550","NEW","63904982740","2290","27906106","27906106","0","2024-09"
"053290","NE능률","57842074500","3500","16526307","16526307","0","2024-09"
"181710","NHN","520767189600","15820","32918280","33766123","847843","2024-09"
"060250","NHN KCP","277237492890","7170","38666317","40160611","1494294","2024-09"
"104200","NHN벅스","46375568820","3430","13520574","14827550","1306976","2024-09"
"005940","NH투자증권","4545908015480","13910","326808628","327492299","683671","2024-09"
"034310","NICE","391903758400","11200","34991407","37503477","2512070","2024-09"
"030190","NICE평가정보","653292928100","11150","58591294","60107670","1516376","2024-09"
"008260","NI스틸","111397455715","3895","28600117","28600117","0","2024-09"
"004250","NPC","172927561500","5100","33907365","36720000","2812635","2024-09"
"222160","NPX","79551289560","8040","9894439","9894439","0","2024-09"
"456040","OCI","697399360500","77900","8952495","8952495","0","2024-09"
"010060","OCI홀딩스","1265922453900","66300","19093853","19563983","470130","2024-09"
"178920","PI첨단소재","603477917100","20550","29366322","29366322","0","2024-09"
"024940","PN풍년","55358225200","5890","9398680","10000000","601320","2024-09"
"005490","POSCO홀딩스","25068288238500","331500","75620779","82624377","7003598","2024-09"
"218410","RFHIC","350656870090","13630","25726843","26484442","757599","2024-09"
"327260","RF머트리얼즈","56391778110","6810","8280731","8433231","152500","2024-09"
"091340","S&K폴리텍","26023557690","2430","10709283","11703721","994438","2024-09"
"010950","S-Oil","6608609890400","58700","112582792","112582792","0","2024-09"
"419530","SAMG엔터","104547646000","13160","7944350","8590930","646580","2024-09"
"019550","SBI인베스트먼트","112960824503","701","161142403","162066575","924172","2024-09"
"034120","SBS","279709781520","15080","18548394","18551238","2844","2024-09"
"036120","SCI평가정보","81338298790","2390","34032761","35500000","1467239","2024-09"
"246960","SCL사이언스","63729758750","8750","7283401","7283401","0","2024-09"
"099220","SDN","67064702018","1238","54171811","56171811","2000000","2024-09"
"036540","SFA반도체","575517146490","3510","163964999","164460303","495304","2024-09"
"255220","SG","239992306875","2875","83475585","94073791","10598206","2024-09"
"040610","SG&G","52576401988","1558","33746086","34087196","341110","2024-09"
"049470","SGA","18832625630","322","58486415","58862249","375834","2024-09"
"184230","SGA솔루션즈","31492434785","505","62361257","62599161","237904","2024-09"
"016250","SGC E&C","49815642800","15400","3234782","3243585","8803","2024-09"
"005090","SGC에너지","417089655900","28950","14407242","14409333","2091","2024-09"
"001380","SG글로벌","132644221850","2950","44964143","44964143","0","2024-09"
"004060","SG세계물산","66987928532","337","198777236","202424960","3647724","2024-09"
"001770","SHD","22353755200","18400","1214878","1214878","0","2024-09"
"002360","SH에너지화학","57712948680","530","108892356","111133730","2241374","2024-09"
"009160","SIMPAC","216535368840","3990","54269516","65429516","11160000","2024-09"
"033530","SJG세종","122411652975","4525","27052299","27820961","768662","2024-09"
"123700","SJM","51028016460","3270","15604898","15604898","0","2024-09"
"025530","SJM홀딩스","48787167600","3600","13551991","14934008","1382017","2024-09"
"034730","SK","7970875023800","146200","54520349","72502703","17982354","2024-09"
"011790","SKC","4871618180000","143000","34067260","37868298","3801038","2024-09"
"018670","SK가스","1654998482400","184400","8975046","9230244","255198","2024-09"
"001740","SK네트웍스","996792952600","5140","193928590","221277902","27349312","2024-09"
"006120","SK디스커버리","589733609400","33300","17709718","18785855","1076137","2024-09"
"210980","SK디앤디","152197824380","8180","18606091","18617382","11291","2024-09"
"302440","SK바이오사이언스","4418787325200","56400","78347293","78347293","0","2024-09"
"326030","SK바이오팜","9624698425000","122900","78313250","78313250","0","2024-09"
"402340","SK스퀘어","11546303004400","86600","133329134","134749960","1420826","2024-09"
"361610","SK아이이테크놀로지","2210112140000","31000","71293940","71297592","3652","2024-09"
"100090","SK오션플랜트","784341276000","13250","59195568","59195568","0","2024-09"
"096770","SK이노베이션","10702659885600","112400","95219394","95735590","516196","2024-09"
"475150","SK이터닉스","513790038720","15260","33669072","33691895","22823","2024-09"
"001510","SK증권","207780913906","502","413906203","472590171","58683968","2024-09"
"285130","SK케미칼","829283886900","48150","17222926","17253783","30857","2024-09"
"017670","SK텔레콤","12240964665000","57500","212886342","214790053","1903711","2024-09"
"000660","SK하이닉스","129401473681800","187800","689038731","728002365","38963634","2024-09"
"048550","SM C&C","163826469189","1707","95973327","96714620","741293","2024-09"
"063440","SM Life Design","62323474516","1354","46029154","46029154","0","2024-09"
"003570","SNT다이내믹스","620309672700","27700","22393851","33252697","10858846","2024-09"
"064960","SNT모티브","544116310200","45450","11971756","14623136","2651380","2024-09"
"100840","SNT에너지","262229903160","13270","19761108","20680783","919675","2024-09"
"036530","SNT홀딩스","339802057000","23500","14459662","16303886","1844224","2024-09"
"067160","SOOP","966531852000","90700","10656360","11494767","838407","2024-09"
"005610","SPC삼립","406882194600","50200","8105223","8629009","523786","2024-09"
"011810","STX","153351247500","4950","30980050","31017927","37877","2024-09"
"465770","STX그린로지스","82162785000","11500","7144590","7171032","26442","2024-09"
"077970","STX엔진","494491550500","21500","22999607","23008904","9297","2024-09"
"002820","SUN&L","37818144540","3135","12063204","12607989","544785","2024-09"
"289080","SV인베스트먼트","84908230000","1595","53234000","53234000","0","2024-09"
"084870","TBH글로벌","29074405686","1394","20856819","20856819","0","2024-09"
"002710","TCC스틸","1145538558900","43700","26213697","26213697","0","2024-09"
"089230","THE E&M","29683345037","1357","21874241","21882953","8712","2024-09"
"032540","TJ미디어","72862315070","5230","13931609","13931609","0","2024-09"
"022220","TKG애강","51690989842","998","51794579","51794579","0","2024-09"
"069260","TKG휴켐스","756673694440","19720","38370877","40878588","2507711","2024-09"
"007980","TP","65148126446","1339","48654314","51175130","2520816","2024-09"
"048770","TPC","40736286645","2595","15697991","15697991","0","2024-09"
"246690","TS인베스트먼트","40714727360","998","40796320","41477862","681542","2024-09"
"317240","TS트릴리온","29786621715","279","106762085","107240922","478837","2024-09"
"002900","TYM","132429569795","3085","42926927","45050956","2124029","2024-09"
"024070","WISCOM","31725726660","2070","15326438","15326438","0","2024-09"
"057030","YBM넷","57778118790","3570","16184347","16312697","128350","2024-09"
"037270","YG PLUS","286700933200","4520","63429410","63429410","0","2024-09"
"040300","YTN","133350000000","3175","42000000","42000000","0","2024-09"
"051390","YW","29914955460","3705","8074212","11355368","3281156","2024-09"
"052220","iMBC","56810000000","2470","23000000","23000000","0","2024-09"
"079940","가비아","176942957100","13650","12962854","13535684","572830","2024-09"
"078890","가온그룹","58326883560","3630","16068012","17410157","1342145","2024-09"
"000500","가온전선","276235110000","38750","7128648","7357946","229298","2024-09"
"399720","가온칩스","425642256000","37050","11488320","11488320","0","2024-09"
"036620","감성코퍼레이션","323959264440","3570","90744892","90744892","0","2024-09"
"000860","강남제비스코","165100000000","25400","6500000","6500000","0","2024-09"
"198440","강동씨앤엘","92445465056","1519","60859424","60931896","72472","2024-09"
"217730","강스템바이오텍","112949110235","2015","56054149","56054149","0","2024-09"
"035250","강원랜드","3345193467000","16500","202738998","213940500","11201502","2024-09"
"114190","강원에너지","331501352220","12690","26123038","26123038","0","2024-09"
"094480","갤럭시아머니트리","322076969980","8210","39229838","39229838","0","2024-09"
"011420","갤럭시아에스엠","67634376020","2455","27549644","27549644","0","2024-09"
"039240","경남스틸","73789216940","2735","26979604","26979604","0","2024-09"
"053950","경남제약","23598235245","663","35593115","35593402","287","2024-09"
"002100","경농","165069366000","9240","17864650","19522575","1657925","2024-09"
"009450","경동나비엔","1258850377200","87100","14452932","14568592","115660","2024-09"
"267290","경동도시가스","110563314790","18770","5890427","5895406","4979","2024-09"
"012320","경동인베스트","163962470400","75200","2180352","2365023","184671","2024-09"
"011040","경동제약","173504998800","6440","26941770","30768766","3826996","2024-09"
"000050","경방","146750940300","5890","24915270","27415270","2500000","2024-09"
"214390","경보제약","177867038400","7440","23906860","23906860","0","2024-09"
"012610","경인양행","122856550740","2970","41365842","41616365","250523","2024-09"
"009140","경인전자","26832262200","20600","1302537","1570797","268260","2024-09"
"024910","경창산업","79174133000","2225","35583880","35819005","235125","2024-09"
"013580","계룡건설","119580259500","13500","8857797","8930907","73110","2024-09"
"012200","계양전기","43676220324","1606","27195654","27222829","27175","2024-09"
"002140","고려산업","77344901700","3135","24671420","24939425","268005","2024-09"
"049720","고려신용정보","138838391520","9970","13925616","14300000","374384","2024-09"
"010130","고려아연","17963653246000","874000","20553379","20703283","149904","2024-09"
"002240","고려제강","483267204420","19340","24987963","25000000","12037","2024-09"
"014570","고려제약","53407970550","4950","10789489","11000000","210511","2024-09"
"348150","고바이오랩","141429105000","7300","19373850","19373850","0","2024-09"
"098460","고영","644774026400","9800","65793268","68654755","2861487","2024-09"
"035290","골드앤에스","21311386560","447","47676480","47676480","0","2024-09"
"215000","골프존","396937110000","66100","6005100","6275415","270315","2024-09"
"121440","골프존뉴딘홀딩스","161724071740","3970","40736542","42836818","2100276","2024-09"
"366030","공구우먼","98317709000","4340","22653850","22653850","0","2024-09"
"009290","광동제약","237277223040","5920","40080612","52420851","12340239","2024-09"
"014200","광림","87868591200","30200","2909556","3023556","114000","2024-09"
"017040","광명전기","64356358275","1485","43337615","43337615","0","2024-09"
"029480","광무","209165804110","3805","54971302","55009083","37781","2024-09"
"017900","광전자","92820415209","1843","50363763","57943763","7580000","2024-09"
"037710","광주신세계","223857498200","29350","7627172","7957190","330018","2024-09"
"026910","광진실업","13867701825","2165","6405405","6405405","0","2024-09"
"421800","교보12호스팩","14591200000","2440","5980000","5980000","0","2024-06"
"440790","교보13호스팩","8808750000","2175","4050000","4050000","0","2024-09"
"456490","교보14호스팩","9135000000","2175","4200000","4200000","0","2024-09"
"465320","교보15호스팩","8267700000","2170","3810000","3810000","0","2024-09"
"482520","교보16호스팩","12505000000","2050","6100000","6100000","0","2024-09"
"030610","교보증권","645612756360","5720","112869363","113962961","1093598","2024-09"
"339770","교촌에프앤비","239582558600","9590","24982540","24982540","0","2024-09"
"053270","구영테크","60644407200","2325","26083616","27410405","1326789","2024-09"
"007690","국도화학","275654648700","33050","8340534","9010616","670082","2024-09"
"005320","국동","32312936592","488","66215034","67327897","1112863","2024-09"
"001140","국보","33448047050","2110","15852155","15856388","4233","2024-09"
"066620","국보디자인","108595136520","16430","6609564","7500000","890436","2024-09"
"043650","국순당","76498664760","4860","15740466","17858304","2117838","2024-09"
"006050","국영지앤엠","62773990036","1852","33895243","34895243","1000000","2024-09"
"060480","국일신동","21714220000","1958","11090000","11090000","0","2024-09"
"078130","국일제지","901924696800","800","1127405871","1127405871","0","2024-09"
"307750","국전약품","214922885760","4380","49069152","49069269","117","2024-09"
"002720","국제약품","109753885780","5390","20362502","21159832","797330","2024-09"
"035080","그래디언트","150217665480","10980","13681026","14527584","846558","2024-09"
"453450","그리드위즈","160840687500","20250","7942750","7942750","0","2024-09"
"204020","그리티","55459989890","2770","20021657","20147430","125773","2024-09"
"402490","그린리소스","138041264800","16700","8265944","8265944","0","2024-09"
"114450","그린생명과학","39415625550","2065","19087470","20000000","912530","2024-09"
"083420","그린케미칼","137858574840","5910","23326324","24000000","673676","2024-09"
"186230","그린플러스","100420757800","9350","10740188","10820188","80000","2024-09"
"014530","극동유화","128112143100","3805","33669420","34869420","1200000","2024-09"
"204620","글로벌텍스프리","228265656705","3735","61115303","61116035","732","2024-09"
"019660","글로본","19448027014","559","34790746","34790746","0","2024-09"
"014280","금강공업","109906958530","4090","26872117","29329357","2457240","2024-09"
"053260","금강철강","75509762000","4750","15896792","18720000","2823208","2024-09"
"008870","금비","45344900000","55400","818500","1000000","181500","2024-09"
"001570","금양","2603747224450","44950","57925411","58050037","124626","2024-09"
"282720","금양그린파워","128271147000","10630","12066900","12119500","52600","2024-09"
"002990","금호건설","107147661540","2985","35895364","36953595","1058231","2024-09"
"011780","금호석유","3062964450200","133400","22960753","27334587","4373834","2024-09"
"214330","금호에이치티","126527000643","621","203747183","213914131","10166948","2024-09"
"001210","금호전기","37202145141","893","41659737","42525621","865884","2024-09"
"073240","금호타이어","1177767176700","4100","287260287","287260287","0","2024-09"
"036190","금화피에스시","163295093500","27650","5905790","6000000","94210","2024-09"
"049080","기가레인","58906718612","694","84879998","84883347","3349","2024-09"
"420770","기가비스","478509864500","37750","12675758","12675758","0","2024-09"
"035460","기산텔레콤","27769832700","1905","14577340","14577340","0","2024-09"
"092440","기신정기","74606000000","2555","29200000","29200000","0","2024-09"
"000270","기아","36244760532500","92500","391835249","399858417","8023168","2024-09"
"024110","기업은행","11594572106180","14540","797425867","797425869","2","2024-09"
"013700","까뮤이앤씨","79528354730","1331","59750830","59750830","0","2024-09"
"308100","까스텔바작","20607312285","3195","6449863","6624733","174870","2024-09"
"004540","깨끗한나라","76899045055","2065","37239247","37240693","1446","2024-09"
"407400","꿈비","70178018750","5950","11794625","12259474","464849","2024-09"
"187790","나노","31435070025","1025","30668361","30840830","172469","2024-09"
"286750","나노브릭","44905272580","2170","20693674","20694559","885","2024-09"
"121600","나노신소재","973916160800","81400","11964572","12196078","231506","2024-09"
"247660","나노씨엠에스","34511312160","8080","4271202","4343920","72718","2024-09"
"039860","나노엔텍","145458671460","4530","32110082","32110082","0","2024-09"
"091970","나노캠텍","23382360667","647","36139661","37417493","1277832","2024-09"
"417010","나노팀","199610199360","10120","19724328","19724328","0","2024-09"
"405920","나라셀라","47367417330","3810","12432393","12878076","445683","2024-09"
"051490","나라엠앤디","65046223375","4925","13207355","14200000","992645","2024-09"
"137080","나래나노텍","37049063700","3350","11059422","11059422","0","2024-09"
"190510","나무가","190455407400","12050","15805428","16264384","458956","2024-09"
"242040","나무기술","54311720012","1639","33137108","34606264","1469156","2024-09"
"089600","나스미디어","178072161750","15750","11306169","11568163","261994","2024-09"
"293580","나우IB","87719933700","926","94729950","94929950","200000","2024-09"
"138610","나이벡","213555327250","20750","10291823","10291823","0","2024-09"
"130580","나이스디앤비","78386000000","5090","15400000","15400000","0","2024-09"
"036800","나이스정보통신","164455312500","18750","8770950","10000000","1229050","2024-09"
"267320","나인테크","98740152875","2275","43402265","43664104","261839","2024-09"
"001260","남광토건","60514078240","6160","9823714","9832572","8858","2024-09"
"008350","남선알미늄","172707822420","1338","129079090","129079090","0","2024-09"
"004270","남성","42629904807","1361","31322487","36212160","4889673","2024-09"
"003920","남양유업","389670381000","593000","657117","679731","22614","2024-09"
"025860","남해화학","312146004450","6510","47948695","49678843","1730148","2024-09"
"111710","남화산업","101087080000","4910","20588000","20588000","0","2024-09"
"091590","남화토건","46607800000","3970","11740000","11740000","0","2024-09"
"168330","내츄럴엔도텍","50864652351","1611","31573341","31754900","181559","2024-09"
"094860","네오리진","30557841746","1429","21384074","21399569","15495","2024-09"
"253590","네오셈","429665516820","10110","42499062","43869164","1370102","2024-09"
"212560","네오오토","67878681340","8620","7874557","7874963","406","2024-09"
"095660","네오위즈","399175510150","20050","19909003","22033719","2124716","2024-09"
"042420","네오위즈홀딩스","126073566710","19390","6501989","8856866","2354877","2024-09"
"311390","네오크레마","76667859840","7040","10890321","10979147","88826","2024-09"
"085910","네오티스","46686686260","3490","13377274","13934818","557544","2024-09"
"092730","네오팜","201381171000","25750","7820628","8207361","386733","2024-09"
"290660","네오펙트","39348965142","934","42129513","42129513","0","2024-09"
"306620","네온테크","88723852560","2170","40886568","42608149","1721581","2024-09"
"153460","네이블","40334716800","6300","6402336","6530014","127678","2024-09"
"007390","네이처셀","585006548040","9090","64357156","64357156","0","2024-09"
"033640","네패스","174184462760","7660","22739486","23059202","319716","2024-09"
"330860","네패스아크","153884488350","12630","12184045","12184045","0","2024-09"
"005720","넥센","222609415950","4595","48446010","53543977","5097967","2024-09"
"002350","넥센타이어","670259079220","6970","96163426","97667877","1504451","2024-09"
"089140","넥스턴바이오","44202480560","3920","11276143","11282627","6484","2024-09"
"389650","넥스트바이오메디컬","304463727900","37650","8086686","8086686","0","2024-09"
"137940","넥스트아이","32385633786","423","76561782","78320992","1759210","2024-09"
"396270","넥스트칩","231357542600","12790","18088940","18088940","0","2024-09"
"348210","넥스틴","667746039600","64600","10336626","10437250","100624","2024-09"
"092790","넥스틸","244418800000","9400","26002000","26002000","0","2024-09"
"225570","넥슨게임즈","937149761550","14650","63969267","65860174","1890907","2024-09"
"217270","넵튠","240039792850","5350","44867251","46676150","1808899","2024-09"
"251270","넷마블","4735818203800","57800","81934571","85953502","4018931","2024-09"
"104620","노랑풍선","74854045350","4725","15842126","15842126","0","2024-09"
"090350","노루페인트","172400000000","8620","20000000","20000000","0","2024-09"
"000320","노루홀딩스","138767303220","13540","10248693","13291151","3042458","2024-09"
"194700","노바렉스","185342201520","10470","17702216","18754848","1052632","2024-09"
"285490","노바텍","116144882100","11700","9926913","10575831","648918","2024-09"
"145170","노브랜드","108548877360","13090","8292504","9079834","787330","2024-09"
"106520","노블엠앤비","15902299386","411","38691726","38695952","4226","2024-09"
"376930","노을","107885415200","2920","36947060","36947060","0","2024-09"
"006280","녹십자","1936816306600","169700","11413178","11686538","273360","2024-09"
"142280","녹십자엠에스","88021584930","4055","21706926","21741926","35000","2024-09"
"234690","녹십자웰빙","205666473940","11590","17745166","17752276","7110","2024-09"
"005250","녹십자홀딩스","731079271300","16270","44934190","47028210","2094020","2024-09"
"004370","농심","2116440018000","366000","5782623","6082642","300019","2024-09"
"072710","농심홀딩스","307949256000","66400","4637790","4637790","0","2024-09"
"054050","농우바이오","116862789690","7290","16030561","16030561","0","2024-09"
"069140","누리플랜","17690933667","1353","13075339","13102743","27404","2024-09"
"040160","누리플렉스","28696881900","2540","11297985","12055535","757550","2024-09"
"332290","누보","37446334958","1138","32905391","33384803","479412","2024-09"
"348340","뉴로메카","226279696500","21450","10549170","10549170","0","2024-09"
"060260","뉴보텍","14062843224","1054","13342356","13512009","169653","2024-09"
"123840","뉴온","64200562829","247","259921307","292370108","32448801","2024-09"
"012340","뉴인텍","26928000697","529","50903593","50907162","3569","2024-09"
"214870","뉴지랩파마","64715071880","6920","9351889","9359221","7332","2024-09"
"270870","뉴트리","78435057120","8720","8994846","9200224","205378","2024-09"
"144960","뉴파워프라즈마","193831100570","4790","40465783","43692624","3226841","2024-09"
"085670","뉴프렉스","135943579040","5560","24450284","24450761","477","2024-09"
"064260","다날","207726214450","3110","66792995","68949040","2156045","2024-09"
"340360","다보링크","113026292260","2605","43388212","43388212","0","2024-09"
"039560","다산네트웍스","130749445840","3380","38683268","39505981","822713","2024-09"
"154040","다산솔루에타","29779205946","1659","17950094","17950094","0","2024-09"
"058730","다스코","57089093600","3140","18181240","18796941","615701","2024-09"
"030210","다올투자증권","173276739675","2925","59239911","60911106","1671195","2024-09"
"023590","다우기술","787502994250","18250","43150849","44866617","1715768","2024-09"
"032190","다우데이타","421300000000","11000","38300000","38300000","0","2024-09"
"323350","다원넥스뷰","49801158400","6560","7591640","7596111","4471","2024-09"
"068240","다원시스","417889635150","10950","38163437","38163437","0","2024-09"
"145210","다이나믹디자인","87094193760","2520","34561188","34581687","20499","2024-09"
"019680","대교","152959587060","2270","67383078","84702850","17319772","2024-09"
"006370","대구백화점","62661730830","7530","8321611","10821611","2500000","2024-09"
"008060","대덕","208085521000","6140","33890150","33890150","0","2024-09"
"353200","대덕전자","825756816750","16710","49416925","49416925","0","2024-09"
"000490","대동","193734607140","8220","23568687","25640788","2072101","2024-09"
"020400","대동금속","20155529120","6320","3189166","3189166","0","2024-09"
"008830","대동기어","64710144000","7200","8987520","8987520","0","2024-09"
"048470","대동스틸","35173678980","3740","9404727","10000000","595273","2024-09"
"008110","대동전자","105136322880","15040","6990447","10490447","3500000","2024-09"
"004780","대륙제관","64885051920","4080","15903199","15903199","0","2024-09"
"005750","대림B&Co","58686284800","3520","16672240","16672240","0","2024-09"
"017650","대림제지","58345000000","7000","8335000","9000000","665000","2024-09"
"006570","대림통상","40297462600","2675","15064472","15225000","160528","2024-09"
"007720","대명소노시즌","105638871600","1048","100800450","100800450","0","2024-09"
"389260","대명에너지","216194000000","12680","17050000","17050000","0","2024-09"
"317850","대모","76751152400","9220","8324420","8324420","0","2024-09"
"290670","대보마그네틱","121859708320","16310","7471472","7857660","386188","2024-09"
"078140","대봉엘에스","201993718050","18450","10948169","11086579","138410","2024-09"
"065150","대산F&B","18113400725","145","124920005","125282405","362400","2024-09"
"001680","대상","685684414750","19790","34648025","34648025","0","2024-09"
"084690","대상홀딩스","289700304000","8000","36212538","36212538","0","2024-09"
"036480","대성미생물","38722000000","10190","3800000","3800000","0","2024-09"
"128820","대성산업","129801027510","3465","37460614","45235478","7774864","2024-09"
"117580","대성에너지","260795696140","9590","27194546","27500000","305454","2024-09"
"027830","대성창투","78516000000","1454","54000000","54000000","0","2024-09"
"104040","대성파인텍","45193695830","970","46591439","47224987","633548","2024-09"
"129920","대성하이텍","60483383730","4410","13715053","13715053","0","2024-09"
"016710","대성홀딩스","125649732340","7810","16088314","16089459","1145","2024-09"
"438220","대신밸런스제13호스팩","14382000000","2550","5640000","5640000","0","2024-09"
"442310","대신밸런스제14호스팩","15198150000","2265","6710000","6710000","0","2024-09"
"457390","대신밸런스제15호스팩","16778475000","2385","7035000","7035000","0","2024-09"
"457630","대신밸런스제16호스팩","15643400000","2140","7310000","7310000","0","2024-09"
"471050","대신밸런스제17호스팩","12998700000","2145","6060000","6060000","0","2024-09"
"478780","대신밸런스제18호스팩","16334150000","2065","7910000","7910000","0","2024-09"
"020180","대신정보통신","34048018690","886","38428915","38428915","0","2024-09"
"003540","대신증권","636956510990","16970","37534267","50773400","13239133","2024-09"
"045390","대아티아이","181821312660","2580","70473377","70473377","0","2024-09"
"009190","대양금속","70606323441","1667","42355323","42359986","4663","2024-09"
"108380","대양전기공업","108151430400","11700","9243712","9567333","323621","2024-09"
"014160","대영포장","97831088511","1027","95259093","108394549","13135456","2024-09"
"047040","대우건설","1522331592600","3705","410885720","415622638","4736918","2024-09"
"003090","대웅","1050891247000","25700","40890710","58141980","17251270","2024-09"
"069620","대웅제약","1811086898000","157400","11506270","11586575","80305","2024-09"
"007680","대원","56811352650","4225","13446474","13446474","0","2024-09"
"000430","대원강업","235600000000","3800","62000000","62000000","0","2024-09"
"048910","대원미디어","97400376840","8060","12084414","12578946","494532","2024-09"
"005710","대원산업","116819208000","5830","20037600","20037600","0","2024-09"
"006340","대원전선","211066377625","2815","74979175","74979175","0","2024-09"
"003220","대원제약","312928209400","14600","21433439","22427583","994144","2024-09"
"024890","대원화성","45283906712","1111","40759592","41249152","489560","2024-09"
"290380","대유","56838037000","2300","24712190","24713612","1422","2024-09"
"002880","대유에이텍","49909938336","1068","46732152","46744020","11868","2024-09"
"000300","대유플러스","30475633069","241","126454909","126454909","0","2024-09"
"120240","대정화금","98344448610","13710","7173191","7190391","17200","2024-09"
"003310","대주산업","49726251750","1405","35392350","35392350","0","2024-09"
"078600","대주전자재료","1476497532000","98600","14974620","15480593","505973","2024-09"
"012800","대창","96392319138","1263","76320126","91140499","14820373","2024-09"
"015230","대창단조","127330397000","5050","25213940","28572230","3358290","2024-09"
"096350","대창솔루션","55545192371","349","159155279","163761009","4605730","2024-09"
"140520","대창스틸","47492631000","2250","21107836","21109243","1407","2024-09"
"131220","대한과학","36330435375","4875","7452397","7454490","2093","2024-09"
"010170","대한광통신","76895523312","1032","74511166","74511166","0","2024-09"
"054670","대한뉴팜","108773489750","7750","14035289","14354920","319631","2024-09"
"001070","대한방직","21240412200","5880","3612315","5300000","1687685","2024-09"
"023910","대한약품","149646000000","25450","5880000","6000000","120000","2024-09"
"006650","대한유화","626256540000","101400","6176100","6500000","323900","2024-09"
"001440","대한전선","2229085128000","12000","185757094","186447300","690206","2024-09"
"084010","대한제강","237272087200","13600","17446477","23414397","5967920","2024-09"
"001790","대한제당","260099389200","2940","88469180","89696580","1227400","2024-09"
"001130","대한제분","224075831400","136200","1645197","1690000","44803","2024-09"
"003490","대한항공","8671595436150","23550","368220613","368220661","48","2024-09"
"005880","대한해운","577392025140","1809","319177460","319177460","0","2024-09"
"003830","대한화섬","135825204000","121200","1120670","1328000","207330","2024-09"
"016090","대현","94321320300","2130","44282310","44282310","0","2024-09"
"069460","대호에이엘","70239871860","1041","67473460","67544896","71436","2024-09"
"021040","대호특수강","28262708218","1543","18316726","21704774","3388048","2024-09"
"067080","대화제약","319678862500","18250","17516650","18616650","1100000","2024-09"
"298540","더네이쳐홀딩스","142529057120","9760","14603387","14765856","162469","2024-09"
"032860","더라미","102737625750","2550","40289265","40395863","106598","2024-09"
"192080","더블유게임즈","1007138295600","50800","19825557","21495906","1670349","2024-09"
"393890","더블유씨피","531394088860","15770","33696518","33696518","0","2024-09"
"299170","더블유에스아이","45702536856","1522","30027948","30027963","15","2024-09"
"012510","더존비즈온","1328567632200","47400","28028853","30382784","2353931","2024-09"
"224060","더코디","20348031510","4310","4721121","4748398","27277","2024-09"
"043090","더테크놀로지","31774244677","427","74412751","74412751","0","2024-09"
"213420","덕산네오룩스","720921555250","29350","24562915","24831179","268264","2024-09"
"317330","덕산테코피아","771967216800","37700","20476584","20476584","0","2024-09"
"077360","덕산하이메탈","212872354370","4685","45437002","45437002","0","2024-09"
"004830","덕성","89961137500","6500","13840175","15680000","1839825","2024-09"
"090410","덕신이피씨","64517649000","1400","46084035","46084095","60","2024-09"
"024900","덕양산업","106038186600","3270","32427580","32564980","137400","2024-09"
"263600","덕우전자","94466738300","5930","15930310","15930310","0","2024-09"
"194480","데브시스터즈","373039943200","34550","10797104","12035480","1238376","2024-09"
"263800","데이타솔루션","70392109200","4340","16219380","16219380","0","2024-09"
"206560","덱스터","198473999370","7890","25155133","25411736","256603","2024-09"
"261200","덴티스","106486440250","6970","15277825","15809700","531875","2024-09"
"145720","덴티움","658002883300","76300","8623891","11068830","2444939","2024-09"
"067990","도이치모터스","136968852670","4615","29679058","30181550","502492","2024-09"
"002150","도화엔지니어링","223082027500","6700","33295825","33720000","424175","2024-09"
"006620","동구바이오제약","154565748600","5700","27116798","28464992","1348194","2024-09"
"100130","동국S&C","140727650575","2525","55733723","57143000","1409277","2024-09"
"005160","동국산업","332332450950","6450","51524411","54244482","2720071","2024-09"
"460850","동국씨엠","190432894080","6380","29848416","29898656","50240","2024-09"
"075970","동국알앤에스","45816000000","2490","18400000","18400000","0","2024-09"
"460860","동국제강","423652859100","8550","49550042","49608017","57975","2024-09"
"086450","동국제약","785713878400","17870","43968320","44460000","491680","2024-09"
"001230","동국홀딩스","247879297710","7970","31101543","31800483","698940","2024-09"
"023450","동남합성","113334930000","32700","3465900","3500000","34100","2024-09"
"004140","동방","113273690220","2370","47794806","47971766","176960","2024-09"
"099410","동방선기","40164638400","2880","13946055","14000000","53945","2024-09"
"007590","동방아그로","77163398020","6220","12405691","13617577","1211886","2024-09"
"005960","동부건설","92915318700","4050","22942054","22946345","4291","2024-09"
"026960","동서","2496414831900","25300","98672523","99700000","1027477","2024-09"
"002210","동성제약","103582925640","4530","22865988","26100970","3234982","2024-09"
"102260","동성케미컬","207976063260","4270","48706338","49689728","983390","2024-09"
"033500","동성화인텍","322558063190","11110","29033129","29989494","956365","2024-09"
"025950","동신건설","170520000000","20300","8400000","8400000","0","2024-09"
"000640","동아쏘시오홀딩스","762588206000","122000","6250723","6348913","98190","2024-09"
"170900","동아에스티","696680228800","77600","8977838","9167274","189436","2024-09"
"088130","동아엘텍","86290024590","9870","8742657","8742657","0","2024-09"
"028100","동아지질","165216027600","12470","13249080","14052646","803566","2024-09"
"041930","동아화성","102594580420","6910","14847262","15800000","952738","2024-09"
"001520","동양","146908344762","774","189804063","238684063","48880000","2024-09"
"084670","동양고속","22046050000","8450","2609000","2895569","286569","2024-09"
"082640","동양생명","867055662280","5560","155945263","161358585","5413322","2024-09"
"060380","동양에스텍","28255200000","1464","19300000","19700000","400000","2024-09"
"079960","동양이엔피","150475254110","19490","7720639","7860000","139361","2024-09"
"008970","동양철관","122018198883","777","157037579","157052160","14581","2024-09"
"228340","동양파일","40200000000","2010","20000000","20000000","0","2024-09"
"092780","동양피스톤","73201405600","5800","12620932","13168460","547528","2024-09"
"088910","동우팜투테이블","51700745640","2010","25721764","25831764","110000","2024-09"
"094170","동운아나텍","355831662080","18880","18847016","19067208","220192","2024-09"
"049770","동원F&B","607812030000","31500","19295620","19295620","0","2024-09"
"013120","동원개발","230652574000","2540","90808100","90808100","0","2024-09"
"018500","동원금속","57075406905","1221","46744805","46754933","10128","2024-09"
"006040","동원산업","1185120345500","32900","36021895","36021895","0","2024-09"
"030720","동원수산","26759378750","5750","4653805","4653805","0","2024-09"
"014820","동원시스템즈","1346645048900","46450","28991282","28991282","0","2024-09"
"111380","동인기연","115569033030","19470","5935749","6128000","192251","2024-09"
"163560","동일고무벨트","100636000000","7240","13900000","13900000","0","2024-09"
"109860","동일금속","73764442000","8720","8459225","9100000","640775","2024-09"
"032960","동일기연","41382371400","10950","3779212","3986323","207111","2024-09"
"004890","동일산업","86751143550","40050","2166071","2425215","259144","2024-09"
"002690","동일제강","28042626080","1478","18973360","20300360","1327000","2024-09"
"023790","동일철강","26217477691","1259","20824049","20841335","17286","2024-09"
"005290","동진쎄미켐","1352201192200","26300","51414494","51414494","0","2024-09"
"025900","동화기업","502237036440","10980","45741078","50557285","4816207","2024-09"
"000020","동화약품","211764985200","7640","27717930","27931470","213540","2024-09"
"000150","두산","2826300521000","209000","13522969","16523835","3000866","2024-09"
"454910","두산로보틱스","4401276642000","67900","64819980","64819980","0","2024-09"
"241560","두산밥캣","4053734464500","40500","100092209","100249166","156957","2024-09"
"034020","두산에너빌리티","13225605719200","20650","640465168","640561146","95978","2024-09"
"131970","두산테스나","480467252400","28400","16917861","17006566","88705","2024-09"
"336260","두산퓨얼셀","1121718291270","17130","65482679","65493726","11047","2024-09"
"016740","두올","112923237750","3625","31151238","32066680","915442","2024-09"
"073190","듀오백","28322401280","2560","11063438","11968040","904602","2024-09"
"030350","드래곤플라이","16514575574","238","69388973","69388973","0","2024-09"
"203650","드림시큐리티","157703658765","3235","48749199","50605754","1856555","2024-09"
"223250","드림씨아이에스","108405920820","4555","23799324","23799324","0","2024-09"
"060570","드림어스컴퍼니","131959644885","1745","75621573","75621573","0","2024-09"
"362990","드림인사이트","36483520800","2225","16397088","16800574","403486","2024-09"
"192650","드림텍","576598570380","8540","67517397","68883113","1365716","2024-09"
"217620","디딤이앤에프","21715711458","381","56996618","57747210","750592","2024-09"
"016670","디모아","19297265420","3910","4935362","4941846","6484","2024-09"
"187870","디바이스이엔지","91214636020","13570","6721786","7036609","314823","2024-09"
"024090","디씨엠","106843955640","12310","8679444","11400000","2720556","2024-09"
"003160","디아이","468562009690","18010","26016769","28300000","2283231","2024-09"
"092200","디아이씨","141422443750","3650","38745875","38888569","142694","2024-09"
"110990","디아이티","248520097320","13480","18436209","18900000","463791","2024-09"
"263690","디알젬","80120904120","7310","10960452","11325610","365158","2024-09"
"214680","디알텍","214176888520","2905","73726984","73727108","124","2024-09"
"347850","디앤디파마텍","504278182650","47850","10538729","10538729","0","2024-09"
"263720","디앤씨미디어","219578734790","17690","12412591","12524473","111882","2024-09"
"376300","디어유","574469425200","24200","23738406","23738406","0","2024-09"
"109740","디에스케이","130804763700","5190","25203230","25710390","507160","2024-09"
"196490","디에이테크놀로지","36209568780","203","178372260","178549360","177100","2024-09"
"066900","디에이피","42417188130","2410","17600493","22744503","5144010","2024-09"
"127120","디엔에이링크","82290865380","3660","22483843","22483843","0","2024-09"
"092070","디엔에프","116181454320","10040","11571858","11571858","0","2024-09"
"039840","디오","231087288120","15990","14451988","14981755","529767","2024-09"
"013570","디와이","113724970510","4610","24669191","26319633","1650442","2024-09"
"219550","디와이디","39721400246","506","78500791","78500791","0","2024-09"
"310870","디와이씨","25237270140","1220","20686287","20687271","984","2024-09"
"210540","디와이파워","137617061970","12470","11035851","11041708","5857","2024-09"
"104460","디와이피엔에프","101396570780","10490","9666022","10713625","1047603","2024-09"
"079810","디이엔티","161491150010","7390","21852659","22028094","175435","2024-09"
"113810","디젠스","28516916574","874","32628051","32628051","0","2024-09"
"043360","디지아이","18727734900","2100","8917969","9000000","82031","2024-09"
"197140","디지캡","34259419800","2700","12688674","13013154","324480","2024-09"
"068930","디지털대성","192858496000","7360","26203600","27675342","1471742","2024-09"
"033130","디지틀조선","59421542467","1601","37115267","37115267","0","2024-09"
"105740","디케이락","75043625940","7380","10168513","10168513","0","2024-09"
"263020","디케이앤디","48954643990","3290","14879831","15069831","190000","2024-09"
"290550","디케이티","167210282800","8360","20001230","20001230","0","2024-09"
"066670","디티씨","52194633050","3325","15697634","18691918","2994284","2024-09"
"187220","디티앤씨","36706911605","3185","11524933","11698021","173088","2024-09"
"383930","디티앤씨알오","89138173760","6980","12770512","12770512","0","2024-09"
"131180","딜리","28203663915","1015","27786861","29350000","1563139","2024-09"
"315640","딥노이드","146186667360","6520","22421268","22421268","0","2024-09"
"223310","딥마인드","49435843820","2165","22834108","22839375","5267","2024-09"
"317120","라닉스","33382814850","3465","9634290","9660000","25710","2024-09"
"462510","라메디텍","91524776300","10580","8650735","8650735","0","2024-09"
"042510","라온시큐어","103305869940","1911","54058540","56025871","1967331","2024-09"
"232680","라온테크","74402358800","6100","12197108","12534234","337126","2024-09"
"418420","라온텍","102858928700","3425","30031804","30108433","76629","2024-09"
"300120","라온피플","96060355260","4605","20860012","20860012","0","2024-09"
"171120","라이온켐텍","82062502500","2325","35295700","35901760","606060","2024-09"
"388790","라이콤","88103392965","2955","29815023","29913930","98907","2024-09"
"347700","라이프시맨틱스","71180124520","3560","19994417","19994417","0","2024-09"
"214260","라파스","158310499750","18850","8398435","8912435","514000","2024-09"
"115390","락앤락","374233582080","8640","43314072","43326411","12339","2024-09"
"200350","래몽래인","139244628250","13930","9996025","9996025","0","2024-09"
"171010","램테크놀러지","53191357440","3720","14298752","14298752","0","2024-09"
"084650","랩지노믹스","265036764300","3570","74239990","74239990","0","2024-09"
"217500","러셀","52359212570","1805","29007874","31812000","2804126","2024-09"
"038390","레드캡투어","130589619820","15620","8360411","8589480","229069","2024-09"
"294140","레몬","86076560300","4100","20994283","21000000","5717","2024-09"
"443250","레뷰코퍼레이션","83296624800","7730","10775760","11279386","503626","2024-09"
"228670","레이","136823092820","8830","15495254","15495254","0","2024-09"
"228850","레이언스","108896164800","6920","15736440","16591014","854574","2024-09"
"412350","레이저쎌","45205714960","5180","8726972","8726972","0","2024-09"
"199550","레이저옵텍","81004772850","6950","11655363","11656947","1584","2024-09"
"281740","레이크머티리얼즈","937317072600","14260","65730510","65730548","38","2024-09"
"277810","레인보우로보틱스","2483181824000","128000","19399858","19399858","0","2024-09"
"215100","로보로보","66008431100","3260","20247985","20348454","100469","2024-09"
"090360","로보스타","203775000000","20900","9750000","9750000","0","2024-09"
"108490","로보티즈","232125156000","18000","12895842","13051842","156000","2024-09"
"067730","로지시스","25200566810","2605","9673922","9673922","0","2024-09"
"071280","로체시스템즈","296531451720","19880","14916069","15296603","380534","2024-09"
"032350","롯데관광개발","736817089610","9670","76196183","76196183","0","2024-09"
"089860","롯데렌탈","1067927452200","29400","36324063","36634063","310000","2024-09"
"000400","롯데손해보험","692406467200","2240","309110030","310336320","1226290","2024-09"
"023530","롯데쇼핑","1823456280000","64500","28270640","28288755","18115","2024-09"
"020150","롯데에너지머티리얼즈","1648462351250","35750","46110835","46110835","0","2024-09"
"280360","롯데웰푸드","1149364710000","130000","8841267","9434574","593307","2024-09"
"286940","롯데이노베이트","347975441000","23000","15129367","15129367","0","2024-09"
"004000","롯데정밀화학","1161432000000","45600","25470000","25800000","330000","2024-09"
"004990","롯데지주","1681625875000","23750","70805300","104909237","34103937","2024-09"
"005300","롯데칠성","1094908312000","118000","9278884","9278884","0","2024-09"
"011170","롯데케미칼","3854077235800","91400","42167147","42775419","608272","2024-09"
"071840","롯데하이마트","185779767360","8030","23135712","23607712","472000","2024-09"
"328130","루닛","1118834640000","38750","28873152","28873152","0","2024-09"
"038060","루멘스","59022465663","1227","48103069","48103069","0","2024-09"
"474170","루미르","215462981760","12560","17154696","17154696",,"자료 없음"
"141080","리가켐바이오","4761054383600","130700","36427348","36567348","140000","2024-09"
"058470","리노공업","2732241600000","180000","15179120","15242370","63250","2024-09"
"016100","리더스코스메틱","51431994735","2805","18335827","19100894","765067","2024-09"
"012700","리드코프","112617348800","4400","25594852","26446135","851283","2024-09"
"302550","리메드","104475852800","3410","30638080","30638080","0","2024-09"
"073570","리튬포어스","60718643106","1678","36185127","36189497","4370","2024-09"
"377450","리파인","211351446000","13900","15205140","17330000","2124860","2024-09"
"277070","린드먼아시아","50804494500","4010","12669450","13692000","1022550","2024-09"
"042500","링네트","75275989800","4675","16101816","19070134","2968318","2024-09"
"193250","링크드","28495519650","450","63323377","63323377","0","2024-09"
"219420","링크제니시스","49464657015","4395","11254757","11469507","214750","2024-09"
"439090","마녀공장","318884722200","19470","16378260","16378260","0","2024-09"
"027740","마니커","58992631522","929","63501218","63511228","10010","2024-09"
"195500","마니커에프앤지","46895430000","2935","15978000","15978000","0","2024-09"
"377480","마음AI","67134286960","10760","6239246","6239246","0","2024-09"
"305090","마이크로디지탈","233500886800","14120","16536890","16536890","0","2024-09"
"098120","마이크로컨텍솔","43808276820","5270","8312766","8312766","0","2024-09"
"424980","마이크로투나노","46404097600","7840","5918890","5918890","0","2024-09"
"038290","마크로젠","178724910870","17910","9979057","10841400","862343","2024-09"
"001080","만호제강","92380375000","31250","2956172","4150000","1193828","2024-09"
"267980","매일유업","271708453800","37650","7216692","7843638","626946","2024-09"
"005990","매일홀딩스","104830742750","8390","12494725","13718304","1223579","2024-09"
"093520","매커스","86366561600","8800","9814382","16163092","6348710","2024-09"
"377030","맥스트","45991572700","2350","19570882","19570882","0","2024-09"
"100590","머큐리","55088480040","3480","15830023","15830023","0","2024-09"
"067280","멀티캠퍼스","182248454250","30750","5926779","5926779","0","2024-09"
"072870","메가스터디","127986562440","11220","11407002","11920959","513957","2024-09"
"215200","메가스터디교육","455102612100","42300","10758927","11461955","703028","2024-09"
"133750","메가엠디","44260344925","2005","22074985","23407077","1332092","2024-09"
"446540","메가터치","83810985000","4035","20771000","20771000","0","2024-09"
"235980","메드팩토","200812556100","5980","33580695","33580695","0","2024-09"
"041920","메디아나","85468109250","4605","18559850","18598223","38373","2024-09"
"014100","메디앙스","24522547210","2170","11300713","11800000","499287","2024-09"
"054180","메디콕스","26433181372","449","58871228","58878283","7055","2024-09"
"086900","메디톡스","1147685968000","170500","6731296","7298497","567201","2024-09"
"078160","메디포스트","220960126800","6480","34098785","34217785","119000","2024-09"
"138040","메리츠금융지주","19629669328100","106100","185011021","190720114","5709093","2024-09"
"408920","메쎄이상","94038724830","2185","43038318","43232455","194137","2024-09"
"021880","메이슨캐피탈","47785904112","314","152184408","152184408","0","2024-09"
"140410","메지온","889779864600","29700","29958918","29958918","0","2024-09"
"241770","메카로","76118469500","7730","9847150","10192640","345490","2024-09"
"090370","메타랩스","39867508029","1601","24901629","24904689","3060","2024-09"
"059210","메타바이오메드","89654743360","3920","22871108","23862351","991243","2024-09"
"118000","메타케어","57176997870","347","164775210","164777364","2154","2024-09"
"058110","멕아이씨에스","39363726200","2540","15497530","16050530","553000","2024-09"
"017180","명문제약","79058002815","2365","33428331","33953454","525123","2024-09"
"009900","명신산업","614425257430","11710","52470133","52470133","0","2024-09"
"012690","모나리자","111510363750","3050","36560775","36571255","10480","2024-09"
"005360","모나미","42802400355","2265","18897307","18897307","0","2024-09"
"070960","모나용평","186379663020","3940","47304483","48133333","828850","2024-09"
"434480","모니터랩","43292624000","3680","11764300","12253300","489000","2024-09"
"080420","모다이노칩","151949411532","1906","79721622","79721622","0","2024-09"
"417970","모델솔루션","61152452000","9560","6396700","6396700","0","2024-09"
"080160","모두투어","173469135780","10020","17312289","18900000","1587711","2024-09"
"087260","모바일어플라이언스","70314179760","2160","32552861","32552861","0","2024-09"
"101330","모베이스","72218730480","3120","23147029","23147029","0","2024-09"
"012860","모베이스전자","127771693152","1758","72680144","73233457","553313","2024-09"
"363260","모비데이즈","74557369000","2350","31726540","32163769","437229","2024-09"
"348030","모비릭스","50612026000","5270","9603800","9603800","0","2024-09"
"250060","모비스","109581543540","3420","32041387","32171314","129927","2024-09"
"288980","모아데이타","56327196060","1630","34556562","34556562","0","2024-09"
"142760","모아라이프플러스","47772270726","1266","37734811","37734811","0","2024-09"
"033200","모아텍","30098809830","3270","9204529","14331185","5126656","2024-09"
"333050","모코엠시스","29719636032","1293","22985024","24444326","1459302","2024-09"
"009680","모토닉","185781290160","8590","21627624","33000000","11372376","2024-09"
"118990","모트렉스","245222767580","9890","24795022","24861990","66968","2024-09"
"006920","모헨즈","27627600000","2530","10920000","10920000","0","2024-09"
"009580","무림P&P","175554035070","2815","62363778","62368324","4546","2024-09"
"001810","무림SP","35353587500","1597","22137500","22137500","0","2024-09"
"009200","무림페이퍼","85091038950","2045","41609310","41609310","0","2024-09"
"033920","무학","149121066840","5630","26486868","28500000","2013132","2024-09"
"008420","문배철강","43468468350","2270","19149105","20503505","1354400","2024-09"
"279600","미디어젠","52938025300","11300","4684781","4684781","0","2024-09"
"095500","미래나노텍","284858725320","10040","28372383","31009999","2637616","2024-09"
"254490","미래반도체","235195020000","16290","14438000","14438000","0","2024-09"
"025560","미래산업","31830869630","1022","31145665","31166865","21200","2024-09"
"218150","미래생명자원","92798908440","4760","19495569","20415802","920233","2024-09"
"007120","미래아이앤지","28088161192","1028","27323114","28878608","1555494","2024-09"
"442900","미래에셋드림스팩1호","76569600000","9970","7680000","7680000","0","2024-09"
"100790","미래에셋벤처투자","254447568620","4790","53120578","53124634","4056","2024-09"
"412930","미래에셋비전스팩1호","16212000000","2625","6176000","6176000","0","2024-09"
"446190","미래에셋비전스팩2호","10840500000","2190","4950000","4950000","0","2024-09"
"448830","미래에셋비전스팩3호","10676400000","2170","4920000","4920000","0","2024-09"
"477380","미래에셋비전스팩4호","16362000000","2020","8100000","8100000","0","2024-09"
"477470","미래에셋비전스팩5호","11343600000","2070","5480000","5480000","0","2024-09"
"478440","미래에셋비전스팩6호","14067900000","2030","6930000","6930000","0","2024-09"
"482680","미래에셋비전스팩7호","16339635000","1989","8215000","8215000","0","2024-09"
"085620","미래에셋생명","679800800000","5210","130480000","177016189","46536189","2024-09"
"006800","미래에셋증권","4060336981840","9040","449152321","595316408","146164087","2024-09"
"049950","미래컴퍼니","146008506180","18420","7926629","8817884","891255","2024-09"
"207760","미스터블루","115996270720","1408","82383715","83079783","696068","2024-09"
"002840","미원상사","933483195000","201000","4644195","4750000","105805","2024-09"
"268280","미원에스씨","722211821100","147900","4883109","5000000","116891","2024-09"
"107590","미원홀딩스","185467545000","80100","2315450","2320000","4550","2024-09"
"134380","미원화학","160203360000","80000","2002542","2199268","196726","2024-09"
"003650","미창석유","140253153300","92700","1512979","1739672","226693","2024-09"
"059090","미코","324409799100","10300","31496097","33416778","1920681","2024-09"
"214610","미코바이오메드","83852197275","1925","43559583","43568945","9362","2024-09"
"201490","미투온","66713890360","2180","30602702","31257770","655068","2024-09"
"452200","민테크","149447493000","6810","21945300","21945300","0","2024-09"
"418470","밀리의서재","118820060220","13980","8499289","8499289","0","2024-09"
"206640","바디텍메드","300197569360","13660","21976396","23486560","1510164","2024-09"
"018700","바른손","40211399424","1168","34427568","35119757","692189","2024-09"
"035620","바른손이앤에이","36019607035","485","74267231","74439675","172444","2024-09"
"053030","바이넥스","694255833200","22450","30924536","31761048","836512","2024-09"
"301300","바이브컴퍼니","51963765000","4200","12372325","12394861","22536","2024-09"
"377740","바이오노트","470919429800","4630","101710460","102056048","345588","2024-09"
"064550","바이오니아","624609042200","24200","25810291","25810291","0","2024-09"
"314930","바이오다인","596904390000","20250","29476760","29764103","287343","2024-09"
"208710","바이오로그디바이스","30314305440","460","65900664","65900664","0","2024-09"
"086820","바이오솔루션","127013872940","15830","8023618","8143426","119808","2024-09"
"038460","바이오스마트","83762468200","3635","23043320","23933216","889896","2024-09"
"251120","바이오에프디엔씨","142007000850","16650","8528949","8695700","166751","2024-09"
"199730","바이오인프라","43827946670","9010","4864367","4864367","0","2024-09"
"086040","바이오톡스텍","72708649125","4625","15720789","15958247","237458","2024-09"
"099430","바이오플러스","320358249130","5690","56301977","57930864","1628887","2024-09"
"032980","바이온","29546226600","660","44767010","44777990","10980","2024-09"
"308080","바이젠셀","64533529000","3350","19263740","19263740","0","2024-09"
"043150","바텍","340905175200","22950","14854256","14854256","0","2024-09"
"323990","박셀바이오","295783339600","12880","22964545","22993200","28655","2024-09"
"003610","방림","110429932080","3120","35394209","42314090","6919881","2024-09"
"267790","배럴","37194277500","4715","7888500","7888500","0","2024-09"
"001340","백광산업","406171784400","9200","44149107","44918407","769300","2024-09"
"046310","백금T&A","38838133845","2415","16082043","16418641","336598","2024-09"
"035150","백산","296485000000","13790","21500000","21500000","0","2024-09"
"331520","밸로프","34095632480","695","49058464","50864390","1805926","2024-09"
"199480","뱅크웨어글로벌","77407647120","7740","10000988","10000988","0","2024-09"
"438700","버넥트","39007115000","3500","11144890","11144890","0","2024-09"
"066410","버킷스튜디오","96977294204","1153","84108668","84109926","1258","2024-09"
"002410","범양건영","25599680512","1031","24829952","24831982","2030","2024-09"
"382900","범한퓨얼셀","124703725000","14530","8582500","8761000","178500","2024-09"
"206400","베노티앤알","129677720000","4000","32419430","32420452","1022","2024-09"
"019010","베뉴지","88440000000","2200","40200000","48200000","8000000","2024-09"
"177350","베셀","22925212377","257","89203161","89372043","168882","2024-09"
"424760","벨로크","19800861516","1021","19393596","19665002","271406","2024-09"
"007210","벽산","113363317125","2025","55981885","67560000","11578115","2024-09"
"225530","보광산업","144990818490","3990","36338551","36338727","176","2024-09"
"250000","보라티알","63461806140","9690","6549206","6750733","201527","2024-09"
"002760","보락","76971500000","1285","59900000","59900000","0","2024-09"
"003850","보령","750869094000","11400","65865710","68690000","2824290","2024-09"
"310210","보로노이","1998190158300","111300","17953191","18356592","403401","2024-09"
"006910","보성파워텍","160979120960","3290","48929824","49129824","200000","2024-09"
"000890","보해양조","58550824232","421","139075592","139120129","44537","2024-09"
"226340","본느","69011665100","1645","41952380","41952420","40","2024-09"
"003000","부광약품","344326995130","5030","68454671","68454671","0","2024-09"
"001270","부국증권","166889328200","28100","5939122","10369886","4430764","2024-09"
"026940","부국철강","50000000000","2500","20000000","20000000","0","2024-09"
"014470","부방","89891355675","1675","53666481","60052260","6385779","2024-09"
"011390","부산산업","56179200000","53200","1056000","1056000","0","2024-09"
"005030","부산주공","38288532168","486","78782988","78782988","0","2024-09"
"008470","부스타","32569698330","4030","8081811","8404800","322989","2024-09"
"338220","뷰노","427757083600","30800","13888217","13888217","0","2024-09"
"100120","뷰웍스","232302348300","25300","9181911","10001865","819954","2024-09"
"406820","뷰티스킨","50466091200","14280","3534040","3534040","0","2024-09"
"337930","브랜드엑스코퍼레이션","260872768300","8900","29311547","29311547","0","2024-09"
"099390","브레인즈컴퍼니","47737146040","6040","7903501","8208283","304782","2024-09"
"064480","브리지텍","59574933560","5140","11590454","11952500","362046","2024-09"
"288330","브릿지바이오테라퓨틱스","275383916310","5790","47561989","47561989","0","2024-09"
"365900","브이씨","24745365500","3385","7310300","7310300","0","2024-09"
"089970","브이엠","186155054800","8450","22030184","24075595","2045411","2024-09"
"251630","브이원텍","63950482550","4190","15262645","15942886","680241","2024-09"
"018290","브이티","1096719084300","30900","35492527","35798007","305480","2024-09"
"439580","블루엠텍","267526792950","23950","11170221","11170221","0","2024-09"
"033560","블루콤","58533797210","3430","17065247","17100000","34753","2024-09"
"369370","블리츠웨이스튜디오","78749486979","1653","47640343","49871911","2231568","2024-09"
"126340","비나텍","222279431200","37600","5911687","6085118","173431","2024-09"
"121800","비덴트","256296018720","3320","77197596","77201611","4015","2024-09"
"082800","비보존 제약","201950412000","4250","47517744","48242965","725221","2024-09"
"318410","비비씨","47330670360","8520","5555243","5555243","0","2024-09"
"002070","비비안","25295097510","849","29793990","29793990","0","2024-09"
"100220","비상교육","62360211350","5090","12251515","12996741","745226","2024-09"
"419540","비스토스","44647463610","1942","22990455","22992511","2056","2024-09"
"146320","비씨엔씨","175324910240","13810","12695504","12792923","97419","2024-09"
"200780","비씨월드제약","41602125450","4930","8438565","8892384","453819","2024-09"
"413640","비아이매트릭스","54700674600","7590","7206940","7206940","0","2024-09"
"141000","비아트론","73802869110","6690","11031819","12114710","1082891","2024-09"
"090460","비에이치","539774029200","17200","31382211","34464379","3082168","2024-09"
"083650","비에이치아이","315919188140","10210","30942134","30944375","2241","2024-09"
"445360","비엔케이제1호스팩","9029450000","2095","4310000","4310000","0","2024-09"
"473370","비엔케이제2호스팩","8504200000","2020","4210000","4210000","0","2024-09"
"065170","비엘팜텍","21174562976","238","88968752","88970559","1807","2024-09"
"086670","비엠티","81214048600","8900","9125174","9125174","0","2024-09"
"335890","비올","513912166000","8900","57742940","58419125","676185","2024-09"
"230980","비유테크놀러지","21370405721","229","93320549","93320557","8","2024-09"
"138580","비즈니스온","356042480800","15850","22463248","22556163","92915","2024-09"
"082920","비츠로셀","436842198000","19500","22402164","22872213","470049","2024-09"
"054220","비츠로시스","22171430149","451","49160599","49160599","0","2024-09"
"042370","비츠로테크","185496177000","7080","26200025","26200025","0","2024-09"
"050090","비케이홀딩스","15820509265","803","19701755","19784735","82980","2024-09"
"148780","비큐AI","33804154375","1075","31445725","31445725","0","2024-09"
"307870","비투엔","45660262032","1008","45297879","45297879","0","2024-09"
"357880","비트나인","21096791120","2020","10443956","10443956","0","2024-09"
"032850","비트컴퓨터","78990234400","4900","16120456","16623293","502837","2024-09"
"238200","비피도","35296700000","4315","8180000","8180000","0","2024-09"
"093190","빅솔론","67801326695","4505","15050239","19238905","4188666","2024-09"
"065450","빅텍","150140672000","5240","28652800","28652800","0","2024-09"
"210120","빅텐츠","82546012500","26250","3144610","3144610","0","2024-09"
"044480","빌리언스","25821467280","635","40663728","40663728","0","2024-09"
"005180","빙그레","557033463000","63000","8841801","9851241","1009440","2024-09"
"069540","빛과전자","62740094960","1478","42449320","42449320","0","2024-09"
"072950","빛샘전자","31481752320","3930","8010624","8052610","41986","2024-09"
"451250","삐아","108041519330","11390","9485647","9682187","196540","2024-09"
"143240","사람인","178259822040","16420","10856262","11709263","853001","2024-09"
"003960","사조대림","361992484350","43350","8350461","9164467","814006","2024-09"
"008040","사조동아원","145456472208","1032","140946194","141144600","198406","2024-09"
"007160","사조산업","304573000000","61000","4993000","5000000","7000","2024-09"
"014710","사조씨푸드","117086092400","6800","17218543","17218543","0","2024-09"
"006090","사조오양","84333487200","8950","9422736","9422739","3","2024-09"
"452430","사피엔반도체","95363387920","11780","8095364","8096454","1090","2024-09"
"419120","산돌","47775967930","6530","7316381","7774326","457945","2024-09"
"062040","산일전기","1282223663400","42200","30384447","30445200","60753","2024-09"
"122350","삼기","56183120640","1480","37961568","38339428","377860","2024-09"
"419050","삼기이브이","112219022880","1962","57196240","57196240","0","2024-09"
"014970","삼륭물산","58356726400","3920","14886920","15125000","238080","2024-09"
"018310","삼목에스폼","325763995800","22900","14225502","14700000","474498","2024-09"
"053700","삼보모터스","94250773440","4240","22228956","22877190","648234","2024-09"
"009620","삼보산업","19552902305","265","73784537","73785902","1365","2024-09"
"023600","삼보판지","144370452420","9210","15675402","16170000","494598","2024-09"
"001470","삼부토건","105097557280","470","223611824","223611824","0","2024-09"
"028050","삼성E&A","3890600000000","19850","196000000","196000000","0","2024-09"
"006400","삼성SDI","21200337036000","324000","65433139","68764530","3331391","2024-09"
"006660","삼성공조","83245511940","10590","7860766","8126314","265548","2024-09"
"028260","삼성물산","22071007774100","136100","162167581","177784107","15616526","2024-09"
"207940","삼성바이오로직스","75373266000000","1059000","71174000","71174000","0","2024-09"
"032830","삼성생명","18460287281200","102800","179574779","200000000","20425221","2024-09"
"425290","삼성스팩6호","11619600000","2105","5520000","5520000","0","2024-09"
"439250","삼성스팩7호","36420800000","10400","3502000","3502000","0","2024-09"
"448740","삼성스팩8호","46873200000","10050","4664000","4664000","0","2024-09"
"468510","삼성스팩9호","22376250000","2025","11050000","11050000","0","2024-09"
"018260","삼성에스디에스","11316332211800","146300","77350186","77377800","27614","2024-09"
"009150","삼성전기","8752320998400","120400","72693696","74693696","2000000","2024-09"
"005930","삼성전자","344456453135000","57700","5969782550","5969782550","0","2024-09"
"001360","삼성제약","165745841256","1761","94120296","94162079","41783","2024-09"
"010140","삼성중공업","8531815354290","9990","854035571","880000000","25964429","2024-09"
"016360","삼성증권","4264075000000","47750","89300000","89300000","0","2024-09"
"068290","삼성출판사","142100000000","14210","10000000","10000000","0","2024-09"
"029780","삼성카드","4353796356000","40800","106710695","115858891","9148196","2024-09"
"000810","삼성화재","14298358264000","359000","39828296","47374837","7546541","2024-09"
"006110","삼아알미늄","723826267200","49200","14711916","14711916","0","2024-09"
"009300","삼아제약","133968356900","21950","6103342","6370000","266658","2024-09"
"145990","삼양사","479934277500","49650","9666350","10313449","647099","2024-09"
"003230","삼양식품","4198926064000","563000","7458128","7533015","74887","2024-09"
"002170","삼양통상","129538000000","47800","2710000","3000000","290000","2024-09"
"272550","삼양패키징","249847911810","16110","15508871","15788671","279800","2024-09"
"000070","삼양홀딩스","534615685500","71900","7435545","8564271","1128726","2024-09"
"003720","삼영","152554147000","4600","33163945","34000000","836055","2024-09"
"002810","삼영무역","224229482880","12720","17628104","18466948","838844","2024-09"
"361670","삼영에스앤씨","38935542840","6980","5578158","5667658","89500","2024-09"
"054540","삼영엠텍","49672350000","4095","12130000","13000000","870000","2024-09"
"065570","삼영이엔씨","26396345759","1939","13613381","13613381","0","2024-09"
"005680","삼영전자","194777076000","9750","19977136","20000000","22864","2024-09"
"023000","삼원강재","102330386700","2575","39739956","40000000","260044","2024-09"
"004380","삼익THK","184644000000","8920","20700000","21000000","300000","2024-09"
"002450","삼익악기","82873697350","1090","76030915","90530915","14500000","2024-09"
"032280","삼일","23793444480","1534","15510720","16213590","702870","2024-09"
"002290","삼일기업공사","35278000000","2845","12400000","12400000","0","2024-09"
"004440","삼일씨엔에스","54110774750","4250","12731947","12731947","0","2024-09"
"000520","삼일제약","367742411960","17380","21158942","21621100","462158","2024-09"
"009770","삼정펄프","67124221350","26850","2499971","2499971","0","2024-09"
"037460","삼지전자","133101077040","8670","15351912","16318522","966610","2024-09"
"032750","삼진","37273489540","4130","9025058","9031122","6064","2024-09"
"054090","삼진엘앤디","22680080295","915","24786973","24959232","172259","2024-09"
"005500","삼진제약","233886184600","18670","12527380","13900000","1372620","2024-09"
"000250","삼천당제약","3104872512000","133500","23257472","23457472","200000","2024-09"
"004690","삼천리","303368615000","88600","3424025","4055025","631000","2024-09"
"024950","삼천리자전거","48955292060","4045","12102668","13273577","1170909","2024-09"
"038500","삼표시멘트","320987120480","2990","107353552","107916306","562754","2024-09"
"437730","삼현","82545366090","7810","10569189","10569189","0","2024-09"
"017480","삼현철강","74203086450","4805","15442890","15702890","260000","2024-09"
"010960","삼호개발","69875000000","3125","22360000","25000000","2640000","2024-09"
"046390","삼화네트웍스","59344489614","1499","39589386","43172933","3583547","2024-09"
"004450","삼화왕관","57828423950","32050","1804319","2154379","350060","2024-09"
"009470","삼화전기","252647924000","38200","6613820","6613820","0","2024-09"
"011230","삼화전자","50026687680","2960","16900908","16902700","1792","2024-09"
"001820","삼화콘덴서","339126050000","33050","10261000","10395000","134000","2024-09"
"000390","삼화페인트","165606503400","7020","23590670","27203469","3612799","2024-09"
"027580","상보","68387343002","1214","56332243","59181279","2849036","2024-09"
"038540","상상인","91717886576","1676","54724276","55328313","604037","2024-09"
"415580","상상인제3호스팩","11151000000","2100","5310000","5310000","0","2024-09"
"452670","상상인제4호스팩","10466100000","2005","5220000","5220000","0","2024-09"
"001290","상상인증권","50900379839","479","106263841","108337120","2073279","2024-09"
"041650","상신브레이크","66018657100","3410","19360310","21471450","2111140","2024-09"
"091580","상신이디피","134348447520","10080","13328219","13428219","100000","2024-09"
"263810","상신전자","46995587100","3300","14241087","14244718","3631","2024-09"
"089980","상아프론테크","329739984450","21150","15590543","15989037","398494","2024-09"
"042940","상지건설","23436580940","5890","3979046","3981814","2768","2024-09"
"042600","새로닉스","157787240100","12900","12231569","12423574","192005","2024-09"
"075180","새론오토모티브","74784000000","3895","19200000","19200000","0","2024-09"
"107600","새빗켐","108850817250","22050","4936545","4936545","0","2024-09"
"411080","샌즈랩","105768598260","7270","14548638","15248638","700000","2024-09"
"252990","샘씨엔에스","319847833140","5610","57013874","58388063","1374189","2024-09"
"007540","샘표","89990646200","44650","2015468","2875800","860332","2024-09"
"248170","샘표식품","129691326400","28400","4566596","4568286","1690","2024-09"
"378800","샤페론","136849360740","4540","30143031","30143031","0","2024-09"
"294630","서남","89323484775","3725","23979459","23979459","0","2024-09"
"038070","서린바이오","61811500080","7320","8444194","8900676","456482","2024-09"
"006730","서부T&D","392128092160","6080","64494752","66426923","1932171","2024-09"
"079650","서산","24240000000","1212","20000000","20000000","0","2024-09"
"100660","서암기계공업","47250000000","3750","12600000","12600000","0","2024-09"
"007860","서연","149780273400","6900","21707286","23479844","1772558","2024-09"
"200880","서연이화","371562826250","13750","27022751","27028437","5686","2024-09"
"019770","서연탑메탈","41707000000","3580","11650000","11650000","0","2024-09"
"017390","서울가스","203458300800","52400","3882792","5000000","1117208","2024-09"
"043710","서울리거","32428129578","646","50198343","50198880","537","2024-09"
"092190","서울바이오시스","186791445890","4130","45227953","45868383","640430","2024-09"
"046890","서울반도체","517580701200","9180","56381340","58305400","1924060","2024-09"
"004410","서울식품","59211354622","158","374755409","374755559","150","2024-09"
"063170","서울옥션","114154982040","6780","16837018","17774267","937249","2024-09"
"027040","서울전자통신","18997569864","273","69588168","69588847","679","2024-09"
"018680","서울제약","45646233885","3915","11659319","11659319","0","2024-09"
"021050","서원","61194746510","1289","47474590","47474590","0","2024-09"
"093920","서원인텍","107322000000","5770","18600000","18600000","0","2024-09"
"189860","서전기전","51791485200","5340","9698780","9698780","0","2024-09"
"178320","서진시스템","1462446804000","26000","56247954","56247954","0","2024-09"
"122690","서진오토모티브","50717283440","2335","21720464","21844410","123946","2024-09"
"140070","서플러스글로벌","109898607060","3190","34450974","36988000","2537026","2024-09"
"011370","서한","78457697135","799","98194865","100894865","2700000","2024-09"
"065710","서호전기","106254042100","21550","4930582","5150000","219418","2024-09"
"008490","서흥","184132511280","16560","11119113","11569113","450000","2024-09"
"035890","서희건설","280104045480","1449","193308520","229808457","36499937","2024-09"
"357550","석경에이티","245570850000","45150","5439000","5455000","16000","2024-09"
"003100","선광","97180500000","15450","6290000","6600000","310000","2024-09"
"007610","선도전기","50907057000","3000","16969019","18000000","1030981","2024-09"
"067370","선바이오","85275957690","6930","12305333","12313555","8222","2024-09"
"171090","선익시스템","415006007400","47400","8755401","9494405","739004","2024-09"
"136490","선진","161936406480","6810","23779208","23779604","396","2024-09"
"086710","선진뷰티사이언스","126588140400","10540","12010260","12203280","193020","2024-09"
"014620","성광벤드","356348749790","13310","26773009","28600000","1826991","2024-09"
"037350","성도이엔지","66043950000","4650","14203000","15470000","1267000","2024-09"
"014910","성문전자","24908708400","1200","20757257","22460985","1703728","2024-09"
"003080","성보화학","51320615020","2620","19588021","20020000","431979","2024-09"
"004980","성신양회","193885379880","8040","24115097","24516073","400976","2024-09"
"011300","성안머티리얼스","39633735856","484","81887884","81887884","0","2024-09"
"081580","성우전자","71614132290","4710","15204699","15508143","303444","2024-09"
"045300","성우테크론","26332786600","2690","9789140","10151583","362443","2024-09"
"015750","성우하이텍","494348044740","6180","79991593","80000000","8407","2024-09"
"365340","성일하이텍","634783248100","52300","12137347","12137347","0","2024-09"
"000180","성창기업지주","101558329600","1456","69751600","69751600","0","2024-09"
"080470","성창오토텍","30076000000","4120","7300000","7300000","0","2024-09"
"043260","성호전자","93943371060","1540","61002189","61002189","0","2024-09"
"148150","세경하이테크","236468185720","6680","35399429","35860429","461000","2024-09"
"002420","세기상사","32018964480","5760","5558848","5558848","0","2024-09"
"188260","세니젠","21791784070","3070","7098301","7228470","130169","2024-09"
"053060","세동","18892863740","1070","17656882","17657419","537","2024-09"
"340440","세림B&G","36806731623","1297","28378359","28378364","5","2024-09"
"017510","세명전기","79126740000","5190","15246000","15246000","0","2024-09"
"004360","세방","216682873920","12080","17937324","19308690","1371366","2024-09"
"004490","세방전지","940545177000","71500","13154478","14000000","845522","2024-09"
"011560","세보엠이씨","95010818760","9580","9917622","10530000","612378","2024-09"
"396300","세아메카닉스","76080497500","2905","26189500","26489500","300000","2024-09"
"001430","세아베스틸지주","706125123110","19690","35862119","35862119","0","2024-09"
"306200","세아제강","317531340000","113400","2800100","2836300","36200","2024-09"
"003030","세아제강지주","643645437300","159300","4040461","4141657","101196","2024-09"
"019440","세아특수강","114241256610","13690","8344869","8570000","225131","2024-09"
"058650","세아홀딩스","381769682000","98000","3895609","4000000","104391","2024-09"
"013000","세우글로벌","35735211345","1245","28702981","28705031","2050","2024-09"
"100700","세운메디칼","119699891500","2765","43291100","43800000","508900","2024-09"
"024830","세원물산","52271000000","6260","8350000","8350000","0","2024-09"
"091090","세원이앤씨","54828158060","1270","43171778","43180255","8477","2024-09"
"021820","세원정공","70600000000","7060","10000000","10000000","0","2024-09"
"067830","세이브존I&C","80334553890","2130","37715753","41040895","3325142","2024-09"
"258830","세종메디칼","22974088612","412","55762351","55786351","24000","2024-09"
"036630","세종텔레콤","94972882000","500","189945764","200000000","10054236","2024-09"
"039310","세중","30698103898","1694","18121667","18121667","0","2024-09"
"075580","세진중공업","413864039680","7280","56849456","56849456","0","2024-09"
"067770","세진티에스","20034088935","2415","8295689","8396593","100904","2024-09"
"053450","세코닉스","76798559250","5250","14628297","14792803","164506","2024-09"
"222810","세토피아","81189010800","1080","75175010","75659350","484340","2024-09"
"252500","세화피앤씨","38914233820","938","41486390","41486390","0","2024-09"
"321370","센서뷰","59273426250","2250","26343745","26343745","0","2024-09"
"347000","센코","82366884930","2530","32556081","33004976","448895","2024-09"
"331920","셀레믹스","33717931240","4130","8164148","8164148","0","2024-09"
"049180","셀루메드","159781639110","3130","51048447","51057455","9008","2024-09"
"299660","셀리드","109735480400","5200","21102977","21102977","0","2024-09"
"268600","셀리버리","248384003120","6680","37183234","37183234","0","2024-09"
"108860","셀바스AI","272641615880","10130","26914276","26914790","514","2024-09"
"208370","셀바스헬스케어","110842765490","4310","25717579","25740564","22985","2024-09"
"318160","셀바이오휴먼텍","29751707850","3390","8776315","9260901","484586","2024-09"
"308430","셀비온","246245043970","19330","12739009","12739009","0","2024-09"
"068270","셀트리온","38642794312500","187500","206094903","217021190","10926287","2024-09"
"068760","셀트리온제약","2611748185100","63100","41390621","41600387","209766","2024-09"
"068940","셀피글로벌","29334496224","778","37705008","38260597","555589","2024-09"
"060230","소니드","40684823634","889","45764706","46066730","302024","2024-09"
"290690","소룩스","433271872080","9510","45559608","45564340","4732","2024-09"
"032680","소프트센","43484513136","417","104279408","105590764","1311356","2024-09"
"258790","소프트캠프","20981320500","875","23978652","24991284","1012632","2024-09"
"066910","손오공","56522186602","1678","33684259","33784259","100000","2024-09"
"336370","솔루스첨단소재","842547576000","12000","70212298","70217344","5046","2024-09"
"248070","솔루엠","992888726400","20400","48671016","50005551","1334535","2024-09"
"035610","솔본","102026106375","3975","25666945","27345997","1679052","2024-09"
"357780","솔브레인","1522301717200","196600","7743142","7778566","35424","2024-09"
"036830","솔브레인홀딩스","1004153419800","48600","20661593","20964056","302463","2024-09"
"304100","솔트룩스","237273910080","19560","12130568","12130568","0","2024-09"
"328380","솔트웨어","39773757429","1161","34258189","34262778","4589","2024-09"
"004430","송원산업","296640000000","12360","24000000","24000000","0","2024-09"
"086980","쇼박스","260366460000","4170","62438000","62638000","200000","2024-09"
"050960","수산아이앤티","67307470000","9970","6751000","6751000","0","2024-09"
"126720","수산인더스트리","311039267500","22100","14074175","14286000","211825","2024-09"
"017550","수산중공업","105766525350","1695","62399130","62399130","0","2024-09"
"084180","수성웹툰","74241338936","632","117470473","117470473","0","2024-09"
"253840","수젠텍","87915591000","5750","15289668","16743200","1453532","2024-09"
"298830","슈어소프트테크","251050234760","4810","52193396","52619061","425665","2024-09"
"236200","슈프리마","178695651400","25900","6899446","7193273","293827","2024-09"
"094840","슈프리마에이치큐","53365592940","5830","9153618","10471840","1318222","2024-09"
"192440","슈피겐코리아","131148846000","21750","6029832","6216363","186531","2024-09"
"424960","스마트레이더시스템","176163595200","11280","15617340","15617340","0","2024-09"
"099440","스맥","123042123600","3300","37285492","40243394","2957902","2024-09"
"053210","스카이라이프","237414534640","5020","47293732","47522955","229223","2024-09"
"276040","스코넥","38856097030","3095","12554474","12554474","0","2024-09"
"159910","스킨앤스킨","27096954990","749","36177510","36410098","232588","2024-09"
"060240","스타코링크","18383657050","605","30386210","31136323","750113","2024-09"
"115570","스타플렉스","23512253640","2980","7890018","7984508","94490","2024-09"
"330730","스톤브릿지벤처스","66689242200","3825","17435096","18150830","715734","2024-09"
"352090","스톰테크","90293273280","3360","26872998","26872998","0","2024-09"
"253450","스튜디오드래곤","1125690750100","37450","30058498","30058498","0","2024-09"
"408900","스튜디오미르","152246667405","4655","32706051","32706134","83","2024-09"
"204630","스튜디오산타클로스","23613109200","4650","5078088","5089941","11853","2024-09"
"415380","스튜디오삼익","33896706800","8360","4054630","4225498","170868","2024-09"
"026890","스틱인베스트먼트","298967466200","8180","36548590","41678175","5129585","2024-09"
"013810","스페코","77673991000","5300","14655470","14655470","0","2024-09"
"203690","스피어파워","68353550790","5190","13170241","13337850","167609","2024-09"
"049830","승일","41352682000","7000","5907526","6132112","224586","2024-09"
"020710","시공테크","66775958100","3540","18863265","20047970","1184705","2024-09"
"033170","시그네틱스","81356174731","949","85728319","85728319","0","2024-09"
"048870","시너지이노베이션","238200030720","2880","82708344","82708344","0","2024-09"
"025320","시노펙스","545911209480","6540","83472662","83817936","345274","2024-09"
"134790","시디즈","49949000500","29750","1678958","2000000","321042","2024-09"
"269620","시스웍","131663951937","889","148103433","148582691","479258","2024-09"
"429270","시지트로닉스","31408562500","6970","4506250","4506250","0","2024-09"
"418250","시큐레터","52279100100","6550","7981542","7981542","0","2024-09"
"131090","시큐브","34327903480","884","38832470","44000000","5167530","2024-09"
"232830","시큐센","24234467040","2070","11707472","11707472","0","2024-09"
"462870","시프트업","3511750144000","60200","58334720","58334720","0","2024-09"
"016590","신대양제지","175445172760","5720","30672233","40297820","9625587","2024-09"
"290520","신도기연","33911433420","2155","15736164","15929362","193198","2024-09"
"029530","신도리코","350515966350","40650","8622779","10080029","1457250","2024-09"
"004970","신라교역","148694700000","9420","15785000","16000000","215000","2024-09"
"001000","신라섬유","26462518600","1090","24277540","24277540","0","2024-09"
"025870","신라에스지","24400000000","6100","4000000","4000000","0","2024-09"
"215600","신라젠","330874021250","2410","137292125","137367125","75000","2024-09"
"065350","신성델타테크","1258616792400","46300","27183948","27483948","300000","2024-09"
"416180","신성에스티","229195212800","25600","8952938","9039778","86840","2024-09"
"011930","신성이엔지","303516904509","1491","203565999","205848151","2282152","2024-09"
"005390","신성통상","321906793600","2240","143708390","143708390","0","2024-09"
"004170","신세계","1353512733300","146700","9226399","9845181","618782","2024-09"
"035510","신세계 I&C","131458100000","10000","13145810","17200000","4054190","2024-09"
"034300","신세계건설","138046129180","18190","7589122","7760554","171432","2024-09"
"031430","신세계인터내셔날","444290070000","12830","34629000","35700000","1071000","2024-09"
"031440","신세계푸드","136691872300","35300","3872291","3872480","189","2024-09"
"006880","신송홀딩스","69593571450","6450","10789701","11828858","1039157","2024-09"
"162300","신스틸","107061030720","2610","41019552","41471382","451830","2024-09"
"290560","신시웨이","24647760240","6360","3875434","3877972","2538","2024-09"
"002800","신신제약","89809360000","5920","15170500","15170500","0","2024-09"
"472220","신영스팩10호","10083500000","2150","4690000","4690000","0","2024-09"
"430220","신영스팩8호","14669200000","2170","6760000","6760000","0","2024-09"
"445970","신영스팩9호","11658000000","2175","5360000","5360000","0","2024-09"
"005800","신영와코루","82170000000","9130","9000000","9000000","0","2024-09"
"001720","신영증권","630856699200","81900","7702768","16440000","8737232","2024-09"
"009270","신원","93139973796","1241","75052356","102586356","27534000","2024-09"
"017000","신원종합개발","35209891530","3145","11195514","11668027","472513","2024-09"
"002700","신일전자","103328987160","1470","70291828","71047521","755693","2024-09"
"012790","신일제약","85193964570","7370","11559561","11986415","426854","2024-09"
"138070","신진에스엠","39460093540","2345","16827332","17503204","675872","2024-09"
"226330","신테카바이오","86057799000","5640","15258475","15258475","0","2024-09"
"002870","신풍","26431886520","954","27706380","34958700","7252320","2024-09"
"019170","신풍제약","568094964370","11530","49271029","52984990","3713961","2024-09"
"418210","신한제10호스팩","7978800000","2180","3660000","3660000","0","2024-09"
"452980","신한제11호스팩","36997085000","1957","18905000","18905000","0","2024-09"
"474660","신한제12호스팩","11757600000","2130","5520000","5520000","0","2024-09"
"474930","신한제13호스팩","7819200000","2160","3620000","3620000","0","2024-09"
"055550","신한지주","28192938144000","56000","503445324","509393214","5947890","2024-09"
"056700","신화인터텍","49899076520","1720","29011091","29135091","124000","2024-09"
"187270","신화콘텍","30539328760","3320","9198593","10143845","945252","2024-09"
"004080","신흥","135034971500","14300","9443005","9500000","56995","2024-09"
"243840","신흥에스이씨","292411651300","7580","38576735","38919035","342300","2024-09"
"257720","실리콘투","2374056126000","39000","60873234","60873234","0","2024-09"
"222800","심텍","522272382800","16400","31845877","31854143","8266","2024-09"
"036710","심텍홀딩스","74787417660","1614","46336690","48350145","2013455","2024-09"
"160980","싸이맥스","115695244960","11320","10220428","10924243","703815","2024-09"
"356890","싸이버원","35625610800","2990","11914920","11916325","1405","2024-09"
"217330","싸이토젠","171637429680","7440","23069547","23129547","60000","2024-09"
"102280","쌍방울","70634046631","269","262580099","262592129","12030","2024-09"
"010280","쌍용정보통신","39074264400","600","65123774","65123786","12","2024-09"
"004770","써니전자","57375426661","1579","36336559","36702884","366325","2024-09"
"208640","썸에이지","35088544008","252","139240254","139240254","0","2024-09"
"222420","쎄노텍","36686403996","807","45460228","45460231","3","2024-09"
"037760","쎄니트","47550168444","1564","30402921","33832921","3430000","2024-09"
"099320","쎄트렉아이","406292413800","37100","10951278","10951278","0","2024-09"
"049960","쎌바이오텍","93077040000","13600","6843900","9400000","2556100","2024-09"
"088280","쏘닉스","40670251500","2350","17306490","17306490","0","2024-09"
"403550","쏘카","570236096760","17380","32809902","32809902","0","2024-09"
"050890","쏠리드","261491321470","4315","60600538","61095231","494693","2024-09"
"109670","씨싸이트","55668752460","9540","5835299","5836602","1303","2024-09"
"066790","씨씨에스","98106931142","1622","60485161","65152039","4666878","2024-09"
"222080","씨아이에스","578138375620","8060","71729327","71729327","0","2024-09"
"004920","씨아이테크","62582241250","1250","50065793","50065793","0","2024-09"
"352480","씨앤씨인터내셔널","723790329600","72400","9997104","10013941","16837","2024-09"
"264660","씨앤지하이테크","121725414900","13050","9327618","9627896","300278","2024-09"
"352700","씨앤투스","77019597060","3010","25587906","27276899","1688993","2024-09"
"458870","씨어스테크놀로지","162920806400","12980","12551680","12551680","0","2024-09"
"297090","씨에스베어링","145621800000","5340","27270000","27270000","0","2024-09"
"112610","씨에스윈드","2336622728400","56400","41429481","42171403","741922","2024-09"
"359090","씨엔알리서치","69998520800","1240","56450420","56450891","471","2024-09"
"115530","씨엔플러스","30107609000","443","67963000","67963000","0","2024-09"
"115480","씨유메디칼","36478414964","758","48124558","48224558","100000","2024-09"
"340810","씨유박스","37516435020","3540","10597863","10597863","0","2024-09"
"376290","씨유테크","55091400000","3120","17657500","17657500","0","2024-09"
"189330","씨이랩","40757379960","6690","6092284","6092284","0","2024-09"
"096530","씨젠","1078468971800","23350","46187108","52225994","6038886","2024-09"
"101240","씨큐브","50141511600","4850","10338456","10340947","2491","2024-09"
"060590","씨티씨바이오","184575743000","7720","23908775","24181020","272245","2024-09"
"308170","씨티알모빌리티","46235700000","5370","8610000","8610000","0","2024-09"
"260930","씨티케이","105902094180","5620","18843789","19341591","497802","2024-09"
"052300","씨티프라퍼티","62565217029","371","168639399","168651433","12034","2024-09"
"413630","씨피시스템","96615228690","2610","37017329","38703425","1686096","2024-09"
"013990","아가방컴퍼니","131342259690","4370","30055437","32887536","2832099","2024-09"
"123860","아나패스","222343431100","18340","12123415","12123415","0","2024-09"
"025980","아난티","416115399210","4695","88629478","88629478","0","2024-09"
"008700","아남전자","97789846440","1268","77121330","77124820","3490","2024-09"
"125210","아모그린텍","102610033800","6220","16496790","16496790","0","2024-09"
"002790","아모레G","1761884932500","23100","76272075","82458180","6186105","2024-09"
"090430","아모레퍼시픽","7261853357000","124300","58421990","58492759","70769","2024-09"
"357580","아모센스","77195416320","6880","11220264","11220264","0","2024-09"
"052710","아모텍","54504796580","3730","14612546","14615109","2563","2024-09"
"074430","아미노로직스","105304385956","1199","87826844","87826844","0","2024-09"
"092040","아미코젠","246947062090","4505","54816218","55018347","202129","2024-09"
"083930","아바코","204689573100","14100","14516991","14912798","395807","2024-09"
"149950","아바텍","150514083200","10880","13834015","15607500","1773485","2024-09"
"036010","아비코전자","69123256800","5200","13292934","13292934","0","2024-09"
"002030","아세아","430222848000","256000","1680558","2115648","435090","2024-09"
"183190","아세아시멘트","410893654900","10940","37558835","38501886","943051","2024-09"
"002310","아세아제지","332846391500","8330","39957550","42782510","2824960","2024-09"
"050860","아세아텍","43554557200","2200","19797526","22500000","2702474","2024-09"
"012170","아센디오","48263333876","466","103569386","103569488","102","2024-09"
"136410","아셈스","88644033540","8340","10628781","11019106","390325","2024-09"
"246720","아스타","64173329000","4730","13567300","13567300","0","2024-09"
"067390","아스트","190615109630","554","344070595","344203992","133397","2024-09"
"159010","아스플로","83235647600","6440","12924790","13334739","409949","2024-09"
"127710","아시아경제","46980894372","1346","34904082","34904082","0","2024-09"
"267850","아시아나IDT","194583000000","17530","11100000","11100000","0","2024-09"
"020560","아시아나항공","731467640120","9830","74411764","74411764","0","2024-09"
"154030","아시아종묘","27297633960","2355","11591352","11591352","0","2024-09"
"227610","아우딘퓨쳐스","47855322450","1350","35448387","35583547","135160","2024-09"
"143160","아이디스","150603491700","14940","10080555","10716390","635835","2024-09"
"054800","아이디스홀딩스","80191009720","9080","8831609","10347756","1516147","2024-09"
"332370","아이디피","47678856120","3780","12613454","13273726","660272","2024-09"
"122900","아이마켓코리아","262727239000","8350","31464340","33428840","1964500","2024-09"
"339950","아이비김영","76753872900","1770","43363770","44946655","1582885","2024-09"
"469750","아이비젼웍스","52940713734","1563","33871218","33936481","65263","2024-09"
"460470","아이빔테크놀로지","75874381100","5030","15084370","15084370","0","2024-09"
"099190","아이센스","524493054280","18980","27633986","27637273","3287","2024-09"
"461300","아이스크림미디어","169795130510","13270","12795413","13063433","268020","2024-09"
"289010","아이스크림에듀","30759173725","2455","12529195","12864037","334842","2024-09"
"214430","아이쓰리시스템","230463842400","33200","6941682","7106760","165078","2024-09"
"040910","아이씨디","87102614340","5340","16311351","18574275","2262924","2024-09"
"368600","아이씨에이치","63935874360","3720","17187063","17538346","351283","2024-09"
"456010","아이씨티케이","93743242640","7090","13221896","13221896","0","2024-09"
"052860","아이앤씨","26632131969","1641","16229209","17862854","1633645","2024-09"
"464500","아이언디바이스","76185207540","5580","13653263","13653263","0","2024-09"
"010780","아이에스동서","636945193600","21100","30186976","30186976","0","2024-09"
"038880","아이에이","62457475255","205","304670611","315334702","10664091","2024-09"
"307180","아이엘사이언스","85183846650","3150","27042491","27042828","337","2024-09"
"101390","아이엠","31751159580","3020","10513629","10548085","34456","2024-09"
"461030","아이엠비디엑스","225545597500","16090","14017750","14017750","0","2024-09"
"451220","아이엠티","71028991220","9020","7874611","7874611","0","2024-09"
"090150","아이윈","35386809876","891","39715836","41875293","2159457","2024-09"
"123010","아이윈플러스","23668065110","730","32422007","32658542","236535","2024-09"
"031310","아이즈비전","43973958600","1800","24429977","25334636","904659","2024-09"
"185490","아이진","78521522520","2905","27029784","27029784","0","2024-09"
"059100","아이컴포넌트","30354965170","4595","6606086","7070860","464774","2024-09"
"262840","아이퀘스트","41590317080","2210","18819148","19290000","470852","2024-09"
"175250","아이큐어","73431431025","1965","37369685","37558368","188683","2024-09"
"052460","아이크래프트","28160939280","2355","11957936","14607936","2650000","2024-09"
"119830","아이텍","116676334960","5480","21291302","21434297","142995","2024-09"
"052770","아이톡시","65878027370","1345","48979946","48979946","0","2024-09"
"124500","아이티센","150597380230","6490","23204527","23204527","0","2024-09"
"372800","아이티아이즈","32790534300","5570","5886990","6026990","140000","2024-09"
"084850","아이티엠반도체","374879624520","18120","20688721","22682934","1994213","2024-09"
"114840","아이패밀리에스씨","352188754800","20450","17221944","17221944","0","2024-09"
"027360","아주IB투자","236228564460","1995","118410308","120945406","2535098","2024-09"
"139990","아주스틸","134444201580","5070","26517594","26517744","150","2024-09"
"032080","아즈텍WB","23886653002","1138","20990029","21491029","501000","2024-09"
"013310","아진산업","107680939050","2775","38803942","38806582","2640","2024-09"
"059120","아진엑스텍","71409257400","7800","9155033","9748596","593563","2024-09"
"009320","아진전자부품","53687449530","1089","49299770","49299770","0","2024-09"
"158430","아톤","88479765360","4140","21371924","22602474","1230550","2024-09"
"321820","아티스트유나이티드","216542322000","16200","13366810","13366810","0","2024-09"
"001540","안국약품","80921398800","7120","11365365","13042420","1677055","2024-09"
"053800","안랩","545772773800","55700","9798434","11126506","1328072","2024-09"
"065660","안트로젠","152490614910","15670","9731373","9731373","0","2024-09"
"297570","알로이스","37702506402","1089","34621218","34621218","0","2024-09"
"001780","알루코","225130056900","2325","96830132","96830132","0","2024-09"
"260660","알리코제약","57276086665","3815","15013391","15327021","313630","2024-09"
"354320","알멕","192380568100","30100","6391381","6391381","0","2024-09"
"361570","알비더블유","65002110570","2270","28635291","28635291","0","2024-09"
"131370","알서포트","149491922860","2870","52087778","53267083","1179305","2024-09"
"140670","알에스오토메이션","98482239440","10660","9238484","9303140","64656","2024-09"
"096610","알에프세미","51550708615","2965","17386411","17386411","0","2024-09"
"061040","알에프텍","93820150740","3005","31221348","32089259","867911","2024-09"
"148250","알엔투테크놀로지","28697300000","4000","7174325","7391186","216861","2024-09"
"347860","알체라","50204843040","2280","22019668","22019668","0","2024-09"
"196170","알테오젠","20373368470000","383500","53124820","53148528","23708","2024-09"
"123750","알톤","20382806497","1601","12731297","12746297","15000","2024-09"
"085810","알티캐스트","42098300277","1419","29667583","30447327","779744","2024-09"
"043100","알파녹스","21593540160","2710","7968096","7975920","7824","2024-09"
"117670","알파홀딩스","37743429465","945","39940137","39940137","0","2024-09"
"314140","알피바이오","55445487220","6410","8649842","8666361","16519","2024-09"
"291650","압타머사이언스","44318457720","2610","16980252","16980252","0","2024-09"
"293780","압타바이오","216389250000","8750","24730200","24730200","0","2024-09"
"018250","애경산업","429728544960","16720","25701468","26409935","708467","2024-09"
"161000","애경케미칼","501598300140","10390","48277026","48648709","371683","2024-09"
"196300","애니젠","80685521280","13440","6003387","6003387","0","2024-09"
"310200","애니플러스","123445336650","2775","44484806","45520979","1036173","2024-09"
"299910","애닉","32483121920","6880","4721384","4721384","0","2024-09"
"179530","애드바이오텍","29980656320","3280","9140444","9140444","0","2024-09"
"205500","액션스퀘어","56288526540","1084","51926685","51928120","1435","2024-09"
"052790","액토즈소프트","67950682340","6220","10924547","11330638","406091","2024-09"
"290740","액트로","52167707930","5590","9332327","10065011","732684","2024-09"
"238090","앤디포스","92863027680","4080","22760546","23541303","780757","2024-09"
"092600","앤씨앤","28456685124","1162","24489402","25083517","594115","2024-09"
"129890","앱코","55654603536","1162","47895528","50643410","2747882","2024-09"
"174900","앱클론","285771820400","16400","17425111","17425111","0","2024-09"
"255440","야스","109823067900","9100","12068469","13058000","989531","2024-09"
"030960","양지사","131866272000","9600","13736070","15980000","2243930","2024-09"
"102120","어보브반도체","162512726900","9850","16498754","17780753","1281999","2024-09"
"263540","어스앤에어로스페이스","85022108500","5950","14289430","14294091","4661","2023-12"
"238120","얼라인드","42561532160","2960","14378896","14378896","0","2024-09"
"019990","에너토크","62488293010","6530","9569417","9756088","186671","2024-09"
"011090","에넥스","32853618794","554","59302561","59991641","689080","2024-09"
"270660","에브리봇","190564308360","15580","12231342","12231342","0","2024-09"
"038680","에스넷","66805109175","3675","18178261","19549677","1371416","2024-09"
"137310","에스디바이오센서","1097456770020","8970","122347466","124477353","2129887","2024-09"
"217480","에스디생명공학","54756837359","499","109733141","109733141","0","2024-09"
"121890","에스디시스템","18674481630","1405","13291446","13291446","0","2024-09"
"304360","에스바이오메딕스","375865472000","32000","11745796","11745796","0","2024-09"
"389500","에스비비테크","90503372520","15180","5962014","6174904","212890","2024-09"
"042110","에스씨디","72156039052","1493","48329564","48329564","0","2024-09"
"298060","에스씨엠생명과학","40921220000","2000","20460610","20467248","6638","2024-09"
"065420","에스아이리소스","18681005574","261","71574734","71577299","2565","2024-09"
"103230","에스앤더블류","25452000000","3535","7200000","7200000","0","2024-09"
"260970","에스앤디","106887260300","36950","2892754","2892754","0","2024-09"
"101490","에스앤에스텍","480807090000","22950","20950200","21451447","501247","2024-09"
"095910","에스에너지","27891765088","1496","18644228","19504503","860275","2024-09"
"275630","에스에스알","17503963880","3235","5410808","6017989","607181","2024-09"
"031330","에스에이엠티","308730137055","3165","97545067","99995067","2450000","2024-09"
"060540","에스에이티","38676742320","1480","26132934","26133306","372","2024-09"
"351320","에스에이티이엔지","34894846460","1585","22015676","22015886","210","2024-09"
"056190","에스에프에이","634579242800","20200","31414814","35908760","4493946","2024-09"
"080000","에스엔유","58338324330","1705","34216026","34322870","106844","2024-09"
"005850","에스엘","1524435792200","33100","46055462","46448520","393058","2024-09"
"214310","에스엘에너지","22487615640","6120","3674447","3679130","4683","2024-09"
"246250","에스엘에스바이오","43742387100","2850","15348206","15348206","0","2024-09"
"041510","에스엠","1598049362000","69800","22894690","23353627","458937","2024-09"
"010580","에스엠벡셀","138216197392","1244","111106268","111251760","145492","2024-09"
"007820","에스엠코어","95910221610","4905","19553562","20033946","480384","2024-09"
"464080","에스오에스랩","98513766800","5620","17529140","17529140","0","2024-09"
"109610","에스와이","187688979300","3930","47758010","48907400","1149390","2024-09"
"365330","에스와이스틸텍","175089200000","5720","30610000","30610000","0","2024-09"
"012750","에스원","2072567650700","61300","33810239","37999178","4188939","2024-09"
"031860","에스유홀딩스","18070939086","1203","15021562","15026356","4794","2024-09"
"306040","에스제이그룹","56867179840","6040","9415096","9865828","450732","2024-09"
"457940","에스케이증권제10호스팩","7083400000","2140","3310000","3310000","0","2024-09"
"472230","에스케이증권제11호스팩","8642400000","2080","4155000","4155000","0","2024-09"
"473000","에스케이증권제12호스팩","6967550000","2105","3310000","3310000","0","2024-09"
"473950","에스케이증권제13호스팩","9149400000","2070","4420000","4420000","0","2024-09"
"435870","에스케이증권제8호스팩","7830600000","2105","3720000","3720000","0","2024-09"
"455910","에스케이증권제9호스팩","10742800000","2140","5020000","5020000","0","2024-09"
"096630","에스코넥","57331620675","735","78002205","79052205","1050000","2024-09"
"069510","에스텍","90323400000","10740","8410000","10910000","2500000","2024-09"
"234300","에스트래픽","120951344925","4395","27520215","27809848","289633","2024-09"
"039440","에스티아이","290172455430","19690","14737047","15830000","1092953","2024-09"
"098660","에스티오","37200665120","3065","12137248","12500976","363728","2024-09"
"052020","에스티큐브","305519830950","6550","46644249","46694249","50000","2024-09"
"237690","에스티팜","2063048994000","102600","20107690","20107690","0","2024-09"
"050760","에스폴리텍","24584888248","1592","15442769","16334678","891909","2024-09"
"288620","에스퓨얼셀","75237026480","10780","6979316","6979316","0","2024-09"
"443670","에스피소프트","155845411120","6440","24199598","24201392","1794","2024-09"
"317830","에스피시스템스","53294562320","5240","10170718","10773818","603100","2024-09"
"058610","에스피지","471268900000","21250","22177360","22177360","0","2024-09"
"043340","에쎈테크","45980000000","484","95000000","95000000","0","2024-09"
"023960","에쓰씨엔지니어링","61330842330","1805","33978306","33978308","2","2024-09"
"298690","에어부산","276882212000","2375","116581984","116640000","58016","2024-09"
"054630","에이디칩스","12594094838","158","79709461","79709461","0","2024-09"
"200710","에이디테크놀로지","195615079100","15100","12954641","13440822","486181","2024-09"
"096690","에이루트","43446749456","1298","33472072","33477189","5117","2024-09"
"078520","에이블씨엔씨","183920097060","7070","26014158","26014161","3","2024-09"
"298380","에이비엘바이오","1936325896700","40300","48047789","48047789","0","2024-09"
"203400","에이비온","218446525520","8660","25224772","25224772","0","2024-09"
"195990","에이비프로바이오","151453965992","532","284687906","284689721","1815","2024-09"
"003800","에이스침대","286093209500","27100","10556945","11090000","533055","2024-09"
"088800","에이스테크","144361061771","1139","126743689","127068928","325239","2024-09"
"241840","에이스토리","63844232800","6880","9279685","9539994","260309","2024-09"
"453860","에이에스텍","131864031000","23400","5635215","5657215","22000","2024-09"
"312610","에이에프더블류","33363094536","1647","20256888","20256888","0","2024-09"
"015260","에이엔피","33158156430","735","45113138","45116894","3756","2024-09"
"172670","에이엘티","80261860500","9060","8858925","8960259","101334","2024-09"
"445090","에이직랜드","327459254400","30400","10771686","10771686","0","2024-09"
"295310","에이치브이엠","179005042240","15040","11901931","11901931","0","2024-09"
"072990","에이치시티","73202629720","10340","7079558","7287341","207783","2024-09"
"239610","에이치엘사이언스","82302088160","16160","5092951","5392115","299164","2024-09"
"462020","에이치엠씨제6호스팩","8820350000","2030","4345000","4345000","0","2024-09"
"477340","에이치엠씨제7호스팩","14959920000","1992","7510000","7510000","0","2024-09"
"148930","에이치와이티씨","43895100900","4515","9722060","10175213","453153","2024-09"
"044780","에이치케이","23939331432","1304","18358383","18505787","147404","2024-09"
"357230","에이치피오","122156864560","2960","41269211","42089487","820276","2024-09"
"355690","에이텀","35024270400","6480","5404980","5404980","0","2024-09"
"071670","에이테크솔루션","62100000000","6210","10000000","10000000","0","2024-09"
"045660","에이텍","112398954600","14900","7543554","8260000","716446","2024-09"
"224110","에이텍모빌리티","64712632910","13190","4906189","5340000","433811","2024-09"
"021080","에이티넘인베스트","116136301875","2525","45994575","48000000","2005425","2024-09"
"200470","에이팩트","117975465765","2785","42361029","42362093","1064","2024-09"
"262260","에이프로","102278702100","7100","14405451","14468152","62701","2024-09"
"007460","에이프로젠","294032864450","1105","266093090","286851768","20758678","2024-09"
"003060","에이프로젠바이오로직스","169122321936","856","197572806","198407845","835039","2024-09"
"397030","에이프릴바이오","524912533200","23950","21917016","21917016","0","2024-09"
"244920","에이플러스에셋","93708887485","4145","22607693","22607693","0","2024-09"
"278470","에이피알","1984308631500","266500","7445811","7622678","176867","2024-09"
"230240","에치에프알","122707286900","9350","13123774","13309000","185226","2024-09"
"230360","에코마케팅","325064739570","10330","31468029","31468029","0","2024-09"
"038870","에코바이오","55210286220","3940","14012763","14014949","2186","2024-09"
"097780","에코볼트","59399506426","877","67730338","67730338","0","2024-09"
"448280","에코아이","190725700330","19310","9877043","9877043","0","2024-09"
"101360","에코앤드림","644875990500","36750","17547646","17786114","238468","2024-09"
"128540","에코캡","33476941232","1288","25991414","26690460","699046","2024-09"
"086520","에코프로","10065248858000","76400","131744095","133138340","1394245","2024-09"
"450080","에코프로머티","7362925746800","106600","69070598","69070598","0","2024-09"
"247540","에코프로비엠","15303334692700","156700","97660081","97801344","141263","2024-09"
"383310","에코프로에이치엔","652532052800","42800","15246076","15304932","58856","2024-09"
"038110","에코플라스틱","113304041160","2820","40178738","41169370","990632","2024-09"
"073540","에프알텍","14592000000","1280","11400000","11400000","0","2024-09"
"064850","에프앤가이드","130420094760","11430","11410332","11410332","0","2024-09"
"036810","에프에스티","350626779440","17570","19955992","21756789","1800797","2024-09"
"173940","에프엔씨엔터","54486802150","3650","14927891","15392808","464917","2024-09"
"083500","에프엔에스테크","77535980000","9700","7993400","8575722","582322","2024-09"
"054940","엑사이엔씨","23685913272","714","33173548","33173548","0","2024-09"
"373110","엑셀세라퓨틱스","68567941360","6280","10918462","10918462","0","2024-09"
"205100","엑셈","125205903840","1740","71957416","71963431","6015","2024-09"
"356680","엑스게이트","136389565960","4780","28533382","28543492","10110","2024-09"
"070300","엑스큐어","40881170110","4895","8351618","8351618","0","2024-09"
"317770","엑스페릭스","75698389800","3300","22938906","22938906","0","2024-09"
"373200","엑스플러스","50495152292","667","75704876","75705657","781","2024-09"
"069920","엑시온그룹","49181766480","1405","35004816","35194116","189300","2024-09"
"092870","엑시콘","138776739900","11100","12502409","13050797","548388","2024-09"
"317870","엔바이오니아","158906090000","18680","8506750","8506750","0","2024-09"
"067570","엔브이에이치코리아","102814570860","2460","41794541","42170000","375459","2024-09"
"236810","엔비티","59269481250","3675","16127750","16975426","847676","2024-09"
"333620","엔시스","103012123730","9970","10332209","10556344","224135","2024-09"
"101400","엔시트론","26418529550","425","62161246","62162413","1167","2024-09"
"036570","엔씨소프트","3922217299000","196300","19980730","21954022","1973292","2024-09"
"078860","엔에스이엔엠","91651062100","8710","10522510","10531054","8544","2024-09"
"422040","엔에이치스팩23호","15107600000","2110","7160000","7160000","0","2024-09"
"437780","엔에이치스팩24호","10688750000","2125","5030000","5030000","0","2024-09"
"438580","엔에이치스팩25호","6644000000","2200","3020000","3020000","0","2024-09"
"439410","엔에이치스팩26호","18392000000","2090","8800000","8800000","0","2024-09"
"440820","엔에이치스팩27호","16224000000","2080","7800000","7800000","0","2024-09"
"451700","엔에이치스팩29호","28700000000","2000","14350000","14350000","0","2024-09"
"466910","엔에이치스팩30호","18200000000","2000","9100000","9100000","0","2024-09"
"481890","엔에이치스팩31호","12785175000","2015","6345000","6345000","0","2024-09"
"265740","엔에프씨","53858754000","6030","8931800","8931800","0","2024-09"
"354200","엔젠바이오","38605140040","2810","13738484","13738484","0","2024-09"
"455900","엔젤로보틱스","349721915400","23400","14945381","14945381","0","2024-09"
"419080","엔젯","90880353000","9000","10097817","10517817","420000","2024-09"
"208860","엔지스테크널러지","41831348265","2205","18971133","18971133","0","2024-09"
"183490","엔지켐생명과학","117041398238","1466","79837243","85065562","5228319","2024-09"
"085310","엔케이","61290010194","777","78880322","79983352","1103030","2024-09"
"182400","엔케이맥스","172744574320","2020","85517116","85518831","1715","2024-09"
"348370","엔켐","3660577140300","176100","20786923","20786923","0","2024-09"
"069410","엔텔스","35052755990","3535","9915914","10244824","328910","2024-09"
"227950","엔투텍","43916024720","424","103575530","103575530","0","2024-09"
"291230","엔피","92380623485","2095","44095763","44095775","12","2024-09"
"198080","엔피디","53945638425","2505","21535185","21535185","0","2024-09"
"048830","엔피케이","21798832902","1166","18695397","18723923","28526","2024-09"
"096870","엘디티","15159968000","2270","6678400","6678400","0","2024-09"
"290650","엘앤씨바이오","428517590990","18890","22684891","22684891","0","2024-09"
"066970","엘앤에프","3141003247200","93600","33557727","36296338","2738611","2024-09"
"156100","엘앤케이바이오","129389397170","6490","19936733","19936743","10","2024-09"
"073110","엘엠에스","38062852240","6580","5784628","8895755","3111127","2024-09"
"083310","엘오티베큠","156784384110","9690","16180019","17810033","1630014","2024-09"
"037950","엘컴텍","106942917669","1267","84406407","84447519","41112","2024-09"
"170920","엘티씨","88875250280","9580","9277166","9805620","528454","2024-09"
"058630","엠게임","125381348760","6740","18602574","19543877","941303","2024-09"
"058970","엠로","543492970300","45850","11853718","11853718","0","2024-09"
"019590","엠벤처투자","104963185182","921","113966542","113966542","0","2024-09"
"169330","엠브레인","38532512060","2170","17756918","18256918","500000","2024-09"
"097520","엠씨넥스","298386408960","17280","17267732","17977732","710000","2024-09"
"373170","엠아이큐브솔루션","39245474700","7790","5037930","5037930","0","2024-09"
"179290","엠아이텍","270253411300","8350","32365678","32365678","0","2024-09"
"009780","엠에스씨","90640000000","5150","17600000","17600000","0","2024-09"
"123040","엠에스오토텍","168319697220","3060","55006437","69172213","14165776","2024-09"
"323230","엠에프엠코리아","6967193212","161","43274492","43274492","0","2024-06"
"032790","엠젠솔루션","60859939104","1422","42798832","42798832","0","2024-09"
"033160","엠케이전자","170153106200","8140","20903330","22066331","1163001","2024-09"
"347890","엠투아이","92099131940","5630","16358638","16913204","554566","2024-09"
"033310","엠투엔","80550297960","2035","39582456","40342231","759775","2024-09"
"259630","엠플러스","115771448590","9590","12072101","12282402","210301","2024-09"
"105550","엣지파운드리","129193476300","2260","57165255","57165255","0","2024-09"
"060850","영림원소프트랩","56103900000","6900","8131000","8131000","0","2024-09"
"014440","영보화학","65325000000","3350","19500000","20000000","500000","2024-09"
"143540","영우디에스피","33114594400","758","43686800","44599895","913095","2024-09"
"111770","영원무역","1764179876250","41250","42767997","44311468","1543471","2024-09"
"009970","영원무역홀딩스","1061848167000","91500","11604898","13635592","2030694","2024-09"
"003520","영진약품","457231135000","2500","182892454","182892731","277","2024-09"
"000670","영풍","614087838000","357000","1720134","1842040","121906","2024-09"
"036560","영풍정밀","322875000000","20500","15750000","15750000","0","2024-09"
"006740","영풍제지","55165263705","1249","44167545","46482148","2314603","2024-09"
"012280","영화금속","38680941820","764","50629505","51664505","1035000","2024-09"
"265560","영화테크","92618141400","8730","10609180","10690180","81000","2024-09"
"012160","영흥","32653575137","479","68170303","101310372","33140069","2024-09"
"036000","예림당","47105096465","2045","23034277","23034277","0","2024-09"
"250930","예선테크","18431726988","564","32680367","33000440","320073","2024-09"
"053280","예스24","158409033680","6340","24985652","25000000","14348","2024-09"
"015360","예스코홀딩스","213835950000","49950","4281000","6000000","1719000","2024-09"
"122640","예스티","385389890000","19120","20156375","20930108","773733","2024-09"
"045060","오공","45658619930","2695","16941974","16941974","0","2024-09"
"080520","오디텍","35705733600","3450","10349488","11746609","1397121","2024-09"
"007310","오뚜기","1418722387500","412500","3439327","4007830","568503","2024-09"
"039830","오로라","56731232600","5740","9883490","10762890","879400","2024-09"
"322310","오로스테크놀로지","149954135760","16280","9210942","9366542","155600","2024-09"
"046120","오르비텍","64953702880","2395","27120544","27449486","328942","2024-09"
"014940","오리엔탈정공","165336659070","3630","45547289","45573661","26372","2024-09"
"002630","오리엔트바이오","54541337960","460","118568126","118583005","14879","2024-09"
"065500","오리엔트정공","38262224124","1206","31726554","31742912","16358","2024-09"
"271560","오리온","3901491375600","98700","39528788","39536132","7344","2024-09"
"001800","오리온홀딩스","985365976140","16380","60156653","62645422","2488769","2024-09"
"010470","오리콤","71369120250","6150","11604735","11975050","370315","2024-09"
"417860","오브젠","42932649660","9690","4430614","4430614","0","2024-09"
"352910","오비고","84926029440","6720","12637802","12637802","0","2024-09"
"053980","오상자이엘","70866980990","3755","18872698","18982783","110085","2024-09"
"036220","오상헬스케어","174548884410","12730","13711617","14489416","777799","2024-09"
"052420","오성첨단소재","145336081296","1744","83334909","86315192","2980283","2024-09"
"039200","오스코텍","1457103105600","38100","38244176","38244176","0","2024-09"
"226400","오스테오닉","119801609950","6050","19801919","20661601","859682","2024-09"
"031510","오스템","34654560129","1323","26193923","28000000","1806077","2024-09"
"368970","오에스피","30842328000","3300","9346160","9346160","0","2024-09"
"138080","오이솔루션","100813517200","9890","10193480","10624095","430615","2024-09"
"080580","오킨스전자","95475456750","5550","17202785","17679298","476513","2024-09"
"067170","오텍","49719911500","3500","14205689","15391605","1185916","2024-09"
"353590","오토앤","63219048700","4910","12875570","12875570","0","2024-09"
"173130","오파스넷","95605805720","7330","13043084","13046473","3389","2024-09"
"440320","오픈놀","45985450000","4690","9805000","9805000","0","2024-09"
"049480","오픈베이스","67044492960","2235","29997536","31422383","1424847","2024-09"
"394280","오픈엣지테크놀로지","253251084930","11590","21850827","21850827","0","2024-09"
"309930","오하임앤컴퍼니","41686104810","2030","20535027","21290990","755963","2024-09"
"244460","올리패스","18290883206","454","40288289","40290730","2441","2024-09"
"226950","올릭스","537832557600","31200","17238223","17238223","0","2024-09"
"057540","옴니시스템","47475275200","800","59344094","61449355","2105261","2024-09"
"131030","옵투스제약","100046422650","6550","15274263","16153162","878899","2024-09"
"082210","옵트론텍","60541478830","2170","27899299","28566538","667239","2024-09"
"109080","옵티시스","32486259810","6830","4756407","5636000","879593","2024-09"
"380540","옵티코어","33933449364","1182","28708502","29779596","1071094","2024-09"
"153710","옵티팜","77310678660","5270","14669958","14669958","0","2024-09"
"432430","와이랩","82440046400","5020","16422320","16422320","0","2024-09"
"338840","와이바이오로직스","175461850080","11880","14769516","14769516","0","2024-09"
"122990","와이솔","168519635970","6090","27671533","28186941","515408","2024-09"
"232140","와이씨","879258262240","10960","80224294","82045350","1821056","2024-09"
"112290","와이씨켐","171373737750","16950","10110545","10110545","0","2024-09"
"065530","와이어블","66974262600","1400","47838759","52860000","5021241","2024-09"
"067900","와이엔텍","115475824420","6380","18099659","18199659","100000","2024-09"
"007530","와이엠","51364570500","2700","19023915","19174452","150537","2024-09"
"155650","와이엠씨","73264273200","4050","18089944","19474358","1384414","2024-09"
"273640","와이엠텍","118345304000","11200","10566545","10966000","399455","2024-09"
"251370","와이엠티","134104894080","8220","16314464","16314464","0","2024-09"
"066430","와이오엠","22430154906","573","39145122","39153476","8354","2024-09"
"209640","와이제이링크","230389482600","16200","14221573","14221573",,"자료 없음"
"273060","와이즈버즈","46473268575","921","50459575","50459582","7","2024-09"
"019210","와이지-원","171562215090","5110","33573819","33573819","0","2024-09"
"122870","와이지엔터테인먼트","751148559000","40500","18546878","18691049","144171","2024-09"
"011690","와이투솔루션","94530249770","2585","36568762","36574394","5632","2024-09"
"332570","와이팜","107268948800","2600","41257288","42233850","976562","2024-09"
"079000","와토스코리아","35746997770","5030","7106759","7200000","93241","2024-09"
"403490","우듬지팜","85493594435","1891","45210785","45212464","1679","2024-09"
"316140","우리금융지주","12340974180720","16620","742537556","742591501","53945","2024-09"
"032820","우리기술","377286467500","2375","158857460","158859048","1588","2024-09"
"041190","우리기술투자","643994460120","8270","77871156","84000000","6128844","2024-09"
"115440","우리넷","79191579230","7570","10461239","10754239","293000","2024-09"
"046970","우리로","49214644038","1134","43399157","43824999","425842","2024-09"
"082850","우리바이오","175139372380","3710","47207378","48456578","1249200","2024-09"
"215360","우리산업","109403312740","11980","9132163","9132163","0","2024-09"
"072470","우리산업홀딩스","57123280225","3025","18883729","18887341","3612","2024-09"
"073560","우리손에프앤지","96517274342","1394","69237643","69237643","0","2024-09"
"037400","우리엔터프라이즈","32132357700","1325","24250836","26223346","1972510","2024-09"
"153490","우리이앤엘","43346288700","857","50579100","51480000","900900","2024-09"
"101170","우림피티에스","69256566480","5240","13216902","13500000","283098","2024-09"
"006980","우성","42120465960","16410","2566756","3090000","523244","2024-09"
"066590","우수AMS","115453641945","2985","38677937","39073104","395167","2024-09"
"017370","우신시스템","128118832480","8240","15548402","18314054","2765652","2024-09"
"103840","우양","63174412080","3860","16366428","16366428","0","2024-09"
"046940","우원개발","41028774500","2270","18074350","18074350","0","2024-09"
"215380","우정바이오","33327536320","2120","15720536","15879576","159040","2024-09"
"065680","우주일렉트로","115914751820","14420","8038471","9530000","1491529","2024-09"
"105840","우진","166468310400","8400","19817656","20323614","505958","2024-09"
"018620","우진비앤지","29031606855","1005","28887171","28889293","2122","2024-09"
"010400","우진아이엔에스","23354373735","3465","6740079","7622000","881921","2024-09"
"457550","우진엔텍","204433024950","22050","9271339","9271339","0","2024-09"
"049800","우진플라임","45600000000","2280","20000000","20000000","0","2024-09"
"016880","웅진","70021616846","901","77715446","79927080","2211634","2024-09"
"095720","웅진씽크빅","194265645436","1724","112683089","115505985","2822896","2024-09"
"396470","워트","150883200000","9360","16120000","16120000","0","2024-09"
"005820","원림","33032689800","16060","2056830","2297970","241140","2024-09"
"307280","원바이오젠","47001563350","1325","35472878","36959013","1486135","2024-09"
"032940","원익","68861190085","3785","18193181","18193230","49","2024-09"
"240810","원익IPS","1430477286000","29400","48655690","49083901","428211","2024-09"
"074600","원익QnC","594108800000","22600","26288000","26288000","0","2024-09"
"104830","원익머트리얼즈","271072000000","21500","12608000","12608000","0","2024-09"
"014190","원익큐브","54756174837","1547","35395071","35399906","4835","2024-09"
"217820","원익피앤이","127195629250","2875","44241958","47454559","3212601","2024-09"
"030530","원익홀딩스","172625591300","2260","76383005","77237981","854976","2024-09"
"012620","원일특강","32736000000","7440","4400000","4400000","0","2024-09"
"382840","원준","211131005900","13900","15189281","15271581","82300","2024-09"
"336570","원텍","526193905140","5890","89336826","89340619","3793","2024-09"
"376980","원티드랩","40900036620","4580","8930139","9754994","824855","2024-09"
"008370","원풍","53298925680","4880","10921911","12000000","1078089","2024-09"
"008290","원풍물산","21815646762","546","39955397","40693679","738282","2024-09"
"101160","월덱스","312553097490","18930","16510993","16510993","0","2024-09"
"336060","웨이버스","67272814400","1397","48155200","48155200","0","2024-09"
"095270","웨이브일렉트로","59466064280","4660","12760958","14971256","2210298","2024-09"
"010600","웰바이오텍","49552926545","545","90922801","90923407","606","2024-09"
"065950","웰크론","65119185190","2390","27246521","28231302","984781","2024-09"
"076080","웰크론한텍","32888592690","1490","22072881","22594156","521275","2024-09"
"043590","웰킵스하이텍","20161314640","755","26703728","27136762","433034","2024-09"
"196700","웹스","19247952960","1340","14364144","14364144","0","2024-09"
"069080","웹젠","472647712600","16040","29466815","34950884","5484069","2024-09"
"053580","웹케시","92195401970","7210","12787157","13636248","849091","2024-09"
"071460","위니아","21802751835","613","35567295","35967295","400000","2024-09"
"377460","위니아에이드","26030247855","1691","15393405","15393405","0","2024-09"
"044340","위닉스","97060530560","6140","15807904","17873425","2065521","2024-09"
"330350","위더스제약","94377712000","7150","13199680","13202139","2459","2024-09"
"348350","위드텍","77309176000","7910","9773600","10183600","410000","2024-09"
"112040","위메이드","1099214456700","32700","33615121","33948483","333362","2024-09"
"101730","위메이드맥스","328484912050","9950","33013559","33295292","281733","2024-09"
"123420","위메이드플레이","78215828320","7520","10401041","11469842","1068801","2024-09"
"065370","위세아이텍","31252923000","4500","6945094","7383954","438860","2024-09"
"038620","위즈코프","37768373151","601","62842551","66546465","3703914","2024-09"
"299900","위지윅스튜디오","215178492680","1270","169431884","171048884","1617000","2024-09"
"036090","위지트","82915640805","703","117945435","118392284","446849","2024-09"
"136540","윈스","152182916640","12310","12362544","13644162","1281618","2024-09"
"097800","윈팩","184690063194","1586","116450229","116450229","0","2024-09"
"192390","윈하이텍","40094716970","3670","10924991","10924991","0","2024-09"
"008600","윌비스","28622734650","435","65799390","67236039","1436649","2024-09"
"335870","윙스풋","19317086676","1158","16681422","16681422","0","2024-09"
"033270","유나이티드제약","312614466250","21250","14711269","16333822","1622553","2024-09"
"014830","유니드","448791600400","67600","6638929","6767600","128671","2024-09"
"446070","유니드비티플러스","44684189550","4370","10225215","10611215","386000","2024-09"
"036200","유니셈","193263468210","6570","29416053","30664223","1248170","2024-09"
"018000","유니슨","116695353852","693","168391564","168391564","0","2024-09"
"000910","유니온","66661613130","4270","15611619","15611619","0","2024-09"
"047400","유니온머티리얼","101850000000","2425","42000000","42000000","0","2024-09"
"203450","유니온커뮤니티","32571119835","2645","12314223","14079007","1764784","2024-09"
"011330","유니켐","137647140596","1532","89848003","96997167","7149164","2024-09"
"077500","유니퀘스트","96444455430","4465","21600102","21794015","193913","2024-09"
"011320","유니크","73515244475","3805","19320695","19320695","0","2024-09"
"086390","유니테스트","192145120650","9450","20332817","21134126","801309","2024-09"
"241690","유니테크노","88828662780","3630","24470706","24470706","0","2024-09"
"142210","유니트론텍","91142927955","4815","18928957","19246092","317135","2024-09"
"088340","유라클","52826829600","12200","4330068","4330068","0","2024-09"
"048430","유라테크","75818542240","6620","11452952","11520000","67048","2024-09"
"206650","유바이오로직스","458505552850","12550","36534307","36534307","0","2024-09"
"089850","유비벨록스","97464431000","6700","14546930","14730199","183269","2024-09"
"084440","유비온","16558752000","840","19712800","19712800","0","2024-09"
"032620","유비케어","190538620710","3755","50742642","52197139","1454497","2024-09"
"264450","유비쿼스","131381230690","13210","9945589","10245706","300117","2024-09"
"078070","유비쿼스홀딩스","160505524080","9720","16512914","18150700","1637786","2024-09"
"002920","유성기업","52449137500","2045","25647500","25947500","300000","2024-09"
"024800","유성티엔에스","66430467792","1989","33398928","37051812","3652884","2024-09"
"000700","유수홀딩스","127639352360","5210","24498916","26041812","1542896","2024-09"
"054930","유신","65400000000","21800","3000000","3000000","0","2024-09"
"069330","유아이디","17507148131","1241","14107291","14191091","83800","2024-09"
"049520","유아이엘","105962357880","4955","21384936","21784936","400000","2024-09"
"435380","유안타제10호스팩","12033000000","2100","5730000","5730000","0","2024-09"
"444920","유안타제11호스팩","10820600000","2065","5240000","5240000","0","2024-09"
"446150","유안타제12호스팩","9778500000","2050","4770000","4770000","0","2024-09"
"449020","유안타제13호스팩","19605950000","2015","9730000","9730000","0","2024-09"
"450940","유안타제14호스팩","9624800000","2120","4540000","4540000","0","2024-09"
"473050","유안타제15호스팩","14160200000","2020","7010000","7010000","0","2024-09"
"474490","유안타제16호스팩","11157750000","2025","5510000","5510000","0","2024-09"
"430700","유안타제9호스팩","11056400000","2110","5240000","5240000","0","2024-09"
"003470","유안타증권","560699099730","2910","192680103","199596576","6916473","2024-09"
"263770","유에스티","49494147195","2105","23512659","23700172","187513","2024-09"
"072130","유엔젤","57259104360","4790","11953884","13195454","1241570","2024-09"
"000220","유유제약","73469335420","4540","16182673","17032351","849678","2024-09"
"388720","유일로보틱스","383690039000","33500","11453434","11453434","0","2024-09"
"340930","유일에너테크","79292846250","2325","34104450","34204450","100000","2024-09"
"023410","유진기업","237487000905","3465","68538817","77310863","8772046","2024-09"
"056080","유진로봇","207067079040","5520","37512152","37512152","0","2024-09"
"468760","유진스팩10호","9010000000","2125","4240000","4240000","0","2024-09"
"442130","유진스팩9호","7819600000","2260","3460000","3460000","0","2024-09"
"084370","유진테크","768502214500","34550","22243190","22916042","672852","2024-09"
"240600","유진테크놀로지","44291665700","6460","6856295","6928151","71856","2024-09"
"001200","유진투자증권","368274971450","4010","91839145","96866418","5027273","2024-09"
"221800","유투바이오","37022002880","3280","11287196","11287196","0","2024-09"
"179900","유티아이","344119647750","21750","15821593","16286895","465302","2024-09"
"263050","유틸렉스","86283993600","2345","36794880","36798858","3978","2024-09"
"000100","유한양행","11364265990000","154000","73793935","80209064","6415129","2024-09"
"003460","유화증권","102264671175","2235","45756005","56702415","10946410","2024-09"
"191410","육일씨엔에쓰","19036029245","1699","11204255","11204255","0","2024-09"
"372170","윤성에프앤씨","401346114400","50300","7979048","7979048","0","2024-09"
"146060","율촌","30329604957","1263","24013939","24015595","1656","2024-09"
"008730","율촌화학","623720000000","25150","24800000","24800000","0","2024-09"
"072770","율호","143988400200","2050","70238244","70238244","0","2024-09"
"008250","이건산업","51530794560","5040","10224364","10952635","728271","2024-09"
"039020","이건홀딩스","70392468250","3250","21659221","22584709","925488","2024-09"
"025820","이구산업","151486774170","4530","33440789","33442000","1211","2024-09"
"067920","이글루","52563260380","5020","10470769","10996119","525350","2024-09"
"044960","이글벳","62356476760","5080","12274897","12641883","366986","2024-09"
"303530","이노뎁","54476311400","7660","7111790","7339299","227509","2024-09"
"296640","이노룰스","29067124000","5750","5055152","5178252","123100","2024-09"
"302430","이노메트리","89233927000","9080","9827525","9833208","5683","2024-09"
"214320","이노션","804000000000","20100","40000000","40000000","0","2024-09"
"462350","이노스페이스","173450339000","18500","9375694","9375694","0","2024-09"
"274400","이노시뮬레이션","39959310860","5110","7819826","7819826","0","2024-09"
"056090","이노시스","122027888325","1297","94084725","94084725","0","2024-09"
"073490","이노와이어리스","126756112820","16670","7603846","7603846","0","2024-09"
"215790","이노인스트루먼트","19939801860","495","40282428","40283149","721","2024-09"
"344860","이노진","22134258000","1851","11958000","12030000","72000","2024-09"
"088390","이녹스","105402915820","11230","9385834","9385844","10","2024-09"
"272290","이녹스첨단소재","443287993000","23000","19273391","20227658","954267","2024-09"
"053350","이니텍","67084516000","4000","16771129","19790916","3019787","2024-09"
"452400","이닉스","107768564640","11880","9071428","9071428","0","2024-09"
"264850","이랜시스","165711527640","5470","30294612","30294612","0","2024-09"
"054210","이랜텍","137126714310","5510","24886881","25291210","404329","2024-09"
"009730","이렘","44617100151","969","46044479","46056774","12295","2024-09"
"065440","이루온","35133547662","1329","26436078","27275020","838942","2024-09"
"139480","이마트","1676950897800","62600","26788353","27875819","1087466","2024-09"
"115610","이미지스","57677921700","3660","15758995","15758995","0","2024-09"
"478110","이베스트스팩6호","10090200000","2010","5020000","5020000","0","2024-09"
"131400","이브이첨단소재","128705055840","2160","59585674","59589882","4208","2024-09"
"351330","이삭엔지니어링","66639700800","8040","8288520","8288520","0","2024-09"
"080010","이상네트웍스","50466227560","5320","9486133","9835071","348938","2024-09"
"457190","이수스페셜티케미컬","1227477065000","41000","29938465","30208280","269815","2024-09"
"086890","이수앱지스","233363864500","6500","35902133","35902133","0","2024-09"
"007660","이수페타시스","2751219226500","43500","63246419","63246419","0","2024-09"
"005950","이수화학","173319412100","7850","22078906","22722739","643833","2024-09"
"015020","이스타코","25901378694","666","38890959","42851600","3960641","2024-09"
"047560","이스트소프트","125591159980","12220","10277509","11603992","1326483","2024-09"
"239340","이스트에이드","45082848102","1671","26979562","26979634","72","2024-09"
"067010","이씨에스","32117121000","2820","11389050","12294000","904950","2024-09"
"093230","이아이디","354065768064","1392","254357592","254384360","26768","2024-09"
"418620","이에이트","139931916500","14500","9650477","9650477","0","2024-09"
"456070","이엔셀","252482143500","23700","10653255","10653255","0","2024-09"
"102710","이엔에프테크놀로지","250037130000","17500","14287836","14287836","0","2024-09"
"074610","이엔플러스","114171078324","1556","73374729","73374729","0","2024-09"
"041520","이엘씨","65509477600","5600","11698121","12188730","490609","2024-09"
"063760","이엘피","20881199900","2365","8829260","9325130","495870","2024-09"
"123570","이엠넷","54557244595","2555","21353129","22276078","922949","2024-09"
"083470","이엠앤아이","28658172246","1343","21338922","21340329","1407","2024-09"
"095190","이엠코리아","105595068760","2330","45319772","45319772","0","2024-09"
"091120","이엠텍","415859085400","25300","16437118","17132936","695818","2024-09"
"102460","이연제약","289237428070","15770","18340991","18586811","245820","2024-09"
"039030","이오테크닉스","1929083188200","159400","12102153","12319550","217397","2024-09"
"294090","이오플로우","173787612890","5710","30435659","30435659","0","2024-09"
"088290","이원컴포텍","36845541768","1176","31331243","31331669","426","2024-09"
"084680","이월드","242479672380","1710","141800978","141806193","5215","2024-09"
"353810","이지바이오","115559799600","3455","33447120","34191720","744600","2024-09"
"099750","이지케어텍","112104845520","16680","6720914","6834776","113862","2024-09"
"377330","이지트로닉스","47533811200","6010","7909120","8139954","230834","2024-09"
"035810","이지홀딩스","168062145495","2605","64515219","65145845","630626","2024-09"
"160600","이큐셀","106346383500","3100","34305285","34482552","177267","2024-09"
"092130","이크레더블","152592412000","12670","12043600","12043600","0","2024-09"
"096040","이트론","245561522409","271","906131079","906131295","216","2024-09"
"134060","이퓨쳐","15713311980","4085","3846588","4769250","922662","2024-09"
"001840","이화공영","45845718290","2315","19803766","19805760","1994","2024-09"
"000760","이화산업","34132000000","12190","2800000","2800000","0","2024-09"
"024810","이화전기","196810080587","899","218921113","218948640","27527","2024-09"
"014990","인디에프","57083592400","760","75109990","75112995","3005","2024-09"
"041830","인바디","304176877450","23350","13026847","13683782","656935","2024-09"
"352940","인바이오","24561069800","2260","10867730","10867730","0","2024-09"
"101140","인바이오젠","93257770480","9340","9984772","10044216","59444","2024-09"
"079950","인베니아","17388420000","798","21790000","23200000","1410000","2024-09"
"389470","인벤티지랩","200641480000","20000","10032074","10032074","0","2024-09"
"277410","인산가","52431216162","1391","37693182","38356789","663607","2024-09"
"060150","인선이엔티","252801669240","5640","44822991","46563612","1740621","2024-09"
"033230","인성정보","98510560566","1966","50107101","50515380","408279","2024-09"
"450520","인스웨이브시스템즈","48378061620","3290","14704578","14704578","0","2024-09"
"006490","인스코비","223899063570","1890","118465113","119368998","903885","2024-09"
"465480","인스피언","161393330240","15920","10137772","10137772",,"자료 없음"
"037330","인지디스플레","63555938272","1576","40327372","43885224","3557852","2024-09"
"100030","인지소프트","46069034700","16770","2747110","3283714","536604","2024-09"
"023800","인지컨트롤스","95411104130","6290","15168697","15809197","640500","2024-09"
"034590","인천도시가스","105935374300","25700","4121999","4374754","252755","2024-09"
"211050","인카금융서비스","251045674940","5140","48841571","51379800","2538229","2024-09"
"083640","인콘","26217799840","340","77111176","77720351","609175","2024-09"
"064090","인크레더블버즈","218858974400","4400","49740676","49742745","2069","2024-09"
"216050","인크로스","83525714800","6920","12070190","12843222","773032","2024-09"
"049070","인탑스","318134060000","20000","15906703","17200000","1293297","2024-09"
"119610","인터로조","312050211300","24900","12532137","13216478","684341","2024-09"
"017250","인터엠","20771849142","1026","20245467","21045467","800000","2024-09"
"129260","인터지스","62071090400","2200","28214132","29747874","1533742","2024-09"
"051370","인터플렉스","233974544160","10030","23327472","23327472","0","2024-09"
"064290","인텍플러스","161966367680","13070","12392224","12863962","471738","2024-09"
"189300","인텔리안테크","540178480800","51800","10428156","10733334","305178","2024-09"
"150840","인트로메딕","251537720850","5850","42997901","42997901","0","2024-09"
"048530","인트론바이오","196321050000","6000","32720175","34150762","1430587","2024-09"
"023810","인팩","72300000000","7230","10000000","10000000","0","2024-09"
"115310","인포바인","42743892450","19950","2142551","3192883","1050332","2024-09"
"039290","인포뱅크","49629015450","5950","8341011","8693978","352967","2024-09"
"071200","인피니트헬스케어","108475215850","4450","24376453","24396458","20005","2024-09"
"101930","인화정공","230468556500","24250","9503858","9615733","111875","2024-09"
"249420","일동제약","388259887400","13900","27932366","28062501","130135","2024-09"
"000230","일동홀딩스","89433352800","7920","11292090","11540400","248310","2024-09"
"013360","일성건설","66288527760","1227","54024880","54024880","0","2024-09"
"003120","일성아이에스","106528968990","15630","6815673","13300000","6484327","2024-09"
"333430","일승","92195440395","3005","30680679","30726747","46068","2024-09"
"068330","일신바이오","51679179920","1240","41676758","44216140","2539382","2024-09"
"003200","일신방직","172536561000","8100","21300810","23280000","1979190","2024-09"
"007110","일신석재","104219447460","1346","77429010","77456610","27600","2024-09"
"007570","일양약품","234006168480","13020","17972824","19085664","1112840","2024-09"
"178780","일월지엠엘","124101377000","8650","14346980","14349195","2215","2024-09"
"008500","일정실업","13801286560","11680","1181617","1200000","18383","2024-09"
"019540","일지테크","53711357190","4065","13213126","13513500","300374","2024-09"
"081000","일진다이아","174920961600","12320","14198130","14202975","4845","2024-09"
"020760","일진디스플","47129030812","916","51450907","51513741","62834","2024-09"
"103590","일진전기","1187163998100","24900","47677269","47685390","8121","2024-09"
"094820","일진파워","160135889580","10620","15078709","15078709","0","2024-09"
"271940","일진하이솔루스","723358744800","19920","36313190","36313190","0","2024-09"
"015860","일진홀딩스","184402003370","4010","45985537","49347483","3361946","2024-09"
"226320","잇츠한불","208933884100","11860","17616685","21929315","4312630","2024-09"
"049550","잉크테크","75680229220","3860","19606277","19606277","0","2024-09"
"389020","자람테크놀로지","196556175900","32050","6132798","6197730","64932","2024-09"
"254120","자비스","57462470070","1871","30712170","30754270","42100","2024-09"
"043910","자연과환경","69394345848","612","113389454","113391457","2003","2024-09"
"234920","자이글","48868896440","3640","13425521","13530910","105389","2024-09"
"289220","자이언트스텝","151312735800","6840","22121745","22121745","0","2024-09"
"317400","자이에스앤디","152259517400","3995","38112520","38782520","670000","2024-09"
"033240","자화전자","336962589600","15980","21086520","22155870","1069350","2024-09"
"174880","장원테크","11454988050","2650","4322637","4381265","58628","2024-09"
"049630","재영솔루텍","52618499977","629","83654213","83654213","0","2024-09"
"417840","저스템","55319596800","7800","7092256","7249175","156919","2024-09"
"000950","전방","21900613400","19220","1139470","1680000","540530","2024-09"
"079900","전진건설로봇","255596352000","17600","14522520","15360574","838054","2024-09"
"110020","전진바이오팜","21650441180","2390","9058762","9058762","0","2024-09"
"208140","정다운","83998486520","2570","32684236","32684246","10","2024-09"
"040420","정상제이엘에스","96653660740","6470","14938742","15677552","738810","2024-09"
"045510","정원엔시스","27796802031","883","31479957","32209292","729335","2024-09"
"217190","제너셈","68574940680","7820","8769174","8769174","0","2024-09"
"095700","제넥신","393399214700","8650","45479678","45540494","60816","2024-09"
"072520","제넨바이오","28838655818","389","74135362","74163194","27832","2024-09"
"122310","제노레이","81024307820","6010","13481582","14553844","1072262","2024-09"
"361390","제노코","109511519400","14600","7500789","7500789","0","2024-09"
"187420","제노포커스","72564981465","3065","23675361","23675361","0","2024-09"
"225220","제놀루션","52543032750","2910","18056025","19190021","1133996","2024-09"
"123330","제닉","179967778000","23000","7824686","7968680","143994","2024-09"
"381620","제닉스","113907272000","26050","4372640","4372640","0","2024-09"
"159580","제로투세븐","84437560740","4215","20032636","20032636","0","2024-09"
"147830","제룡산업","120657467700","6300","19151979","20000000","848021","2024-09"
"033100","제룡전기","952500853700","59300","16062409","16062409","0","2024-09"
"079370","제우스","370036509660","12060","30682961","31016990","334029","2024-09"
"054950","제이브이엠","229553102240","19930","11517968","12089892","571924","2024-09"
"023440","제이스코홀딩스","97010454030","1653","58687510","58687510","0","2024-09"
"090470","제이스텍","92476571330","5330","17350201","17476594","126393","2024-09"
"287410","제이시스메디칼","960860460300","12900","74485307","75692193","1206886","2024-06"
"137950","제이씨케미칼","99070243290","4590","21583931","22267814","683883","2024-09"
"033320","제이씨현시스템","83880262440","4440","18891951","19114432","222481","2024-09"
"417500","제이아이테크","112664495360","3565","31602944","32784744","1181800","2024-09"
"204270","제이앤티씨","1352526317700","23700","57068621","57848466","779845","2024-09"
"194370","제이에스코퍼레이션","209101863000","15700","13318590","13335601","17011","2024-09"
"026040","제이에스티나","25153855364","1756","14324519","16503790","2179271","2024-09"
"452160","제이엔비","55199840780","5740","9616697","9617527","830","2024-09"
"126880","제이엔케이글로벌","88386389245","3815","23168123","23204903","36780","2024-09"
"322510","제이엘케이","182432688000","11500","15863712","16195712","332000","2024-09"
"033050","제이엠아이","30056325632","944","31839328","32579342","740014","2024-09"
"094970","제이엠티","55233602870","3305","16712134","16748240","36106","2024-09"
"418550","제이오","499524671970","16890","29575173","31772273","2197100","2024-09"
"025620","제이준코스메틱","22953456540","5130","4474358","4484846","10488","2024-09"
"420570","제이투케이바이오","94792871040","16590","5713856","5732807","18951","2024-09"
"089790","제이티","43502211200","4760","9139120","10315513","1176393","2024-09"
"030000","제일기획","1844285582250","18210","101278725","115041225","13762500","2024-09"
"052670","제일바이오","56184286080","2080","27011676","29129064","2117388","2024-09"
"271980","제일약품","214638445410","14730","14571517","14704872","133355","2024-09"
"412540","제일엠앤에스","221663155400","10760","20600665","20600665","0","2024-09"
"001560","제일연마","58191300000","8550","6806000","9900000","3094000","2024-09"
"199820","제일일렉트릭","202202000000","9100","22220000","22220000","0","2024-09"
"038010","제일테크노스","55467720000","6670","8316000","9000000","684000","2024-09"
"002620","제일파마홀딩스","135396922500","8820","15351125","15973355","622230","2024-09"
"276730","제주맥주","29501385725","2485","11871785","11886605","14820","2024-09"
"080220","제주반도체","409586544640","12160","33683104","34442833","759729","2024-09"
"006220","제주은행","263777234540","8210","32128774","32128774","0","2024-09"
"089590","제주항공","713054332350","8850","80571111","80640985","69874","2024-09"
"216080","제테마","338423483050","18950","17858759","17858759","0","2024-09"
"229000","젠큐릭스","36890492100","2420","15244005","15244005","0","2024-09"
"082270","젬백스","749950412400","18900","39679916","39994174","314258","2024-09"
"044060","조광ILI","70075958688","732","95732184","95732184","0","2024-09"
"004910","조광페인트","62737840540","6130","10234558","12800000","2565442","2024-09"
"004700","조광피혁","181554365300","51100","3552923","6649138","3096215","2024-09"
"001550","조비","55500641320","10690","5191828","5192239","411","2024-09"
"462520","조선내화","195155236980","16470","11849134","11855168","6034","2024-09"
"120030","조선선재","90659556000","93600","968585","1257651","289066","2024-09"
"034940","조아제약","42690201606","1378","30979827","30979827","0","2024-09"
"067000","조이시티","113593099750","1625","69903446","69903446","0","2024-09"
"018470","조일알미늄","206029810067","1627","126631721","126631721","0","2024-09"
"002600","조흥","103500000000","172500","600000","600000","0","2024-09"
"185750","종근당","1394088221500","110500","12616183","13174420","558237","2024-09"
"063160","종근당바이오","162932982300","29700","5485959","5485962","3","2024-09"
"001630","종근당홀딩스","285633480000","60000","4760558","5009861","249303","2024-09"
"033340","좋은사람들","61951406562","639","96950558","96950558","0","2024-09"
"036930","주성엔지니어링","1276244667000","27000","47268321","47268321","0","2024-09"
"109070","주성코퍼레이션","216476814300","4100","52799223","52810230","11007","2024-09"
"044380","주연테크","22825657686","354","64479259","66403852","1924593","2024-09"
"072020","중앙백신","101315733120","10570","9585216","9658687","73471","2024-09"
"000440","중앙에너비스","105081889500","23700","4433835","6227130","1793295","2024-09"
"051980","중앙첨단소재","1236710900000","12400","99734750","99961003","226253","2024-09"
"228760","지노믹트리","402793980480","16790","23990112","24362333","372221","2024-09"
"314130","지놈앤컴퍼니","129507013050","4190","30908595","30908595","0","2024-09"
"013890","지누스","431709971850","21150","20411819","20735204","323385","2024-09"
"389030","지니너스","50494693330","1514","33351845","33351845","0","2024-09"
"043610","지니뮤직","156621105410","2695","58115438","58115438","0","2024-09"
"263860","지니언스","83939435370","9730","8626869","9444600","817731","2024-09"
"303030","지니틱스","43991203112","1231","35736152","35745668","9516","2024-09"
"036180","지더블유바이텍","53929030348","577","93464524","93464524","0","2024-09"
"208350","지란지교시큐리티","23357111580","2985","7824828","8838549","1013721","2024-09"
"144510","지씨셀","536468933700","35700","15027141","15800344","773203","2024-09"
"358570","지아이이노베이션","665035877440","15040","44217811","44217811","0","2024-09"
"382480","지아이텍","91223614215","2335","39067929","39357140","289211","2024-09"
"382800","지앤비에스 에코","102168262430","3230","31631041","31631041","0","2024-09"
"051160","지어소프트","138296373600","9520","14526930","15474430","947500","2024-09"
"053050","지에스이","116801690315","3895","29987597","29987597","0","2024-09"
"119850","지엔씨에너지","78005172810","5230","14914947","16448909","1533962","2024-09"
"065060","지엔코","35055012850","325","107861578","108008044","146466","2024-09"
"204840","지엘팜텍","83552457182","1087","76865186","76865206","20","2024-09"
"013870","지엠비코리아","72951471000","3825","19072280","19072280","0","2024-09"
"071320","지역난방공사","552306088800","47700","11578744","11578744","0","2024-09"
"270520","지오릿에너지","164348463510","1035","158790786","158790786","0","2024-09"
"311320","지오엘리먼트","83508387200","6620","12614560","12614560","0","2024-09"
"388050","지투파워","127975227660","6860","18655281","18709437","54156","2024-09"
"088790","진도","22804267008","1832","12447744","12447744","0","2024-09"
"018120","진로발효","117663843920","17780","6617764","6621120","3356","2024-09"
"109820","진매트릭스","66780125235","3345","19964163","20393640","429477","2024-09"
"086060","진바이오텍","29706525150","3450","8610587","8610587","0","2024-09"
"036890","진성티이씨","171875231200","8600","19985492","22482268","2496776","2024-09"
"363250","진시스템","66077874240","9740","6784176","7006491","222315","2024-09"
"003780","진양산업","83980000000","6460","13000000","13000000","0","2024-09"
"007370","진양제약","63108646560","5560","11350476","12574867","1224391","2024-09"
"010640","진양폴리","67300000000","6730","10000000","10000000","0","2024-09"
"100250","진양홀딩스","177747028560","3180","55895292","55895292","0","2024-09"
"051630","진양화학","43371000000","2745","15800000","15800000","0","2024-09"
"272450","진에어","542649166020","10530","51533634","52200000","666366","2024-09"
"285800","진영","45528241460","2605","17477252","17477270","18","2024-09"
"011000","진원생명과학","182809717590","2290","79829571","80039035","209464","2024-09"
"002780","진흥기업","113277205306","779","145413614","145471745","58131","2024-09"
"085660","차바이오텍","979871308200","17400","56314443","56314443","0","2024-09"
"261780","차백신연구소","106896620780","3985","26824748","26824748","0","2024-09"
"351870","차이커뮤니케이션","109961831200","9880","11129740","11131089","1349","2024-09"
"009310","참엔지니어링","32492615540","385","84396404","84867419","471015","2024-09"
"094850","참좋은여행","62911459900","4700","13385417","14000000","614583","2024-09"
"004650","창해에탄올","71548719930","9430","7587351","9190885","1603534","2024-09"
"278280","천보","526290000000","53000","9930000","10000000","70000","2024-09"
"000650","천일고속","58152450500","40750","1427054","1429220","2166","2024-09"
"362320","청담글로벌","130400513280","6480","20123536","20551290","427754","2024-09"
"012600","청호ICT","116119947330","2490","46634517","46634517","0","2024-09"
"066360","체리부로","36635339460","764","47952015","47952015","0","2024-09"
"033250","체시스","42560000000","1330","32000000","32000000","0","2024-09"
"047820","초록뱀미디어","131865872400","5400","24419606","24453930","34324","2024-09"
"094360","칩스앤미디어","262956850000","13000","20227450","20823124","595674","2024-09"
"016920","카스","29071419377","1183","24574319","26493538","1919219","2024-09"
"284620","카이노스메드","134577206720","4840","27805208","28180793","375585","2024-09"
"035720","카카오","16392074550300","37350","438877498","443530908","4653410","2024-09"
"293490","카카오게임즈","1374463725600","16800","81813317","82667326","854009","2024-09"
"323410","카카오뱅크","10362380840250","21750","476431303","476963637","532334","2024-09"
"377300","카카오페이","3250976061900","24150","134615986","134615986","0","2024-09"
"140430","카티스","49659469740","3105","15993388","17922947","1929559","2024-09"
"042000","카페24","603245316550","24950","24178169","24253054","74885","2024-09"
"006380","카프로","618528628380","3660","168996893","168999996","3103","2024-09"
"313760","캐리","50055092640","6840","7317996","7417913","99917","2024-09"
"317530","캐리소프트","27399034740","3990","6866926","6971196","104270","2024-09"
"071850","캐스텍코리아","51190579180","2110","24260938","24529188","268250","2024-09"
"050110","캠시스","80489552199","1099","73238901","73824118","585217","2024-09"
"452300","캡스톤파트너스","37778298400","2680","14096380","14096380","0","2024-09"
"451760","컨텍","145627188720","9880","14739594","14940476","200882","2024-09"
"078340","컴투스","426032058300","37300","11421771","12737755","1315984","2024-09"
"063080","컴투스홀딩스","138164202500","20950","6594950","6595192","242","2024-09"
"307930","컴퍼니케이","76957300000","4930","15610000","15610000","0","2024-09"
"079190","케스피온","22486490958","597","37665814","38355514","689700","2024-09"
"263700","케어랩스","56065939310","2890","19399979","19414200","14221","2024-09"
"214370","케어젠","803504896400","16400","48994201","53715000","4720799","2024-09"
"221980","케이디켐","46811012500","12500","3744881","4034800","289919","2024-09"
"038530","케이바이오","30029178660","260","115496841","115714347","217506","2024-09"
"001620","케이비아이동국실업","63770906763","573","111293031","111293031","0","2024-09"
"424140","케이비제21호스팩","16692150000","2165","7710000","7710000","0","2024-09"
"192250","케이사인","65517422949","957","68461257","70671257","2210000","2024-09"
"431190","케이쓰리아이","42522990560","5680","7486442","7486442","0","2024-09"
"029460","케이씨","224109233130","19290","11617897","13554044","1936147","2024-09"
"115500","케이씨에스","75600000000","6300","12000000","12000000","0","2024-09"
"281820","케이씨텍","699034296400","34900","20029636","20861556","831920","2024-09"
"089150","케이씨티","38930500000","2270","17150000","17150000","0","2024-09"
"025880","케이씨피드","43093421280","2730","15785136","16715858","930722","2024-09"
"093320","케이아이엔엑스","354540152100","73300","4836837","4880000","43163","2024-09"
"093640","케이알엠","150213715200","4610","32584320","32584320","0","2024-09"
"073010","케이에스피","160277576000","4000","40069394","40191250","121856","2024-09"
"105330","케이엔더블유","63878372075","4025","15870403","16060028","189625","2024-09"
"053080","케이엔솔","198264988800","15300","12958496","12999807","41311","2024-09"
"199430","케이엔알시스템","81942556020","7540","10867713","10867713","0","2024-09"
"432470","케이엔에스","138532659320","15970","8674556","8674556","0","2024-09"
"272110","케이엔제이","131448585900","16420","8005395","8005395","0","2024-09"
"039420","케이엘넷","55461289770","2595","21372366","24154730","2782364","2024-09"
"083550","케이엠","38636340600","3350","11533236","12374226","840990","2024-09"
"032500","케이엠더블유","290692445900","7300","39820883","39820883","0","2024-09"
"225430","케이엠제약","19381472645","695","27887011","27887050","39","2024-09"
"102370","케이옥션","112484620050","4345","25888290","27229210","1340920","2024-09"
"068100","케이웨더","33728677290","3465","9734106","9939614","205508","2024-09"
"381970","케이카","633594259950","13150","48182073","48182073","0","2024-09"
"036030","케이티알파","197792233935","4035","49019141","49019283","142","2024-09"
"064820","케이프","143414881920","5140","27901728","30901728","3000000","2024-09"
"256940","케이피에스","105929917700","5650","18748658","18748658","0","2024-09"
"024880","케이피에프","79336582600","4100","19350386","20682798","1332412","2024-09"
"042040","케이피엠테크","53380546992","306","174446232","174460917","14685","2024-09"
"054410","케이피티유","22676718240","3960","5726444","5726444","0","2024-09"
"258610","케일럼","42472098081","1601","26528481","26787133","258652","2024-09"
"274090","켄코아에어로스페이스","126678747060","9810","12913226","12913226","0","2024-09"
"089010","켐트로닉스","296767131210","19910","14905431","15334346","428915","2024-09"
"220260","켐트로스","130268422260","4905","26558292","26558307","15","2024-09"
"052400","코나아이","194827818560","13340","14604784","14899999","295215","2024-09"
"402030","코난테크놀로지","161485720800","14100","11452888","11452888","0","2024-09"
"391710","코닉오토메이션","87773489820","2115","41500468","41503222","2754","2024-09"
"046070","코다코","144219271360","10280","14029112","14064588","35476","2024-09"
"047770","코데즈컴바인","56284145169","1491","37749259","37842602","93343","2024-09"
"080530","코디","66196573144","1534","43152916","43300427","147511","2024-09"
"104540","코렌텍","84769456200","6630","12785740","12785740","0","2024-09"
"027050","코리아나","76347000000","2495","30600000","40000000","9400000","2024-09"
"007810","코리아써키트","240931660200","10200","23620751","23620751","0","2024-09"
"190650","코리아에셋투자증권","35645040000","5580","6388000","6388000","0","2024-09"
"123410","코리아에프티","142824632670","5130","27841059","27841064","5","2024-09"
"003690","코리안리","1295954228800","8800","147267526","165367526","18100000","2024-09"
"036690","코맥스","45885746130","2885","15904938","15904938","0","2024-09"
"049430","코메론","98378851500","10950","8984370","9048000","63630","2024-09"
"183300","코미코","519340752000","50400","10304380","10460684","156304","2024-09"
"041960","코미팜","302766972200","4370","69283060","70622233","1339173","2024-09"
"089890","코세스","147597264000","9000","16399696","16584962","185266","2024-09"
"360350","코셈","40724744600","7180","5671970","5671970","0","2024-09"
"082660","코스나인","47827116000","480","99639825","99640869","1044","2024-09"
"192820","코스맥스","1639448159000","144500","11345662","11349509","3847","2024-09"
"044820","코스맥스비티아이","83031550910","8690","9554839","9603921","49082","2024-09"
"222040","코스맥스엔비티","65158830120","3170","20554836","20628000","73164","2024-09"
"241710","코스메카코리아","807408000000","75600","10680000","10680000","0","2024-09"
"005070","코스모신소재","3331147090000","102500","32498996","32510756","11760","2024-09"
"005420","코스모화학","797978667200","20800","38364359","38408228","43869","2024-09"
"355150","코스텍시스","59589942990","7890","7552591","7797350","244759","2024-09"
"071950","코아스","32643942400","9920","3290720","3290720","0","2024-09"
"166480","코아스템켐온","368325150480","15120","24360129","32870376","8510247","2024-09"
"045970","코아시아","109750235025","4425","24802313","26314876","1512563","2024-09"
"196450","코아시아씨엠","40641519087","897","45308271","45319582","11311","2024-09"
"384470","코어라인소프트","95724519300","7460","12831705","12832064","359","2024-09"
"029960","코엔텍","350752798400","7220","48580720","50000000","1419280","2024-09"
"002020","코오롱","180431627540","14290","12626426","12626426","0","2024-09"
"138490","코오롱ENP","218120000000","5740","38000000","38000000","0","2024-09"
"003070","코오롱글로벌","170666918150","9050","18858223","18932713","74490","2024-09"
"450140","코오롱모빌리티그룹","145048481930","2365","61331282","62777250","1445968","2024-09"
"102940","코오롱생명과학","232317336900","18700","12423387","12423387","0","2024-09"
"120110","코오롱인더","881763798550","32050","27512131","27519091","6960","2024-09"
"021240","코웨이","4746002778000","66000","71909133","73799619","1890486","2024-09"
"033290","코웰패션","128500323200","2425","52989824","56156301","3166477","2024-09"
"056360","코위버","44576634420","4815","9257868","9796800","538932","2024-09"
"282880","코윈테크","150734902200","13800","10922819","11141807","218988","2024-09"
"121850","코이즈","28272064296","931","30367416","30614175","246759","2024-09"
"448710","코츠테크놀로지","99418345600","22400","4438319","5166069","727750","2024-09"
"126730","코칩","102362337500","12500","8188987","8503460","314473","2024-09"
"015710","코콤","70624221935","4255","16597937","17530500","932563","2024-09"
"052330","코텍","98818568820","7860","12572337","15574552","3002215","2024-09"
"322780","코퍼스코리아","38296750500","1038","36894750","37932613","1037863","2024-09"
"036420","콘텐트리중앙","201553076350","10550","19104557","19262308","157751","2024-09"
"200130","콜마비앤에이치","410548177200","14100","29116892","29415558","298666","2024-09"
"024720","콜마홀딩스","236301224510","6890","34296259","34296259","0","2024-09"
"031820","콤텍시스템","68273026824","564","121051466","121051466","0","2024-09"
"294570","쿠콘","139097760120","13640","10197783","10254685","56902","2024-09"
"192400","쿠쿠홀딩스","736557724500","23700","31078385","35562185","4483800","2024-09"
"284740","쿠쿠홈시스","525804811000","23450","22422380","22437330","14950","2024-09"
"317690","퀀타매트릭스","124030582500","7500","16537411","16537411","0","2024-09"
"078940","퀀타피아","151577916950","2855","53092090","53094278","2188","2024-09"
"227100","퀀텀온","18957862326","1209","15680614","15680614","0","2024-09"
"432720","퀄리타스반도체","133412250720","9660","13810792","13810792","0","2024-09"
"365270","큐라클","80052795360","5770","13873968","13873968","0","2024-09"
"348080","큐라티스","34522496190","819","42152010","42152010","0","2024-09"
"060280","큐렉소","278590132200","6780","41089990","41089990","0","2024-09"
"372320","큐로셀","443838937500","31500","14090125","14090125","0","2024-09"
"051780","큐로홀딩스","18871240202","139","135764318","136422450","658132","2024-09"
"115180","큐리언트","183068888940","5670","32287282","32292671","5389","2024-09"
"445680","큐리옥스바이오시스템즈","393565244100","24450","16096738","16096738","0","2024-09"
"182360","큐브엔터","192500126280","13860","13888898","14571557","682659","2024-09"
"405100","큐알티","165909570750","14070","11791725","12289301","497576","2024-09"
"066310","큐에스아이","61060165850","6830","8939995","9271621","331626","2024-09"
"016600","큐캐피탈","49389166226","283","174520022","178247112","3727090","2024-09"
"355390","크라우드웍스","49560539140","11740","4221511","4224606","3095","2024-09"
"264900","크라운제과","100575334530","8370","12016169","12523850","507681","2024-09"
"005740","크라운해태홀딩스","83419863000","5800","14382735","14847347","464612","2024-09"
"259960","크래프톤","15476552074500","340500","45452429","47897003","2444574","2024-09"
"096240","크레버스","132439029900","15700","8435607","11138180","2702573","2024-09"
"040350","크레오에스지","105870987834","698","151677633","152074086","396453","2024-09"
"110790","크리스에프앤씨","136102290240","6720","20253317","23430960","3177643","2024-09"
"045520","크린앤사이언스","31808400000","5200","6117000","6500000","383000","2024-09"
"036170","클라우드에어","52376983252","869","60272708","61365626","1092918","2024-09"
"214150","클래시스","3674867469900","56100","65505659","65505659","0","2024-09"
"352770","클리노믹스","23991012864","624","38447136","38886113","438977","2024-09"
"237880","클리오","405695022450","23150","17524623","18071353","546730","2024-09"
"139670","키네마스터","39038509650","2765","14118810","14118810","0","2024-09"
"020120","키다리스튜디오","130647751800","3525","37063192","37063766","574","2024-09"
"413600","키움제6호스팩","9089500000","2650","3430000","3430000","0","2024-09"
"433530","키움제7호스팩","9092575000","2215","4105000","4105000","0","2024-09"
"446840","키움제8호스팩","12936000000","2200","5880000","5880000","0","2024-09"
"039490","키움증권","3310822729200","137200","24131361","25526706","1395345","2024-09"
"054780","키이스트","85386588050","4370","19539265","19547793","8528","2024-09"
"219130","타이거일렉","132284375500","20950","6314290","6314290","0","2024-09"
"360070","탑머티리얼","269426935600","33650","8006744","8076743","69999","2024-09"
"065130","탑엔지니어링","62681391840","4040","15515196","17189982","1674786","2024-09"
"134580","탑코미디어","50543059750","2335","21645850","22025767","379917","2024-09"
"014580","태경비케이","122193133000","4430","27583100","27583100","0","2024-09"
"015890","태경산업","150528062500","5150","29228750","29228750","0","2024-09"
"006890","태경케미컬","124219533040","10960","11333899","11600000","266101","2024-09"
"023160","태광","334980783900","12950","25867242","26500000","632758","2024-09"
"003240","태광산업","535277316000","636000","841631","1113400","271769","2024-09"
"011280","태림포장","146283132125","2125","68839121","70805940","1966819","2024-09"
"323280","태성","805606776000","31200","25820730","25820730","0","2024-09"
"053620","태양","50234105610","6310","7961031","8600000","638969","2024-09"
"004100","태양금속","107632506300","2955","36423860","36700000","276140","2024-09"
"009410","태영건설","1330097939940","4620","287899987","287905337","5350","2024-09"
"044490","태웅","286505695920","14320","20007381","20007381","0","2024-09"
"124560","태웅로직스","102888241480","2845","36164584","38416584","2252000","2024-09"
"001420","태원물산","27865806600","3800","7333107","7600000","266893","2024-09"
"191420","테고사이언스","122660591120","15320","8006566","8108834","102268","2024-09"
"073640","테라사이언스","59577565530","654","91097195","95587404","4490209","2024-09"
"066700","테라젠이텍스","113299041660","3540","32005379","32474435","469056","2024-09"
"095610","테스","283290799900","16150","17541226","19768226","2227000","2024-09"
"055490","테이팩스","80273209500","16830","4769650","4769650","0","2024-09"
"064520","테크엘","49942241670","2235","22345522","22351062","5540","2024-09"
"089030","테크윙","1368860154200","38300","35740474","37353645","1613171","2024-09"
"054450","텔레칩스","187763685120","12720","14761296","15144233","382937","2024-09"
"078000","텔코웨어","51071989670","9890","5164003","9240077","4076074","2024-09"
"200230","텔콘RF제약","68422383715","569","120250235","120250235","0","2024-09"
"214420","토니모리","188352889880","7880","23902651","24054799","152148","2024-09"
"393210","토마토시스템","99050130200","6440","15380455","15614544","234089","2024-09"
"215480","토박스코리아","23745250800","2650","8960472","9400000","439528","2024-09"
"051360","토비스","306227780300","20050","15273206","16167058","893852","2024-09"
"045340","토탈소프트","44073906000","5150","8558040","8558040","0","2024-09"
"108230","톱텍","195659107560","5370","36435588","38023245","1587657","2024-09"
"079970","투비소프트","8617024290","1030","8366043","9290500","924457","2024-09"
"199800","툴젠","455209994400","57300","7944328","7946828","2500","2024-09"
"417790","트루엔","95157674190","9090","10468391","10999650","531259","2024-09"
"290090","트윔","59232360060","8460","7001461","7432268","430807","2024-09"
"026150","특수건설","96153893880","5480","17546331","17546331","0","2024-09"
"464280","티디에스팜","79168845000","14970","5288500","5530000","241500","2024-09"
"322180","티라유텍","96804123500","5860","16519475","16519475","0","2024-09"
"117730","티로보틱스","128783573200","7220","17837060","17837060","0","2024-09"
"033830","티비씨","79977159900","846","94535650","100000000","5464350","2024-09"
"057680","티사이언티픽","64194899401","901","71248501","71248501","0","2024-09"
"204610","티쓰리","82055488200","1400","58611063","63851720","5240657","2024-09"
"064760","티씨케이","998212500000","85500","11675000","11675000","0","2024-09"
"246710","티앤알바이오팹","153413415360","7120","21546828","21546828","0","2024-09"
"340570","티앤엘","594100009600","73600","8072011","8128000","55989","2024-09"
"043220","티에스넥스젠","83058912360","584","142224165","142224165","0","2024-09"
"277880","티에스아이","123182683520","6110","20160832","20160832","0","2024-09"
"131290","티에스이","548982968000","50900","10785520","11061429","275909","2024-09"
"019180","티에이치엔","57420000000","3190","18000000","18000000","0","2024-09"
"425420","티에프이","182672650000","16150","11311000","11381000","70000","2024-09"
"131100","티엔엔터테인먼트","42990705429","1533","28043513","28048252","4739","2024-09"
"356860","티엘비","116294297000","11900","9772630","9832630","60000","2024-09"
"062860","티엘아이","42843237000","5800","7386765","9872720","2485955","2024-09"
"363280","티와이홀딩스","120730146350","3410","35404735","50429268","15024533","2024-09"
"321550","티움바이오","160056781950","6150","26025493","26025493","0","2024-09"
"091810","티웨이항공","626155132350","2910","215173585","215378976","205391","2024-09"
"004870","티웨이홀딩스","67859599872","608","111611184","111611693","509","2024-09"
"425040","티이엠씨","185512625610","8770","21153093","21316062","162969","2024-09"
"241790","티이엠씨씨엔에스","56532203340","5820","9713437","10002634","289197","2024-09"
"104480","티케이케미칼","129889575186","1429","90895434","90895434","0","2024-09"
"081150","티플랙스","76202782280","3140","24268402","24268402","0","2024-09"
"130740","티피씨글로벌","21730160433","1927","11276679","11276679","0","2024-09"
"084730","팅크웨어","104163705240","9940","10479246","11109424","630178","2024-09"
"440110","파두","924505763720","18770","49254436","49334436","80000","2024-09"
"034230","파라다이스","894692967000","10360","86360325","91771623","5411298","2024-09"
"033540","파라텍","52428209391","1401","37421991","37751063","329072","2024-09"
"388870","파로스아이바이오","127111356460","9830","12930962","12930962","0","2024-09"
"043200","파루","23153173528","554","41792732","41804315","11583","2024-09"
"214450","파마리서치","2384338100000","230500","10344200","10464152","119952","2024-09"
"208340","파멥신","233760977175","2915","80192445","80201108","8663","2024-09"
"005690","파미셀","300020070000","5000","60004014","60016964","12950","2024-09"
"177830","파버나인","36827024315","3095","11898877","14288753","2389876","2024-09"
"037070","파세코","118435057050","5930","19972185","20000000","27815","2024-09"
"150900","파수","54259972800","4800","11304161","11685422","381261","2024-09"
"037030","파워넷","53042851925","2425","21873341","21878974","5633","2024-09"
"047310","파워로직스","183419882550","5010","36610755","36610755","0","2024-09"
"368770","파이버프로","169356085500","5180","32694225","32854225","160000","2024-09"
"170790","파이오링크","53708076360","8040","6680109","6856330","176221","2024-09"
"049120","파인디앤씨","55284435420","1185","46653532","46653532","0","2024-09"
"038950","파인디지털","31983716700","3900","8200953","10210765","2009812","2024-09"
"441270","파인엠텍","239953166970","6490","36972753","36987901","15148","2024-09"
"106240","파인테크닉스","16506736480","1040","15871862","15923057","51195","2024-09"
"131760","파인텍","36004782307","829","43431583","43431583","0","2024-09"
"065690","파커스","14037223941","1053","13330697","14049331","718634","2024-09"
"140860","파크시스템스","1418825499000","204500","6938022","6983609","45587","2024-09"
"091700","파트론","360785541500","7100","50814865","58918214","8103349","2024-09"
"032800","판타지오","37249153971","163","228522417","229785294","1262877","2024-09"
"318010","팜스빌","44127553780","5710","7728118","7929338","201220","2024-09"
"036580","팜스코","75815779940","2165","35018836","36727943","1709107","2024-09"
"027710","팜스토리","144335950605","1305","110602261","111416600","814339","2024-09"
"004720","팜젠사이언스","85332773575","4705","18136615","18178525","41910","2024-09"
"225590","패션플랫폼","22713304334","887","25606882","26636713","1029831","2024-09"
"054300","팬스타엔터프라이즈","32879214998","491","66963778","66985895","22117","2024-09"
"068050","팬엔터테인먼트","58410782640","2160","27042029","27694076","652047","2024-09"
"028670","팬오션","1868320444440","3495","534569512","534569512","0","2024-09"
"222110","팬젠","54676331570","4790","11414683","11414683","0","2024-09"
"271830","팸텍","61698767150","2150","28697101","29490202","793101","2024-09"
"010820","퍼스텍","155503478400","3200","48594837","48771938","177101","2024-09"
"016800","퍼시스","380330460000","42500","8948952","11500000","2551048","2024-09"
"263750","펄어비스","2247950406000","36600","61419410","64247855","2828445","2024-09"
"251970","펌텍코리아","453161008300","36550","12398386","12400000","1614","2024-09"
"001020","페이퍼코리아","139668363370","785","177921482","177983313","61831","2024-09"
"168360","펨트론","148379339480","6970","21288284","21288284","0","2024-09"
"087010","펩트론","1912196838100","92900","20583389","20657350","73961","2024-09"
"090080","평화산업","54847356741","999","54902259","54902259","0","2024-09"
"010770","평화홀딩스","40648814825","2825","14388961","14625466","236505","2024-09"
"064800","포니링크","191090526560","1516","126049160","127807298","1758138","2024-09"
"119500","포메탈","34356972800","2900","11847232","11847232","0","2024-09"
"389140","포바이포","61138320920","5540","11035798","11112735","76937","2024-09"
"105760","포스뱅크","62908900250","6650","9459985","9459985","0","2024-09"
"022100","포스코DX","3947385494000","26000","151822519","152034729","212210","2024-09"
"058430","포스코스틸리온","223449007000","37300","5990590","6000000","9410","2024-09"
"009520","포스코엠텍","650409911580","15620","41639559","41642703","3144","2024-09"
"047050","포스코인터내셔널","8556313247400","50200","170444487","175922788","5478301","2024-09"
"003670","포스코퓨처엠","16997040448000","219500","77435264","77463220","27956","2024-09"
"189690","포시에스","62003616675","2275","27254337","27321969","67632","2024-09"
"318020","포인트모바일","53966400760","4330","12463372","12662272","198900","2024-09"
"256630","포인트엔지니어링","75870456976","1333","56917072","57997072","1080000","2024-09"
"331380","포커스에이치엔에스","78095017160","3505","22281032","22725452","444420","2024-09"
"472850","폰드그룹","207273612570","6410","32335977","32343933","7956","2024-09"
"039980","폴라리스AI","162964982095","2285","71319467","72152777","833310","2024-09"
"041910","폴라리스AI파마","85113640920","6820","12480006","12698263","218257","2024-09"
"234100","폴라리스세원","70247457983","1291","54413213","54413213","0","2024-09"
"041020","폴라리스오피스","235252759855","4735","49683793","49725498","41705","2024-09"
"114630","폴라리스우노","39744229693","523","75992791","77757548","1764757","2024-09"
"290720","푸드나무","40591203250","3250","12489601","13403058","913457","2024-09"
"005670","푸드웰","48178393270","5110","9428257","10000000","571743","2024-09"
"094940","푸른기술","48931101970","6190","7904863","8361386","456523","2024-09"
"057880","푸른소나무","215672327790","8790","24536101","24580368","44267","2024-09"
"007330","푸른저축은행","102416368800","8740","11718120","15082800","3364680","2024-09"
"017810","풀무원","384116159100","10420","36863355","38120542","1257187","2024-09"
"093380","풍강","27709961580","2890","9588222","9879313","291091","2024-08"
"023900","풍국주정","127764000000","10140","12600000","12600000","0","2024-09"
"103140","풍산","1969359443800","72100","27314278","28024278","710000","2024-09"
"005810","풍산홀딩스","399108756000","28500","14003816","14417292","413476","2024-09"
"371950","풍원정밀","229762128960","10920","21040488","21040488","0","2024-09"
"370090","퓨런티어","119372899700","14590","8181830","8181830","0","2024-09"
"445180","퓨릿","107825878840","6430","16769188","16769188","0","2024-09"
"151910","퓨처코어","121645902080","640","190071722","190071722","0","2024-09"
"220100","퓨쳐켐","612084905600","27700","22096928","22102155","5227","2024-09"
"035200","프럼파스트","23319719540","2755","8464508","9730590","1266082","2024-09"
"334970","프레스티지바이오로직스","435430400520","7080","61501469","61501469","0","2024-09"
"321260","프로이천","60753874215","2155","28192053","28192084","31","2024-09"
"053610","프로텍","284850000000","31650","9000000","11000000","2000000","2024-09"
"303360","프로티아","37021993125","2875","12877215","12877215","0","2024-09"
"377220","프롬바이오","59309450000","2095","28310000","28310000","0","2024-09"
"335810","프리시젼바이오","40418550480","3480","11614526","11614526","0","2024-09"
"053160","프리엠스","67907196280","12670","5359684","6000000","640316","2024-09"
"405000","플라즈맵","49806772040","1910","26076844","26076844","0","2024-09"
"041590","플래스크","103917099150","789","131707350","131707350","0","2024-09"
"367000","플래티어","38570275240","4760","8102999","8388207","285208","2024-09"
"075130","플랜티넷","31295181420","2010","15569742","16622320","1052578","2024-09"
"009810","플레이그램","53157259750","350","151877885","151887500","9615","2024-09"
"237820","플레이디","75423583200","5880","12827140","12827140","0","2024-09"
"023770","플레이위드","36163132500","4125","8766820","8766820","0","2024-09"
"019570","플루토스","20828516866","397","52464778","52470042","5264","2024-09"
"300080","플리토","87949840000","16000","5496865","5501817","4952","2024-09"
"033790","피노","189568380000","8350","22702800","22822800","120000","2024-09"
"032580","피델릭스","49307337133","1489","33114397","33132064","17667","2024-09"
"051380","피씨디렉트","41097832540","2780","14783393","15340072","556679","2024-09"
"241820","피씨엘","63905724360","1080","59171967","59171967","0","2024-09"
"237750","피앤씨테크","30014292000","4620","6496600","6496600","0","2024-09"
"460940","피앤에스미캐닉스","79602402000","12300","6471740","6471740","0","2024-09"
"319660","피에스케이","596714308400","20600","28966714","28966714","0","2024-09"
"031980","피에스케이홀딩스","1026370002000","47600","21562395","21562395","0","2024-09"
"002230","피에스텍","59833007100","3620","16528455","19370673","2842218","2024-09"
"043370","피에이치에이","195332130000","10000","19533213","21000000","1466787","2024-09"
"239890","피엔에이치테크","70543860500","7100","9935755","9935755","0","2024-09"
"347740","피엔케이피부임상연구센타","69460707355","2405","28881791","30010576","1128785","2024-09"
"137400","피엔티","1176315201600","50600","23247336","23743086","495750","2024-09"
"257370","피엔티엠에스","62285705430","5070","12285149","12504861","219712","2024-09"
"147760","피엠티","36517047750","3375","10819866","10819866","0","2024-09"
"128660","피제이메탈","80734966095","3255","24803369","24803369","0","2024-09"
"006140","피제이전자","76257450000","5130","14865000","15000000","135000","2024-09"
"376180","피코그램","63835431660","3470","18396378","18491378","95000","2024-09"
"304840","피플바이오","77291196150","3675","21031618","21089464","57846","2024-09"
"087600","픽셀플러스","44777359710","6910","6480081","8166558","1686477","2024-09"
"291810","핀텔","22829001120","2010","11357712","11357712","0","2024-09"
"378340","필에너지","331208323920","15560","21285882","21285882","0","2024-09"
"161580","필옵틱스","493412688000","21600","22843180","22843180","0","2024-09"
"347770","핌스","52799767020","2310","22857042","22857042","0","2024-09"
"163730","핑거","103533759630","11270","9186669","9360608","173939","2024-09"
"417180","핑거스토리","45277574875","2705","16738475","16739405","930","2024-09"
"446750","하나26호스팩","12843900000","2130","6030000","6030000","0","2024-09"
"448370","하나27호스팩","11970600000","2130","5620000","5620000","0","2024-09"
"454750","하나28호스팩","14944150000","2075","7202000","7202000","0","2024-09"
"454640","하나29호스팩","11477125000","2125","5401000","5401000","0","2024-09"
"469880","하나30호스팩","14975250000","2050","7305000","7305000","0","2024-09"
"469900","하나31호스팩","11602350000","2070","5605000","5605000","0","2024-09"
"475240","하나32호스팩","6864000000","2145","3200000","3200000","0","2024-09"
"475250","하나33호스팩","7862500000","2125","3700000","3700000","0","2024-09"
"406760","하나금융21호스팩","15412800000","2080","7410000","7410000","0","2024-09"
"418170","하나금융22호스팩","13642700000","2270","6010000","6010000","0","2024-09"
"435620","하나금융25호스팩","44697780000","10390","4302000","4302000","0","2024-09"
"086790","하나금융지주","17944921465200","64600","277785162","287240880","9455718","2024-09"
"299030","하나기술","215862570000","27000","7994910","7994910","0","2024-09"
"067310","하나마이크론","689006510080","10480","65744896","65744896","0","2024-09"
"166090","하나머티리얼즈","560278677500","28750","19487954","19777674","289720","2024-09"
"293480","하나제약","188045412820","10870","17299486","17772946","473460","2024-09"
"039130","하나투어","752036198600","48550","15489932","16039185","549253","2024-09"
"136480","하림","299447853240","2820","106187182","106209702","22520","2024-09"
"003380","하림지주","499922470340","5140","97261181","112005621","14744440","2024-09"
"450330","하스","64333633890","8210","7836009","7836009","0","2024-09"
"101670","하이드로리튬","84661142280","1716","49336330","51086330","1750000","2024-09"
"365590","하이딥","125822040632","872","144291331","144447309","155978","2024-09"
"149980","하이로닉","112790643750","6750","16709725","18594363","1884638","2024-09"
"013030","하이록코리아","281995589500","23300","12102815","12856050","753235","2024-09"
"352820","하이브","8134411012000","196000","41502097","41652097","150000","2024-09"
"126700","하이비젼시스템","209774430880","16480","12729031","14942112","2213081","2024-09"
"106080","하이소닉","96608964260","6140","15734359","15735465","1106","2024-09"
"071090","하이스틸","63679103405","3155","20183551","20191471","7920","2024-09"
"450050","하이제8호스팩","10479260000","2090","5014000","5014000","0","2024-09"
"160190","하이젠알앤엠","219757440000","7880","27888000","30888000","3000000","2024-09"
"221840","하이즈항공","34895246826","1866","18700561","18700561","0","2024-09"
"106190","하이텍팜","165868528800","15600","10632598","10633173","575","2024-09"
"019490","하이트론","93843640625","3125","30029965","30044269","14304","2024-09"
"000080","하이트진로","1371615551460","19980","68649427","70133611","1484184","2024-09"
"000140","하이트진로홀딩스","195075441990","9130","21366423","23206765","1840342","2024-09"
"065650","하이퍼코퍼레이션","140914780650","1323","106511550","106681728","170178","2024-09"
"066130","하츠","62304969090","5190","12004811","12800000","795189","2024-09"
"004590","한국가구","55125000000","3675","15000000","15000000","0","2024-09"
"036460","한국가스공사","3547746392100","40650","87275434","92313000","5037566","2024-09"
"039340","한국경제TV","113131704560","5320","21265358","23000000","1734642","2024-09"
"005430","한국공항","169424889400","55400","3058211","3166355","108144","2024-09"
"071050","한국금융지주","4166342527000","79000","52738513","55725992","2987479","2024-09"
"034950","한국기업평가","380066209200","85200","4460871","4540514","79643","2024-09"
"010040","한국내화","77607253380","2190","35437102","41067062","5629960","2024-09"
"025540","한국단자","760215500000","73700","10315000","10415000","100000","2024-09"
"222980","한국맥널티","41817221600","3850","10861616","11031483","169867","2024-09"
"010100","한국무브넥스","110078268300","3615","30450420","30450420","0","2024-09"
"256840","한국비엔씨","330559656200","4975","66444152","67912443","1468291","2024-09"
"219750","한국비티비","63245329550","967","65403650","65426885","23235","2024-09"
"004090","한국석유","221929514310","17610","12602471","12694120","91649","2024-09"
"025550","한국선재","62054633520","2805","22122864","23300000","1177136","2024-09"
"002200","한국수출포장","97751095710","2630","37167717","40000000","2832283","2024-09"
"002960","한국쉘석유","418600000000","322000","1300000","1300000","0","2024-09"
"017890","한국알콜","187077590370","9090","20580593","21605760","1025167","2024-09"
"000240","한국앤컴퍼니","1540117021440","16260","94718144","94935240","217096","2024-09"
"080720","한국유니온제약","15410411825","2725","5655197","7912828","2257631","2024-09"
"123890","한국자산신탁","359147306425","2935","122367055","123977752","1610697","2024-09"
"015760","한국전력","13994816878600","21800","641964077","641964077","0","2024-09"
"063570","한국전자금융","155291484160","5120","30330368","34147728","3817360","2024-09"
"041460","한국전자인증","64731622500","3420","18927375","19000000","72625","2024-09"
"006200","한국전자홀딩스","32409500493","739","43855887","46803136","2947249","2024-09"
"101680","한국정밀기계","20292687135","2415","8402769","8404000","1231","2024-09"
"039740","한국정보공학","21248752050","2650","8018397","8018397","0","2024-09"
"053300","한국정보인증","158538857980","3860","41072243","42441361","1369118","2024-09"
"025770","한국정보통신","284593485270","7970","35708091","37444271","1736180","2024-09"
"458610","한국제12호스팩","9242550000","2185","4230000","4230000","0","2024-09"
"464440","한국제13호스팩","9331200000","2160","4320000","4320000","0","2024-09"
"477530","한국제14호스팩","10942750000","2275","4810000","4810000","0","2024-09"
"479880","한국제15호스팩","13980450000","2035","6870000","6870000","0","2024-09"
"027970","한국제지","192052227200","1010","190150720","190178237","27517","2024-09"
"023350","한국종합기술","45361069400","4360","10403915","10950000","546085","2024-09"
"025890","한국주강","22122062760","1985","11144616","11309259","164643","2024-09"
"000970","한국주철관","138315537100","6430","21510970","22800500","1289530","2024-09"
"104700","한국철강","268155565260","7820","34290993","42450000","8159007","2024-09"
"062970","한국첨단소재","18759845509","1901","9868409","9868409","0","2024-09"
"017960","한국카본","534012544100","10850","49217746","51908452","2690706","2024-09"
"023760","한국캐피탈","178262127750","570","312740575","315609576","2869001","2024-09"
"054040","한국컴퓨터","66149162040","4890","13527436","16071290","2543854","2024-09"
"161890","한국콜마","1657076405400","70200","23605077","23605077","0","2024-09"
"021650","한국큐빅","39893968495","2455","16250089","16350563","100474","2024-09"
"161390","한국타이어앤테크놀로지","4458688922150","36550","121988753","123875069","1886316","2024-09"
"034830","한국토지신탁","225357795258","1046","215447223","252489230","37042007","2024-09"
"007280","한국특강","94503885294","1554","60813311","60813311","0","2024-09"
"032300","한국파마","218679355050","20050","10906701","10906701","0","2024-09"
"037230","한국팩키지","59153649095","1985","29800327","29800327","0","2024-09"
"047810","한국항공우주","5517091056200","56600","97475107","97475107","0","2024-09"
"123690","한국화장품","106524680730","6630","16067071","16068000","929","2024-09"
"003350","한국화장품제조","288188056500","79500","3625007","4532000","906993","2024-09"
"030520","한글과컴퓨터","414472571100","17220","24069255","24179744","110489","2024-09"
"052600","한네트","45965707500","3975","11563700","11563700","0","2024-09"
"011500","한농화성","285233473000","18650","15294020","15637042","343022","2024-09"
"002390","한독","208655160280","15160","13763533","13763533","0","2024-09"
"256150","한독크린텍","54727839970","7030","7784899","8395000","610101","2024-09"
"092460","한라IMS","104272678400","6380","16343680","17109680","766000","2024-09"
"053690","한미글로벌","144029148000","14160","10171550","10957550","786000","2024-09"
"042700","한미반도체","9452828517600","98800","95676402","96993634","1317232","2024-09"
"008930","한미사이언스","2278566206900","33650","67713706","68391550","677844","2024-09"
"128940","한미약품","4222511262000","333000","12680214","12810991","130777","2024-09"
"452190","한빛레이저","107582329405","4645","23160889","23162757","1868","2024-09"
"047080","한빛소프트","33510188700","1350","24822362","24822362","0","2024-09"
"009240","한샘","859896679600","51800","16600322","23533928","6933606","2024-09"
"452280","한선엔지니어링","158123250000","9300","17002500","17002500","0","2024-09"
"020000","한섬","343631904000","16000","21476994","23398500","1921506","2024-09"
"003680","한성기업","28635638850","5070","5648055","6209515","561460","2024-09"
"066980","한성크린텍","104383822500","2010","51932250","51935125","2875","2024-09"
"105630","한세실업","614372288400","15600","39382839","40000000","617161","2024-09"
"069640","한세엠케이","41841524125","1525","27437065","30106502","2669437","2024-09"
"016450","한세예스24홀딩스","199150243890","5070","39280127","40000000","719873","2024-09"
"010420","한솔PNS","21538155612","1051","20493012","20493012","0","2024-09"
"009180","한솔로지스틱스","63113251500","2250","28050334","28057025","6691","2024-09"
"114810","한솔아이원스","191225363160","6920","27633723","29113174","1479451","2024-09"
"070590","한솔인티큐브","16190034060","1185","13662476","13879521","217045","2024-09"
"213500","한솔제지","222551484480","9360","23776868","23800576","23708","2024-09"
"014680","한솔케미칼","1432768648000","126400","11335195","11335195","0","2024-09"
"004710","한솔테크닉스","137137461705","4365","31417517","32109878","692361","2024-09"
"004150","한솔홀딩스","94976622985","2315","41026619","42008577","981958","2024-09"
"025750","한솔홈데코","57201255790","710","80565149","80565149","0","2024-09"
"226440","한송네오텍","100580954580","1530","65739186","65739186","0","2024-09"
"042520","한스바이오메드","119480206800","9200","12986979","13526367","539388","2024-09"
"004960","한신공영","79259308700","6850","11570702","11570702","0","2024-09"
"011700","한신기계","114505374540","3540","32346151","32446151","100000","2024-09"
"430690","한싹","51807170520","4755","10895304","10895327","23","2024-09"
"078350","한양디지텍","171374360850","11550","14837607","15244382","406775","2024-09"
"045100","한양이엔지","281870217780","16790","16787982","18000000","1212018","2024-09"
"001750","한양증권","156560968200","12300","12728534","12728534","0","2024-09"
"018880","한온시스템","2038613402600","3820","533668430","533800000","131570","2024-09"
"009420","한올바이오파마","2525371944000","49800","50710280","52240638","1530358","2024-09"
"320000","한울반도체","79841853665","2855","27965623","27965627","4","2024-09"
"091440","한울소재과학","72929828100","5190","14051990","14606671","554681","2024-09"
"014130","한익스프레스","40533000000","3435","11800000","12000000","200000","2024-09"
"024740","한일단조","92292782160","2955","31232752","31532546","299794","2024-09"
"005860","한일사료","164313366450","4170","39403685","39403685","0","2024-09"
"300720","한일시멘트","978665560200","14130","69261540","69261540","0","2024-09"
"002220","한일철강","48951017400","2010","24353740","26697460","2343720","2024-09"
"006390","한일현대시멘트","264982383120","13710","19327672","19327672","0","2024-09"
"003300","한일홀딩스","411599777400","13350","30831444","30832884","1440","2024-09"
"007770","한일화학","42400800000","12080","3510000","3510000","0","2024-09"
"051600","한전KPS","2018250000000","44850","45000000","45000000","0","2024-09"
"052690","한전기술","2731523659000","71800","38043505","38220000","176495","2024-09"
"130660","한전산업","445642000000","13670","32600000","32600000","0","2024-09"
"198940","한주라이트메탈","38101650092","979","38918948","38922978","4030","2024-09"
"058450","한주에이알티","34292943250","2375","14439134","14452469","13335","2024-09"
"107640","한중엔시에스","359747629200","40200","8948946","8948946","0","2024-09"
"002320","한진","281860541960","19480","14469227","14947628","478401","2024-09"
"003480","한진중공업홀딩스","89617446240","3435","26089504","29529812","3440308","2024-09"
"180640","한진칼","6174600450900","93100","66322239","66762279","440040","2024-09"
"005110","한창","22551214950","1254","17983425","18606407","622982","2024-09"
"079170","한창산업","40324806600","7800","5169847","5200000","30153","2024-09"
"009460","한창제지","44392609584","744","59667486","59667486","0","2024-09"
"372910","한컴라이프케어","113465064600","4100","27674406","27674406","0","2024-09"
"054920","한컴위드","61325781045","2465","24878613","28217081","3338468","2024-09"
"457370","한켐","183018541200","22800","8027129","8027134","5","2024-09"
"002680","한탑","21556675305","695","31016799","32316799","1300000","2024-09"
"000880","한화","1932122491200","27850","69376032","74958735","5582703","2024-09"
"452260","한화갤러리아","256173496738","1322","193777229","193859610","82381","2024-09"
"088350","한화생명","2182788676250","2905","751390250","868530000","117139750","2024-09"
"000370","한화손해보험","571164904440","4940","115620426","116738915","1118489","2024-09"
"009830","한화솔루션","3471639719500","20500","169348279","171892536","2544257","2024-09"
"272210","한화시스템","3608969937300","19300","186993261","188919389","1926128","2024-09"
"012450","한화에어로스페이스","17527354254000","385500","45466548","45581161","114613","2024-09"
"082740","한화엔진","1326466006500","15900","83425535","83447142","21607","2024-09"
"042660","한화오션","9345114203500","30500","306397187","306413394","16207","2024-09"
"489790","한화인더스트리얼솔루션즈","1858931299800","36900","50377542","50488390","110848","2024-09"
"003530","한화투자증권","747477006060","3495","213870388","214547775","677387","2024-09"
"430460","한화플러스제3호스팩","12491200000","2110","5920000","5920000","0","2024-09"
"455310","한화플러스제4호스팩","10676600000","2110","5060000","5060000","0","2024-09"
"195870","해성디에스","481950000000","28350","17000000","17000000","0","2024-09"
"034810","해성산업","203586404400","6870","29634120","32556857","2922737","2024-09"
"059270","해성에어로보틱스","64728042190","5810","11140799","11140799","0","2024-09"
"076610","해성옵틱스","28980096180","1140","25421137","25453198","32061","2024-09"
"101530","해태제과식품","146907847480","5540","26517662","29116822","2599160","2024-09"
"220180","핸디소프트","59776640000","3080","19408000","19408000","0","2024-09"
"143210","핸즈코퍼레이션","42299611440","1968","21493705","21875747","382042","2024-09"
"214180","헥토이노베이션","153471551200","12400","12376738","13257185","880447","2024-09"
"234340","헥토파이낸셜","136781842840","16460","8309954","9453000","1143046","2024-09"
"084990","헬릭스미스","171064188920","3715","46046888","46092797","45909","2024-09"
"187660","현대ADM","82390658455","3895","21152929","21836250","683321","2024-09"
"000720","현대건설","3251588338000","29200","111355765","111355765","0","2024-09"
"170030","현대공업","79787354360","5320","14997623","15340000","342377","2024-09"
"453340","현대그린푸드","390297245050","11530","33850585","33880914","30329","2024-09"
"086280","현대글로비스","9045000000000","120600","75000000","75000000","0","2024-09"
"064350","현대로템","7214305567300","66100","109142293","109142293","0","2024-09"
"079430","현대리바트","159505621860","7930","20114202","20535282","421080","2024-09"
"012330","현대모비스","22277139142500","247500","90008643","92995094","2986451","2024-09"
"319400","현대무벡스","373694654180","3205","116597396","117741058","1143662","2024-09"
"048410","현대바이오","686485628480","17240","39819352","39821608","2256","2024-09"
"052260","현대바이오랜드","162300000000","5410","30000000","30000000","0","2024-09"
"069960","현대백화점","1006431315300","46050","21855186","23402441","1547255","2024-09"
"004560","현대비앤지스틸","189088289940","12540","15078811","15078811","0","2024-09"
"016790","현대사료","187340898626","994","188471729","188471729","0","2024-09"
"004310","현대약품","108332468210","4145","26135698","32000000","5864302","2024-08"
"041440","현대에버다임","137202765280","7690","17841712","17915944","74232","2024-09"
"039010","현대에이치티","45604030000","5870","7769000","8625000","856000","2024-09"
"017800","현대엘리베이","1595843740400","44200","36105062","39092385","2987323","2024-09"
"307950","현대오토에버","3713089906400","135400","27423116","27423982","866","2024-09"
"011210","현대위아","1273667471400","47800","26645763","27195083","549320","2024-09"
"090850","현대이지웰","117900682365","4965","23746361","23746361","0","2024-09"
"004020","현대제철","3512271231300","26700","131545739","133445785","1900046","2024-09"
"005440","현대지에프홀딩스","681301795370","4370","155904301","155904301","0","2024-09"
"005380","현대차","47799514094500","234500","203835881","209416191","5580310","2024-09"
"001500","현대차증권","283510304280","8940","31712562","31712562","0","2024-09"
"011760","현대코퍼레이션","218719690860","18210","12010966","13228966","1218000","2024-09"
"227840","현대코퍼레이션홀딩스","93157162560","10560","8821701","9100836","279135","2024-09"
"126560","현대퓨처넷","429047317725","3895","110153355","110202945","49590","2024-09"
"001450","현대해상","2375959350000","30300","78414500","89400000","10985500","2024-09"
"057050","현대홈쇼핑","539189025000","47100","11447750","12000000","552250","2024-09"
"460930","현대힘스","354752064840","10040","35333871","35333871","0","2024-09"
"092300","현우산업","53428959880","2920","18297589","18672816","375227","2024-09"
"138360","협진","40054748234","829","48316946","48348248","31302","2024-09"
"011080","형지I&C","15578176367","611","25496197","25503364","7167","2024-09"
"093240","형지엘리트","46557380375","1375","33859913","34164255","304342","2024-09"
"003010","혜인","53096715620","4940","10748323","12712747","1964424","2024-09"
"111110","호전실업","74396696960","8080","9207512","9749984","542472","2024-09"
"008770","호텔신라","1642255604250","44250","37113121","39248121","2135000","2024-09"
"060560","홈센타홀딩스","100917306360","795","126940008","127669525","729517","2024-09"
"064240","홈캐스트","92945815225","2705","34360745","35038012","677267","2024-09"
"039610","화성밸브","104416312000","10030","10410400","10410400","0","2024-09"
"378850","화승알앤에이","74633788980","3930","18990786","18993623","2837","2024-09"
"241590","화승엔터프라이즈","524703130160","8660","60589276","60589276","0","2024-09"
"006060","화승인더","202325113870","4090","49468243","55320000","5851757","2024-09"
"013520","화승코퍼레이션","83925907380","1890","44405242","50051252","5646010","2024-09"
"010690","화신","329762705090","9490","34748441","34920410","171969","2024-09"
"126640","화신정공","46554248480","1328","35055910","36373887","1317977","2024-09"
"133820","화인베스틸","26849548778","871","30826118","30826118","0","2024-09"
"127980","화인써키트","79088755120","6680","11839634","11840684","1050","2024-09"
"061250","화일약품","104576325756","1403","74537652","76877652","2340000","2024-09"
"010660","화천기계","60500000000","2750","22000000","22000000","0","2024-09"
"000850","화천기공","60170000000","27350","2200000","2200000","0","2024-09"
"016580","환인제약","203968055200","13360","15267070","18600070","3333000","2024-09"
"032560","황금에스티","89360993320","5260","16988782","17000000","11218","2024-09"
"004800","효성","839259864800","50200","16718324","16740407","22083","2024-09"
"094280","효성ITX","136765342350","12390","11038365","11558200","519835","2024-09"
"097870","효성오앤비","48760200000","6180","7890000","8490000","600000","2024-09"
"298040","효성중공업","3636234860500","390500","9311741","9324548","12807","2024-09"
"298020","효성티앤씨","1320601140000","306000","4315690","4327682","11992","2024-09"
"298000","효성화학","150045356000","39700","3779480","3791811","12331","2024-09"
"093370","후성","637096101840","5940","107255236","107255330","94","2024-09"
"081660","휠라홀딩스","2422541411400","40700","59521902","60095839","573937","2024-09"
"290270","휴네시온","33942543540","3660","9273919","9607672","333753","2024-09"
"005870","휴니드","107996542500","8250","13090490","14116015","1025525","2024-09"
"353190","휴럼","31777649763","807","39377509","39378420","911","2024-09"
"192410","휴림네트웍스","34556009400","2430","14220580","14235530","14950","2024-09"
"090710","휴림로봇","125684139976","1147","109576408","109623165","46757","2024-09"
"078590","휴림에이텍","30339902230","565","53698942","54210339","511397","2024-09"
"205470","휴마시스","172106990640","1521","113153840","129375009","16221169","2024-09"
"115160","휴맥스","73435783369","1703","43121423","43970124","848701","2024-09"
"028080","휴맥스홀딩스","32535812840","2980","10918058","12577506","1659448","2024-09"
"175140","휴먼테크놀로지","103488554520","4810","21515292","21515292","0","2024-09"
"200670","휴메딕스","316993109250","30750","10308719","11229930","921211","2024-09"
"079980","휴비스","90174276800","2740","32910320","34500000","1589680","2024-09"
"065510","휴비츠","96704486550","8890","10877895","12159371","1281476","2024-09"
"215090","휴센텍","149904424845","1505","99604269","99649272","45003","2024-09"
"005010","휴스틸","224752300000","4000","56188075","56188075","0","2024-09"
"263920","휴엠앤씨","49584630474","1011","49045134","49045134","0","2024-09"
"243070","휴온스","336014471900","28450","11810702","11979665","168963","2024-09"
"084110","휴온스글로벌","467732445850","38450","12164693","12621492","456799","2024-09"
"145020","휴젤","3074282549000","279500","10999222","12604033","1604811","2024-09"
"024060","흥구석유","265515318420","18260","14540817","15000000","459183","2024-09"
"010240","흥국","54744591720","4945","11070696","12322696","1252000","2024-09"
"189980","흥국에프엔비","67829261991","1753","38693247","40137827","1444580","2024-09"
"000540","흥국화재","216818926875","3375","64242645","64242645","0","2024-09"
"003280","흥아해운","476685446528","1984","240264842","240424899","160057","2024-09"
"037440","희림","58514650200","4635","12624520","13922475","1297955","2024-09"
"238490","힘스","48118239900","4335","11099940","11312236","212296","2024-09"