종목코드,종목명,자기주식 제외 시가총액(A*B),종가,자기주식 제외 발행주식수(B=C-D),총발행주식수(C),자기주식수(D),자기주식수 반영시점
"060310","3S","106766901780","2090","51084642","51084642","0","2024-09"
"095570","AJ네트웍스","215252550500","4810","44751050","45252759","501709","2024-09"
"006840","AK홀딩스","167504155800","12840","13045495","13247561","202066","2024-09"
"054620","APS","112832247240","6210","18169444","19894221","1724777","2024-09"
"265520","AP시스템","259998519540","17310","15020134","15281421","261287","2024-09"
"211270","AP위성","144608915760","10160","14233161","15082304","849143","2024-09"
"109960","AP헬스케어","61966030017","543","114117919","114153169","35250","2024-09"
"139050","BF랩스","24234697905","2805","8639821","8644551","4730","2024-09"
"027410","BGF","344073013770","3595","95708766","95716791","8025","2024-09"
"282330","BGF리테일","2009084244500","116300","17275015","17283906","8891","2024-09"
"126600","BGF에코머티리얼즈","209303796000","3380","61924200","62766899","842699","2024-09"
"138930","BNK금융지주","3037378771260","9540","318383519","320436727","2053208","2024-09"
"001460","BYC","204460542500","32750","6243070","6246150","3080","2024-09"
"013720","CBI","48092782296","1079","44571624","44628136","56512","2024-09"
"083790","CG인바이츠","188006274990","2445","76894182","76894182","0","2024-09"
"001040","CJ","2803255938000","103600","27058455","29176998","2118543","2024-09"
"079160","CJ CGV","933871216920","5640","165580003","165580003","0","2024-09"
"035760","CJ ENM","1283163416100","61900","20729619","21929154","1199535","2024-09"
"311690","CJ 바이오사이언스","104793773000","11500","9112502","9112502","0","2024-09"
"000120","CJ대한통운","1805034174500","90500","19945129","22812344","2867215","2024-09"
"011150","CJ씨푸드","111026088570","3090","35930773","35930773","0","2024-09"
"097950","CJ제일제당","4026944846000","274000","14696879","15054186","357307","2024-09"
"051500","CJ프레시웨이","214638274880","18080","11871586","11871586","0","2024-09"
"058820","CMG제약","290979251180","2095","138892244","138892244","0","2024-09"
"023460","CNH","7646357848","232","32958439","37200000","4241561","2024-09"
"056730","CNT85","57581279246","827","69626698","74111186","4484488","2024-09"
"000480","CR홀딩스","233512084320","5660","41256552","46890490","5633938","2024-09"
"065770","CS","19158785310","987","19411130","19411130","0","2024-09"
"083660","CSA 코스믹","47690207670","805","59242494","61247181","2004687","2024-09"
"000590","CS홀딩스","72156130200","69300","1041214","1154482","113268","2024-09"
"012030","DB","307368127597","1609","191030533","201173933","10143400","2024-09"
"456440","DB금융스팩11호","12091625000","2275","5315000","5315000","0","2024-09"
"477760","DB금융스팩12호","12176400000","2085","5840000","5840000","0","2024-09"
"016610","DB금융투자","217907581150","5350","40730389","42446389","1716000","2024-09"
"005830","DB손해보험","6604781590000","110000","60043469","70800000","10756531","2024-09"
"000990","DB하이텍","1499388679950","36050","41591919","44398588","2806669","2024-09"
"139130","DGB금융지주","1359429437440","8170","166392832","169145833","2753001","2024-09"
"099520","DGI","58000622016","1284","45171824","45281824","110000","2024-09"
"060900","DGP","30304305600","1200","25253588","25258229","4641","2024-09"
"290120","DH오토리드","40261783110","2595","15515138","15515138","0","2024-09"
"025440","DH오토웨어","36167937025","235","153906115","153906120","5","2024-09"
"001530","DI동일","728342794400","37600","19370819","25215672","5844853","2024-09"
"000210","DL","851880588900","40700","20930727","20955884","25157","2024-09"
"375500","DL이앤씨","1174982572400","30550","38460968","38693623","232655","2024-09"
"068790","DMS","127058198400","5400","23529296","24573061","1043765","2024-09"
"007340","DN오토모티브","885135744450","17610","50263245","59065865","8802620","2024-09"
"004840","DRB동일","86821999820","4505","19272364","19930000","657636","2024-09"
"241520","DSC인베스트먼트","74131848000","2835","26148800","27496125","1347325","2024-09"
"155660","DSR","60880000000","3805","16000000","16000000","0","2024-09"
"069730","DSR제강","50760000000","3525","14400000","14400000","0","2024-09"
"017860","DS단석","390369506400","66600","5861404","5861404","0","2024-09"
"180400","DXVX","117878776920","2395","49218696","49219432","736","2024-09"
"017940","E1","436522200500","75500","5781751","6860000","1078249","2024-09"
"245620","EDGC","57441040175","415","138412145","138493951","81806","2024-09"
"037370","EG","60547303440","7020","8624972","8624972","0","2024-09"
"050120","ES큐브","23613810641","1763","13394107","13564086","169979","2024-09"
"383220","F&F","2288133776500","60500","37820393","38307075","486682","2024-09"
"007700","F&F홀딩스","511424899370","13090","39069893","39114367","44474","2024-09"
"214270","FSN","73975718650","2225","33247514","33250463","2949","2024-09"
"130500","GH신소재","43853274495","3015","14545033","14545052","19","2024-09"
"114090","GKL","668659792700","10810","61855670","61855670","0","2024-09"
"078930","GS","3906255564750","42050","92895495","92915378","19883","2024-09"
"083450","GST","283851717800","15260","18601030","18618260","17230","2024-09"
"006360","GS건설","1553466778500","18300","84888895","85581490","692595","2024-09"
"001250","GS글로벌","273884070640","3320","82495202","82533764","38562","2024-09"
"007070","GS리테일","2182547201600","21100","103438256","104717922","1279666","2024-09"
"297890","HB솔루션","272084200080","3720","73140914","73140914","0","2024-09"
"440290","HB인베스트먼트","50906964780","1878","27107010","27107010","0","2024-09"
"078150","HB테크놀러지","203921348310","2295","88854618","92715916","3861298","2024-09"
"012630","HDC","547839296700","10950","50030986","59741721","9710735","2024-09"
"039570","HDC랩스","182416362820","7940","22974353","25957601","2983248","2024-09"
"089470","HDC현대EP","100957866385","3895","25919863","31900000","5980137","2024-09"
"294870","HDC현대산업개발","1321888198000","20600","64169330","65907330","1738000","2024-09"
"009540","HD한국조선해양","13845924554000","195800","70714630","70773116","58486","2024-09"
"267250","HD현대","5794811260000","82000","70668430","78993085","8324655","2024-09"
"267270","HD현대건설기계","920179206900","52100","17661789","18305586","643797","2024-09"
"443060","HD현대마린솔루션","5627370000000","126600","44450000","44450000","0","2024-09"
"071970","HD현대마린엔진","712350933000","21000","33921473","33921495","22","2024-09"
"010620","HD현대미포","4339411622400","108800","39884298","39942149","57851","2024-09"
"322000","HD현대에너지솔루션","258160000000","23050","11200000","11200000","0","2024-09"
"042670","HD현대인프라코어","1434803188400","7450","192591032","192655867","64835","2024-09"
"267260","HD현대일렉트릭","12309504768000","342000","35992704","36047135","54431","2024-09"
"329180","HD현대중공업","17550445033200","197700","88773116","88773116","0","2024-09"
"097230","HJ중공업","186937423300","2245","83268340","83274281","5941","2024-09"
"195940","HK이노엔","1320172920600","46600","28329891","28329891","0","2024-09"
"014790","HL D&I","94078623485","2485","37858601","37858601","0","2024-09"
"028300","HLB","8572064648000","65500","130871216","131127236","256020","2024-09"
"003580","HLB글로벌","189697505345","3995","47483731","47489591","5860","2024-09"
"278650","HLB바이오스텝","182283305130","2165","84195522","86730589","2535067","2024-09"
"067630","HLB생명과학","1037831821250","8750","118609351","118679271","69920","2024-09"
"024850","HLB이노베이션","353930666720","3880","91219244","91226268","7024","2024-09"
"047920","HLB제약","618180588720","19440","31799413","31799994","581","2024-09"
"115450","HLB테라퓨틱스","719025363370","9010","79803037","80139933","336896","2024-09"
"046210","HLB파나진","122881929100","2900","42373079","42373079","0","2024-09"
"204320","HL만도","1864197664000","39700","46957120","46957120","0","2024-09"
"060980","HL홀딩스","339564975750","35750","9498321","10169410","671089","2024-09"
"011200","HMM","12771123406800","17050","749039496","749039496","0","2024-09"
"403870","HPSP","2450515228200","30600","80082197","82934144","2851947","2024-09"
"036640","HRS","83105178000","5200","15981765","16354800","373035","2024-09"
"035000","HS애드","103890998040","6410","16207644","16567409","359765","2024-09"
"002460","HS화성","84709324550","8950","9464729","10150000","685271","2024-09"
"487570","HS효성","148434391350","40050","3706227","3725927","19700","2024-09"
"298050","HS효성첨단소재","1148281654000","257000","4468022","4479948","11926","2024-09"
"439730","IBKS제20호스팩","9460450000","2195","4310000","4310000","0","2024-09"
"442770","IBKS제21호스팩","9262000000","2200","4210000","4210000","0","2024-09"
"448760","IBKS제22호스팩","9701700000","2190","4430000","4430000","0","2024-09"
"467930","IBKS제23호스팩","9263700000","2190","4230000","4230000","0","2024-09"
"469480","IBKS제24호스팩","9284850000","2195","4230000","4230000","0","2024-09"
"003560","IHQ","63618682920","10760","5912517","5994566","82049","2024-09"
"095340","ISC","1246269292800","60900","20464192","21197058","732866","2024-09"
"175330","JB금융지주","3373173755220","17590","191766558","195083198","3316640","2024-09"
"234080","JW생명과학","169865557380","10970","15484554","15834554","350000","2024-09"
"067290","JW신약","70817412721","1397","50692493","50841502","149009","2024-09"
"001060","JW중외제약","641340620100","27900","22987119","23285930","298811","2024-09"
"096760","JW홀딩스","214771293920","2980","72070904","73924942","1854038","2024-09"
"035900","JYP Ent.","1696412620800","51200","33133059","35532492","2399433","2024-09"
"318000","KBG","48803415210","5610","8699361","8740223","40862","2024-09"
"024840","KBI메탈","94062818700","2700","34838081","34909199","71118","2024-09"
"105560","KB금융","35156502308000","93200","377215690","393528423","16312733","2024-09"
"024120","KB오토시스","41917500000","3645","11500000","11500000","0","2024-09"
"455250","KB제25호스팩","11365200000","2640","4305000","4305000","0","2024-09"
"458320","KB제26호스팩","12689025000","2305","5505000","5505000","0","2024-09"
"464680","KB제27호스팩","25758380000","1996","12905000","12905000","0","2024-09"
"476470","KB제28호스팩","11560500000","2100","5505000","5505000","0","2024-09"
"478390","KB제29호스팩","12813200000","2060","6220000","6220000","0","2024-09"
"486630","KB제30호스팩","10726200000","2020","5310000","5310000","0","2024-09"
"002380","KCC","1890021947000","257000","7354171","8886471","1532300","2024-09"
"021320","KCC건설","85466193260","4285","19945436","21400000","1454564","2024-09"
"344820","KCC글라스","618601320400","38800","15943333","15970512","27179","2024-09"
"036670","KCI","80486296000","7480","10760200","11270000","509800","2024-09"
"009070","KCTC","134127288750","4485","29905750","30000000","94250","2024-09"
"009440","KC그린홀딩스","18673483120","844","22124980","22434980","310000","2024-09"
"119650","KC코트렐","26648946535","415","64214329","64214329","0","2024-09"
"044180","KD","12153591905","455","26711191","26717799","6608","2024-09"
"092220","KEC","173258590683","863","200763141","200763141","0","2024-09"
"046440","KG모빌리언스","163253296800","4400","37103022","38825568","1722546","2024-09"
"003620","KG모빌리티","961398823330","4895","196404254","196404254","0","2024-09"
"016380","KG스틸","658838543220","6610","99673002","100008897","335895","2024-09"
"151860","KG에코솔루션","218615444980","5210","41960738","49603002","7642264","2024-09"
"035600","KG이니시스","246753383760","9270","26618488","27904434","1285946","2024-09"
"001390","KG케미칼","271137398400","3960","68469040","68469040","0","2024-09"
"226360","KH 건설","60474013950","2555","23668890","23756732","87842","2024-09"
"111870","KH 미래물산","43747975260","8910","4909986","4930249","20263","2024-09"
"033180","KH 필룩스","125157155370","6630","18877399","18903579","26180","2024-09"
"060720","KH바텍","194149864020","8810","22037442","23677442","1640000","2024-09"
"015590","KIB플러그에너지","98347339515","415","236981541","236981544","3","2024-09"
"001940","KISCO홀딩스","237812694140","18830","12629458","16176380","3546922","2024-09"
"058400","KNN","100381727760","758","132429720","132429720","0","2024-09"
"025000","KPX케미칼","223495387000","47000","4755221","4840000","84779","2024-09"
"092230","KPX홀딩스","221720187600","56400","3931209","4224646","293437","2024-09"
"000040","KR모터스","31202933940","519","60121260","60132868","11608","2024-09"
"044450","KSS해운","206358578500","9140","22577525","23085880","508355","2024-09"
"101000","KS인더스트리","66291808000","2200","30132640","30149619","16979","2024-09"
"030200","KT","10767168945000","43800","245825775","252021685","6195910","2024-09"
"033780","KT&G","11991963499900","109300","109716043","130322497","20606454","2024-09"
"058850","KTcs","108884152230","2870","37938729","42685000","4746271","2024-09"
"058860","KTis","80376927750","2625","30619782","34802000","4182218","2024-09"
"122450","KX","147599497530","3555","41518846","45335964","3817118","2024-09"
"052900","KX하이텍","53203480880","979","54344720","55107517","762797","2024-09"
"376190","LB루셈","123984000000","5040","24600000","24600000","0","2024-09"
"061970","LB세미콘","193527896640","4420","43784592","43784592","0","2024-09"
"309960","LB인베스트먼트","89337296055","3885","22995443","23217239","221796","2024-09"
"093050","LF","414993593040","14990","27684696","29240000","1555304","2024-09"
"003550","LG","11490592304000","76000","151192004","157300993","6108989","2024-09"
"034220","LG디스플레이","5175000000000","10350","500000000","500000000","0","2024-09"
"051900","LG생활건강","5196893782500","354500","14659785","15618197","958412","2024-09"
"373220","LG에너지솔루션","95121000000000","406500","234000000","234000000","0","2024-09"
"032640","LG유플러스","4263897251840","9920","429828352","436611361","6783009","2024-09"
"011070","LG이노텍","4164953232000","176000","23664507","23667107","2600","2024-09"
"066570","LG전자","15832386813600","97200","162884638","163647814","763176","2024-09"
"037560","LG헬로비전","199812911700","2580","77446865","77446865","0","2024-09"
"051910","LG화학","23154288504000","328000","70592343","70592343","0","2024-09"
"079550","LIG넥스원","5492178720000","252000","21794360","22000000","205640","2024-09"
"225190","LK삼양","127124842200","2505","50748440","50748440","0","2024-09"
"006260","LS","2980881642000","109000","27347538","32200000","4852462","2024-09"
"010120","LS ELECTRIC","4421567358600","149100","29655046","30000000","344954","2024-09"
"000680","LS네트웍스","258867900990","3285","78803014","78803016","2","2024-09"
"060370","LS마린솔루션","428198178900","15650","27360906","28706781","1345875","2024-09"
"417200","LS머트리얼즈","1035085682700","15300","67652659","67652659","0","2024-09"
"229640","LS에코에너지","864335916000","28500","30327576","30624879","297303","2024-09"
"078020","LS증권","222289101720","4410","50405692","55481190","5075498","2024-09"
"108320","LX세미콘","990495870000","60900","16264300","16264300","0","2024-09"
"001120","LX인터내셔널","1066448294300","29650","35967902","38760000","2792098","2024-09"
"108670","LX하우시스","360229248750","40250","8949795","8967670","17875","2024-09"
"383800","LX홀딩스","535169201580","7020","76234929","76280690","45761","2024-09"
"476080","M83","101205000000","13000","7785000","7785000","0","2024-09"
"086960","MDS테크","96349015944","1038","92821788","92821788","0","2024-09"
"023150","MH에탄올","37398919470","5830","6414909","7378526","963617","2024-09"
"038340","MIT","39924432729","1233","32379913","32424892","44979","2024-09"
"035420","NAVER","26029254862400","172100","151244944","160784508","9539564","2024-09"
"160550","NEW","66277001750","2375","27906106","27906106","0","2024-09"
"053290","NE능률","57842074500","3500","16526307","16526307","0","2024-09"
"181710","NHN","524717383200","15940","32918280","33766123","847843","2024-09"
"060250","NHN KCP","279944135080","7240","38666317","40160611","1494294","2024-09"
"104200","NHN벅스","47592420480","3520","13520574","14827550","1306976","2024-09"
"005940","NH투자증권","4415184564280","13510","326808628","327492299","683671","2024-09"
"034310","NICE","396102727240","11320","34991407","37503477","2512070","2024-09"
"030190","NICE평가정보","663839361020","11330","58591294","60107670","1516376","2024-09"
"008260","NI스틸","108966445770","3810","28600117","28600117","0","2024-09"
"004250","NPC","175301077050","5170","33907365","36720000","2812635","2024-09"
"222160","NPX","79551289560","8040","9894439","9894439","0","2024-09"
"456040","OCI","660694131000","73800","8952495","8952495","0","2024-09"
"010060","OCI홀딩스","1246828600900","65300","19093853","19563983","470130","2024-09"
"178920","PI첨단소재","602009601000","20500","29366322","29366322","0","2024-09"
"024940","PN풍년","56298093200","5990","9398680","10000000","601320","2024-09"
"005490","POSCO홀딩스","25673254470500","339500","75620779","82624377","7003598","2024-09"
"218410","RFHIC","376383713090","14630","25726843","26484442","757599","2024-09"
"327260","RF머트리얼즈","55646512320","6720","8280731","8433231","152500","2024-09"
"091340","S&K폴리텍","26023557690","2430","10709283","11703721","994438","2024-09"
"010950","S-Oil","6574835052800","58400","112582792","112582792","0","2024-09"
"419530","SAMG엔터","105659855000","13300","7944350","8590930","646580","2024-09"
"019550","SBI인베스트먼트","107965410010","670","161142403","162066575","924172","2024-09"
"034120","SBS","281008169100","15150","18548394","18551238","2844","2024-09"
"036120","SCI평가정보","78956005520","2320","34032761","35500000","1467239","2024-09"
"246960","SCL사이언스","63365588700","8700","7283401","7283401","0","2024-09"
"099220","SDN","65547891310","1210","54171811","56171811","2000000","2024-09"
"036540","SFA반도체","578796446470","3530","163964999","164460303","495304","2024-09"
"255220","SG","244583464050","2930","83475585","94073791","10598206","2024-09"
"040610","SG&G","52137702870","1545","33746086","34087196","341110","2024-09"
"049470","SGA","19008084875","325","58486415","58862249","375834","2024-09"
"184230","SGA솔루션즈","31118267243","499","62361257","62599161","237904","2024-09"
"016250","SGC E&C","50139121000","15500","3234782","3243585","8803","2024-09"
"005090","SGC에너지","412047121200","28600","14407242","14409333","2091","2024-09"
"001380","SG글로벌","137140636150","3050","44964143","44964143","0","2024-09"
"004060","SG세계물산","66789151296","336","198777236","202424960","3647724","2024-09"
"001770","SHD","22535986900","18550","1214878","1214878","0","2024-09"
"002360","SH에너지화학","56188455696","516","108892356","111133730","2241374","2024-09"
"009160","SIMPAC","212736502720","3920","54269516","65429516","11160000","2024-09"
"033530","SJG세종","122005868490","4510","27052299","27820961","768662","2024-09"
"123700","SJM","51340114420","3290","15604898","15604898","0","2024-09"
"025530","SJM홀딩스","48922687510","3610","13551991","14934008","1382017","2024-09"
"034730","SK","7932710779500","145500","54520349","72502703","17982354","2024-09"
"011790","SKC","4823924016000","141600","34067260","37868298","3801038","2024-09"
"018670","SK가스","1644228427200","183200","8975046","9230244","255198","2024-09"
"001740","SK네트웍스","981278665400","5060","193928590","221277902","27349312","2024-09"
"006120","SK디스커버리","584420694000","33000","17709718","18785855","1076137","2024-09"
"210980","SK디앤디","151081458920","8120","18606091","18617382","11291","2024-09"
"302440","SK바이오사이언스","4442291513100","56700","78347293","78347293","0","2024-09"
"326030","SK바이오팜","9483734575000","121100","78313250","78313250","0","2024-09"
"402340","SK스퀘어","11999622060000","90000","133329134","134749960","1420826","2024-09"
"361610","SK아이이테크놀로지","2231500322000","31300","71293940","71297592","3652","2024-09"
"100090","SK오션플랜트","767766516960","12970","59195568","59195568","0","2024-09"
"096770","SK이노베이션","10978796128200","115300","95219394","95735590","516196","2024-09"
"475150","SK이터닉스","522207306720","15510","33669072","33691895","22823","2024-09"
"001510","SK증권","207367007703","501","413906203","472590171","58683968","2024-09"
"285130","SK케미칼","847367959200","49200","17222926","17253783","30857","2024-09"
"017670","SK텔레콤","12198387396600","57300","212886342","214790053","1903711","2024-09"
"000660","SK하이닉스","136567476484200","198200","689038731","728002365","38963634","2024-09"
"048550","SM C&C","162482842611","1693","95973327","96714620","741293","2024-09"
"063440","SM Life Design","63059940980","1370","46029154","46029154","0","2024-09"
"003570","SNT다이내믹스","595676436600","26600","22393851","33252697","10858846","2024-09"
"064960","SNT모티브","552496539400","46150","11971756","14623136","2651380","2024-09"
"100840","SNT에너지","252744571320","12790","19761108","20680783","919675","2024-09"
"036530","SNT홀딩스","326065378100","22550","14459662","16303886","1844224","2024-09"
"067160","SOOP","955875492000","89700","10656360","11494767","838407","2024-09"
"005610","SPC삼립","402019060800","49600","8105223","8629009","523786","2024-09"
"011810","STX","150253242500","4850","30980050","31017927","37877","2024-09"
"465770","STX그린로지스","86306647200","12080","7144590","7171032","26442","2024-09"
"077970","STX엔진","450332305060","19580","22999607","23008904","9297","2024-09"
"002820","SUN&L","37697512500","3125","12063204","12607989","544785","2024-09"
"289080","SV인베스트먼트","84269422000","1583","53234000","53234000","0","2024-09"
"084870","TBH글로벌","28970121591","1389","20856819","20856819","0","2024-09"
"002710","TCC스틸","1184859104400","45200","26213697","26213697","0","2024-09"
"089230","THE E&M","28327142095","1295","21874241","21882953","8712","2024-09"
"032540","TJ미디어","73140947250","5250","13931609","13931609","0","2024-09"
"022220","TKG애강","54487897108","1052","51794579","51794579","0","2024-09"
"069260","TKG휴켐스","758208529520","19760","38370877","40878588","2507711","2024-09"
"007980","TP","64612928992","1328","48654314","51175130","2520816","2024-09"
"048770","TPC","37518198490","2390","15697991","15697991","0","2024-09"
"246690","TS인베스트먼트","40918708960","1003","40796320","41477862","681542","2024-09"
"317240","TS트릴리온","29786621715","279","106762085","107240922","478837","2024-09"
"002900","TYM","131356396620","3060","42926927","45050956","2124029","2024-09"
"024070","WISCOM","31495830090","2055","15326438","15326438","0","2024-09"
"057030","YBM넷","58991944815","3645","16184347","16312697","128350","2024-09"
"037270","YG PLUS","364719107500","5750","63429410","63429410","0","2024-09"
"040300","YTN","130830000000","3115","42000000","42000000","0","2024-09"
"051390","YW","30359037120","3760","8074212","11355368","3281156","2024-09"
"052220","iMBC","58190000000","2530","23000000","23000000","0","2024-09"
"079940","가비아","169813387400","13100","12962854","13535684","572830","2024-09"
"078890","가온그룹","57202122720","3560","16068012","17410157","1342145","2024-09"
"000500","가온전선","272670786000","38250","7128648","7357946","229298","2024-09"
"399720","가온칩스","428514336000","37300","11488320","11488320","0","2024-09"
"036620","감성코퍼레이션","328496509040","3620","90744892","90744892","0","2024-09"
"000860","강남제비스코","164450000000","25300","6500000","6500000","0","2024-09"
"198440","강동씨앤엘","90193666368","1482","60859424","60931896","72472","2024-09"
"217730","강스템바이오텍","119395337370","2130","56054149","56054149","0","2024-09"
"035250","강원랜드","3304645667400","16300","202738998","213940500","11201502","2024-09"
"114190","강원에너지","322358288920","12340","26123038","26123038","0","2024-09"
"094480","갤럭시아머니트리","311484913720","7940","39229838","39229838","0","2024-09"
"011420","갤럭시아에스엠","64328418740","2335","27549644","27549644","0","2024-09"
"039240","경남스틸","75407993180","2795","26979604","26979604","0","2024-09"
"053950","경남제약","23420269670","658","35593115","35593402","287","2024-09"
"002100","경농","163997487000","9180","17864650","19522575","1657925","2024-09"
"009450","경동나비엔","1309435639200","90600","14452932","14568592","115660","2024-09"
"267290","경동도시가스","110504410520","18760","5890427","5895406","4979","2024-09"
"012320","경동인베스트","164834611200","75600","2180352","2365023","184671","2024-09"
"011040","경동제약","170541404100","6330","26941770","30768766","3826996","2024-09"
"000050","경방","149242467300","5990","24915270","27415270","2500000","2024-09"
"214390","경보제약","177867038400","7440","23906860","23906860","0","2024-09"
"012610","경인양행","123477038370","2985","41365842","41616365","250523","2024-09"
"009140","경인전자","27353277000","21000","1302537","1570797","268260","2024-09"
"024910","경창산업","79352052400","2230","35583880","35819005","235125","2024-09"
"013580","계룡건설","118694479800","13400","8857797","8930907","73110","2024-09"
"012200","계양전기","41826915852","1538","27195654","27222829","27175","2024-09"
"002140","고려산업","79441972400","3220","24671420","24939425","268005","2024-09"
"049720","고려신용정보","138699135360","9960","13925616","14300000","374384","2024-09"
"010130","고려아연","23389745302000","1138000","20553379","20703283","149904","2024-09"
"002240","고려제강","479019250710","19170","24987963","25000000","12037","2024-09"
"014570","고려제약","52167179315","4835","10789489","11000000","210511","2024-09"
"348150","고바이오랩","138910504500","7170","19373850","19373850","0","2024-09"
"098460","고영","639510564960","9720","65793268","68654755","2861487","2024-09"
"035290","골드앤에스","21025327680","441","47676480","47676480","0","2024-09"
"215000","골프존","399939660000","66600","6005100","6275415","270315","2024-09"
"121440","골프존뉴딘홀딩스","156428321280","3840","40736542","42836818","2100276","2024-09"
"366030","공구우먼","97298285750","4295","22653850","22653850","0","2024-09"
"009290","광동제약","230062712880","5740","40080612","52420851","12340239","2024-09"
"014200","광림","87868591200","30200","2909556","3023556","114000","2024-09"
"017040","광명전기","62926216980","1452","43337615","43337615","0","2024-09"
"029480","광무","211089799680","3840","54971302","55009083","37781","2024-09"
"017900","광전자","90251863296","1792","50363763","57943763","7580000","2024-09"
"037710","광주신세계","224238856800","29400","7627172","7957190","330018","2024-09"
"026910","광진실업","14187972075","2215","6405405","6405405","0","2024-09"
"421800","교보12호스팩","16205800000","2710","5980000","5980000","0","2024-06"
"440790","교보13호스팩","8829000000","2180","4050000","4050000","0","2024-09"
"456490","교보14호스팩","9093000000","2165","4200000","4200000","0","2024-09"
"465320","교보15호스팩","8210550000","2155","3810000","3810000","0","2024-09"
"482520","교보16호스팩","12535500000","2055","6100000","6100000","0","2024-09"
"030610","교보증권","627553658280","5560","112869363","113962961","1093598","2024-09"
"339770","교촌에프앤비","264065447800","10570","24982540","24982540","0","2024-09"
"053270","구영테크","58818554080","2255","26083616","27410405","1326789","2024-09"
"007690","국도화학","284412209400","34100","8340534","9010616","670082","2024-09"
"005320","국동","31518356184","476","66215034","67327897","1112863","2024-09"
"001140","국보","33448047050","2110","15852155","15856388","4233","2024-09"
"066620","국보디자인","107735893200","16300","6609564","7500000","890436","2024-09"
"043650","국순당","77836604370","4945","15740466","17858304","2117838","2024-09"
"006050","국영지앤엠","63519685382","1874","33895243","34895243","1000000","2024-09"
"060480","국일신동","21403700000","1930","11090000","11090000","0","2024-09"
"078130","국일제지","901924696800","800","1127405871","1127405871","0","2024-09"
"307750","국전약품","211242699360","4305","49069152","49069269","117","2024-09"
"002720","국제약품","108532135660","5330","20362502","21159832","797330","2024-09"
"035080","그래디언트","153364301460","11210","13681026","14527584","846558","2024-09"
"453450","그리드위즈","157266450000","19800","7942750","7942750","0","2024-09"
"204020","그리티","55660206460","2780","20021657","20147430","125773","2024-09"
"402490","그린리소스","131263190720","15880","8265944","8265944","0","2024-09"
"114450","그린생명과학","39511062900","2070","19087470","20000000","912530","2024-09"
"083420","그린케미칼","134592889480","5770","23326324","24000000","673676","2024-09"
"186230","그린플러스","98057916440","9130","10740188","10820188","80000","2024-09"
"014530","극동유화","126260325000","3750","33669420","34869420","1200000","2024-09"
"204620","글로벌텍스프리","236210646095","3865","61115303","61116035","732","2024-09"
"019660","글로본","19065328808","548","34790746","34790746","0","2024-09"
"014280","금강공업","110175679700","4100","26872117","29329357","2457240","2024-09"
"053260","금강철강","75589245960","4755","15896792","18720000","2823208","2024-09"
"008870","금비","45263050000","55300","818500","1000000","181500","2024-09"
"001570","금양","2467622508600","42600","57925411","58050037","124626","2024-09"
"282720","금양그린파워","123203049000","10210","12066900","12119500","52600","2024-09"
"002990","금호건설","104455509240","2910","35895364","36953595","1058231","2024-09"
"011780","금호석유","3267315151900","142300","22960753","27334587","4373834","2024-09"
"214330","금호에이치티","126323253460","620","203747183","213914131","10166948","2024-09"
"001210","금호전기","36824070194","863","42669838","43535722","865884","2024-09"
"073240","금호타이어","1206493205400","4200","287260287","287260287","0","2024-09"
"036190","금화피에스시","161523356500","27350","5905790","6000000","94210","2024-09"
"049080","기가레인","58736958616","692","84879998","84883347","3349","2024-09"
"420770","기가비스","472171985500","37250","12675758","12675758","0","2024-09"
"035460","기산텔레콤","26968079000","1850","14577340","14577340","0","2024-09"
"092440","기신정기","75482000000","2585","29200000","29200000","0","2024-09"
"000270","기아","35617824134100","90900","391835249","399858417","8023168","2024-09"
"024110","기업은행","11522803778150","14450","797425867","797425869","2","2024-09"
"013700","까뮤이앤씨","78871095600","1320","59750830","59750830","0","2024-09"
"308100","까스텔바작","20317068450","3150","6449863","6624733","174870","2024-09"
"004540","깨끗한나라","76899045055","2065","37239247","37240693","1446","2024-09"
"407400","꿈비","70413911250","5970","11794625","12259474","464849","2024-09"
"187790","나노","31435070025","1025","30668361","30840830","172469","2024-09"
"286750","나노브릭","50802969670","2455","20693674","20694559","885","2024-09"
"121600","나노신소재","1005024048000","84000","11964572","12196078","231506","2024-09"
"247660","나노씨엠에스","34255040040","8020","4271202","4343920","72718","2024-09"
"039860","나노엔텍","144013717770","4485","32110082","32110082","0","2024-09"
"091970","나노캠텍","22731846769","629","36139661","37417493","1277832","2024-09"
"417010","나노팀","191325981600","9700","19724328","19724328","0","2024-09"
"405920","나라셀라","46621473750","3750","12432393","12878076","445683","2024-09"
"051490","나라엠앤디","68810319550","5210","13207355","14200000","992645","2024-09"
"137080","나래나노텍","36827875260","3330","11059422","11059422","0","2024-09"
"190510","나무가","187926538920","11890","15805428","16264384","458956","2024-09"
"242040","나무기술","57824253460","1745","33137108","34606264","1469156","2024-09"
"089600","나스미디어","176150113020","15580","11306169","11568163","261994","2024-09"
"293580","나우IB","88288313400","932","94729950","94929950","200000","2024-09"
"138610","나이벡","205836460000","20000","10291823","10291823","0","2024-09"
"130580","나이스디앤비","76769000000","4985","15400000","15400000","0","2024-09"
"036800","나이스정보통신","163929055500","18690","8770950","10000000","1229050","2024-09"
"267320","나인테크","99608198175","2295","43402265","43664104","261839","2024-09"
"001260","남광토건","61299975360","6240","9823714","9832572","8858","2024-09"
"008350","남선알미늄","173353217870","1343","129079090","129079090","0","2024-09"
"004270","남성","40813200561","1303","31322487","36212160","4889673","2024-09"
"003920","남양유업","417269295000","635000","657117","679731","22614","2024-09"
"025860","남해화학","309748569700","6460","47948695","49678843","1730148","2024-09"
"111710","남화산업","105822320000","5140","20588000","20588000","0","2024-09"
"091590","남화토건","46901300000","3995","11740000","11740000","0","2024-09"
"168330","내츄럴엔도텍","49412278665","1565","31573341","31754900","181559","2024-09"
"094860","네오리진","29702478786","1389","21384074","21399569","15495","2024-09"
"253590","네오셈","473864541300","11150","42499062","43869164","1370102","2024-09"
"212560","네오오토","68429900330","8690","7874557","7874963","406","2024-09"
"095660","네오위즈","395392799580","19860","19909003","22033719","2124716","2024-09"
"042420","네오위즈홀딩스","127243924730","19570","6501989","8856866","2354877","2024-09"
"311390","네오크레마","77430182310","7110","10890321","10979147","88826","2024-09"
"085910","네오티스","46151595300","3450","13377274","13934818","557544","2024-09"
"092730","네오팜","213894175800","27350","7820628","8207361","386733","2024-09"
"290660","네오펙트","40191555402","954","42129513","42129513","0","2024-09"
"306620","네온테크","90359315280","2210","40886568","42608149","1721581","2024-09"
"153460","네이블","40078623360","6260","6402336","6530014","127678","2024-09"
"007390","네이처셀","899713040880","13980","64357156","64357156","0","2024-09"
"033640","네패스","171455724440","7540","22739486","23059202","319716","2024-09"
"330860","네패스아크","152422402950","12510","12184045","12184045","0","2024-09"
"005720","넥센","220913805600","4560","48446010","53543977","5097967","2024-09"
"002350","넥센타이어","668335810700","6950","96163426","97667877","1504451","2024-09"
"089140","넥스턴바이오","42623820540","3780","11276143","11282627","6484","2024-09"
"389650","넥스트바이오메디컬","292738033200","36200","8086686","8086686","0","2024-09"
"137940","넥스트아이","32615319132","426","76561782","78320992","1759210","2024-09"
"396270","넥스트칩","230633985000","12750","18088940","18088940","0","2024-09"
"348210","넥스틴","699789580200","67700","10336626","10437250","100624","2024-09"
"092790","넥스틸","236878220000","9110","26002000","26002000","0","2024-09"
"225570","넥슨게임즈","939068839560","14680","63969267","65860174","1890907","2024-09"
"217270","넵튠","234655722730","5230","44867251","46676150","1808899","2024-09"
"251270","넷마블","4604722890200","56200","81934571","85953502","4018931","2024-09"
"104620","노랑풍선","72715358340","4590","15842126","15842126","0","2024-09"
"090350","노루페인트","168400000000","8420","20000000","20000000","0","2024-09"
"000320","노루홀딩스","138254868570","13490","10248693","13291151","3042458","2024-09"
"194700","노바렉스","184811135040","10440","17702216","18754848","1052632","2024-09"
"285490","노바텍","115350729060","11620","9926913","10575831","648918","2024-09"
"145170","노브랜드","105812351040","12760","8292504","9079834","787330","2024-09"
"106520","노블엠앤비","15902299386","411","38691726","38695952","4226","2024-09"
"376930","노을","107515944600","2910","36947060","36947060","0","2024-09"
"006280","녹십자","1895728865800","166100","11413178","11686538","273360","2024-09"
"142280","녹십자엠에스","87695981040","4040","21706926","21741926","35000","2024-09"
"234690","녹십자웰빙","207263538880","11680","17745166","17752276","7110","2024-09"
"005250","녹십자홀딩스","725687168500","16150","44934190","47028210","2094020","2024-09"
"004370","농심","2101983460500","363500","5782623","6082642","300019","2024-09"
"072710","농심홀딩스","311659488000","67200","4637790","4637790","0","2024-09"
"054050","농우바이오","114939122370","7170","16030561","16030561","0","2024-09"
"069140","누리플랜","17782461040","1360","13075339","13102743","27404","2024-09"
"040160","누리플렉스","27397613625","2425","11297985","12055535","757550","2024-09"
"332290","누보","38367685906","1166","32905391","33384803","479412","2024-09"
"348340","뉴로메카","219422736000","20800","10549170","10549170","0","2024-09"
"060260","뉴보텍","14022816156","1051","13342356","13512009","169653","2024-09"
"123840","뉴온","60301743224","232","259921307","292370108","32448801","2024-09"
"012340","뉴인텍","26877097104","528","50903593","50907162","3569","2024-09"
"214870","뉴지랩파마","64715071880","6920","9351889","9359221","7332","2024-09"
"270870","뉴트리","80593820160","8960","8994846","9200224","205378","2024-09"
"144960","뉴파워프라즈마","192819455995","4765","40465783","43692624","3226841","2024-09"
"085670","뉴프렉스","130809019400","5350","24450284","24450761","477","2024-09"
"064260","다날","204386564700","3060","66792995","68949040","2156045","2024-09"
"340360","다보링크","109772176360","2530","43388212","43388212","0","2024-09"
"039560","다산네트웍스","128235033420","3315","38683268","39505981","822713","2024-09"
"154040","다산솔루에타","29976656980","1670","17950094","17950094","0","2024-09"
"058730","다스코","57179999800","3145","18181240","18796941","615701","2024-09"
"030210","다올투자증권","172388141010","2910","59239911","60911106","1671195","2024-09"
"023590","다우기술","784913943310","18190","43150849","44866617","1715768","2024-09"
"032190","다우데이타","426279000000","11130","38300000","38300000","0","2024-09"
"323350","다원넥스뷰","49193827200","6480","7591640","7596111","4471","2024-09"
"068240","다원시스","401860991610","10530","38163437","38163437","0","2024-09"
"145210","다이나믹디자인","86575775940","2505","34561188","34581687","20499","2024-09"
"019680","대교","154644164010","2295","67383078","84702850","17319772","2024-09"
"006370","대구백화점","60914192520","7320","8321611","10821611","2500000","2024-09"
"008060","대덕","208763324000","6160","33890150","33890150","0","2024-09"
"353200","대덕전자","799071677250","16170","49416925","49416925","0","2024-09"
"000490","대동","189492243480","8040","23568687","25640788","2072101","2024-09"
"020400","대동금속","20027962480","6280","3189166","3189166","0","2024-09"
"008830","대동기어","64889894400","7220","8987520","8987520","0","2024-09"
"048470","대동스틸","34045111740","3620","9404727","10000000","595273","2024-09"
"008110","대동전자","105136322880","15040","6990447","10490447","3500000","2024-09"
"004780","대륙제관","64726019930","4070","15903199","15903199","0","2024-09"
"005750","대림B&Co","58102756400","3485","16672240","16672240","0","2024-09"
"017650","대림제지","58345000000","7000","8335000","9000000","665000","2024-09"
"006570","대림통상","39920850800","2650","15064472","15225000","160528","2024-09"
"007720","대명소노시즌","117432524250","1165","100800450","100800450","0","2024-09"
"389260","대명에너지","207669000000","12180","17050000","17050000","0","2024-09"
"317850","대모","76334931400","9170","8324420","8324420","0","2024-09"
"290670","대보마그네틱","121411420000","16250","7471472","7857660","386188","2024-09"
"078140","대봉엘에스","198490303970","18130","10948169","11086579","138410","2024-09"
"065150","대산F&B","18113400725","145","124920005","125282405","362400","2024-09"
"001680","대상","687763296250","19850","34648025","34648025","0","2024-09"
"084690","대상홀딩스","289700304000","8000","36212538","36212538","0","2024-09"
"036480","대성미생물","38190000000","10050","3800000","3800000","0","2024-09"
"128820","대성산업","129051815230","3445","37460614","45235478","7774864","2024-09"
"117580","대성에너지","259707914300","9550","27194546","27500000","305454","2024-09"
"027830","대성창투","78084000000","1446","54000000","54000000","0","2024-09"
"104040","대성파인텍","44914147196","964","46591439","47224987","633548","2024-09"
"129920","대성하이텍","56711744155","4135","13715053","13715053","0","2024-09"
"016710","대성홀딩스","126454148040","7860","16088314","16089459","1145","2024-09"
"438220","대신밸런스제13호스팩","14917800000","2645","5640000","5640000","0","2024-09"
"442310","대신밸런스제14호스팩","14762000000","2200","6710000","6710000","0","2024-09"
"457390","대신밸런스제15호스팩","16778475000","2385","7035000","7035000","0","2024-09"
"457630","대신밸런스제16호스팩","16008900000","2190","7310000","7310000","0","2024-09"
"471050","대신밸런스제17호스팩","12847200000","2120","6060000","6060000","0","2024-09"
"478780","대신밸런스제18호스팩","16294600000","2060","7910000","7910000","0","2024-09"
"020180","대신정보통신","33433156050","870","38428915","38428915","0","2024-09"
"003540","대신증권","632452398950","16850","37534267","50773400","13239133","2024-09"
"045390","대아티아이","182526046430","2590","70473377","70473377","0","2024-09"
"009190","대양금속","72004049100","1700","42355323","42359986","4663","2024-09"
"108380","대양전기공업","105932939520","11460","9243712","9567333","323621","2024-09"
"014160","대영포장","96306943023","1011","95259093","108394549","13135456","2024-09"
"047040","대우건설","1493569592200","3635","410885720","415622638","4736918","2024-09"
"003090","대웅","1044757640500","25550","40890710","58141980","17251270","2024-09"
"069620","대웅제약","1769664326000","153800","11506270","11586575","80305","2024-09"
"007680","대원","57013049760","4240","13446474","13446474","0","2024-09"
"000430","대원강업","236840000000","3820","62000000","62000000","0","2024-09"
"048910","대원미디어","97158688560","8040","12084414","12578946","494532","2024-09"
"005710","대원산업","116218080000","5800","20037600","20037600","0","2024-09"
"006340","대원전선","210316585875","2805","74979175","74979175","0","2024-09"
"003220","대원제약","310784865500","14500","21433439","22427583","994144","2024-09"
"024890","대원화성","44020359360","1080","40759592","41249152","489560","2024-09"
"290380","대유","56838037000","2300","24712190","24713612","1422","2024-09"
"002880","대유에이텍","49723009728","1064","46732152","46744020","11868","2024-09"
"000300","대유플러스","30475633069","241","126454909","126454909","0","2024-09"
"120240","대정화금","98846571980","13780","7173191","7190391","17200","2024-09"
"003310","대주산업","50611060500","1430","35392350","35392350","0","2024-09"
"078600","대주전자재료","1549873170000","103500","14974620","15480593","505973","2024-09"
"012800","대창","94484315988","1238","76320126","91140499","14820373","2024-09"
"015230","대창단조","129599651600","5140","25213940","28572230","3358290","2024-09"
"096350","대창솔루션","55545192371","349","159155279","163761009","4605730","2024-09"
"140520","대창스틸","47703709360","2260","21107836","21109243","1407","2024-09"
"131220","대한과학","35734243615","4795","7452397","7454490","2093","2024-09"
"010170","대한광통신","78013190802","1047","74511166","74511166","0","2024-09"
"054670","대한뉴팜","108212078190","7710","14035289","14354920","319631","2024-09"
"001070","대한방직","21204289050","5870","3612315","5300000","1687685","2024-09"
"023910","대한약품","148470000000","25250","5880000","6000000","120000","2024-09"
"006650","대한유화","620698050000","100500","6176100","6500000","323900","2024-09"
"001440","대한전선","2173357999800","11700","185757094","186447300","690206","2024-09"
"084010","대한제강","235701904270","13510","17446477","23414397","5967920","2024-09"
"001790","대한제당","258330005600","2920","88469180","89696580","1227400","2024-09"
"001130","대한제분","222759673800","135400","1645197","1690000","44803","2024-09"
"003490","대한항공","8634773374850","23450","368220613","368220661","48","2024-09"
"005880","대한해운","569412588640","1784","319177460","319177460","0","2024-09"
"003830","대한화섬","133359730000","119000","1120670","1328000","207330","2024-09"
"016090","대현","94321320300","2130","44282310","44282310","0","2024-09"
"069460","대호에이엘","72129128740","1069","67473460","67544896","71436","2024-09"
"021040","대호특수강","28299341670","1545","18316726","21704774","3388048","2024-09"
"067080","대화제약","324058025000","18500","17516650","18616650","1100000","2024-09"
"298540","더네이쳐홀딩스","144719565170","9910","14603387","14765856","162469","2024-09"
"032860","더라미","80779976325","2005","40289265","40395863","106598","2024-09"
"192080","더블유게임즈","995242961400","50200","19825557","21495906","1670349","2024-09"
"393890","더블유씨피","530046228140","15730","33696518","33696518","0","2024-09"
"299170","더블유에스아이","45041922000","1500","30027948","30027963","15","2024-09"
"012510","더존비즈온","1463106126600","52200","28028853","30382784","2353931","2024-09"
"224060","더코디","21268650105","4505","4721121","4748398","27277","2024-09"
"043090","더테크놀로지","30360402408","408","74412751","74412751","0","2024-09"
"213420","덕산네오룩스","670567579500","27300","24562915","24831179","268264","2024-09"
"317330","덕산테코피아","743299999200","36300","20476584","20476584","0","2024-09"
"077360","덕산하이메탈","213781094410","4705","45437002","45437002","0","2024-09"
"004830","덕성","89822735750","6490","13840175","15680000","1839825","2024-09"
"090410","덕신이피씨","64517649000","1400","46084035","46084095","60","2024-09"
"024900","덕양산업","103768256000","3200","32427580","32564980","137400","2024-09"
"263600","덕우전자","92395798000","5800","15930310","15930310","0","2024-09"
"194480","데브시스터즈","366561680800","33950","10797104","12035480","1238376","2024-09"
"263800","데이타솔루션","68364686700","4215","16219380","16219380","0","2024-09"
"206560","덱스터","198725550700","7900","25155133","25411736","256603","2024-09"
"261200","덴티스","107403109750","7030","15277825","15809700","531875","2024-09"
"145720","덴티움","667489163400","77400","8623891","11068830","2444939","2024-09"
"067990","도이치모터스","138007619700","4650","29679058","30181550","502492","2024-09"
"002150","도화엔지니어링","221750194500","6660","33295825","33720000","424175","2024-09"
"006620","동구바이오제약","151311732840","5580","27116798","28464992","1348194","2024-09"
"100130","동국S&C","139334307500","2500","55733723","57143000","1409277","2024-09"
"005160","동국산업","334908671500","6500","51524411","54244482","2720071","2024-09"
"460850","동국씨엠","191328346560","6410","29848416","29898656","50240","2024-09"
"075970","동국알앤에스","45448000000","2470","18400000","18400000","0","2024-09"
"460860","동국제강","423652859100","8550","49550042","49608017","57975","2024-09"
"086450","동국제약","771644016000","17550","43968320","44460000","491680","2024-09"
"001230","동국홀딩스","248812344000","8000","31101543","31800483","698940","2024-09"
"023450","동남합성","112815045000","32550","3465900","3500000","34100","2024-09"
"004140","동방","111600872010","2335","47794806","47971766","176960","2024-09"
"099410","동방선기","42535467750","3050","13946055","14000000","53945","2024-09"
"007590","동방아그로","77907739480","6280","12405691","13617577","1211886","2024-09"
"005960","동부건설","93603580320","4080","22942054","22946345","4291","2024-09"
"026960","동서","2042521226100","20700","98672523","99700000","1027477","2024-09"
"002210","동성제약","102325296300","4475","22865988","26100970","3234982","2024-09"
"102260","동성케미컬","208706658330","4285","48706338","49689728","983390","2024-09"
"033500","동성화인텍","319364419000","11000","29033129","29989494","956365","2024-09"
"025950","동신건설","168000000000","20000","8400000","8400000","0","2024-09"
"000640","동아쏘시오홀딩스","763838350600","122200","6250723","6348913","98190","2024-09"
"170900","동아에스티","674235633800","75100","8977838","9167274","189436","2024-09"
"088130","동아엘텍","78334206720","8960","8742657","8742657","0","2024-09"
"028100","동아지질","174490383600","13170","13249080","14052646","803566","2024-09"
"041930","동아화성","101555272080","6840","14847262","15800000","952738","2024-09"
"001520","동양","143302067565","755","189804063","238684063","48880000","2024-09"
"084670","동양고속","21993870000","8430","2609000","2895569","286569","2024-09"
"082640","동양생명","871734020170","5590","155945263","161358585","5413322","2024-09"
"060380","동양에스텍","28023600000","1452","19300000","19700000","400000","2024-09"
"079960","동양이엔피","147927443240","19160","7720639","7860000","139361","2024-09"
"008970","동양철관","117778184250","750","157037579","157052160","14581","2024-09"
"228340","동양파일","40100000000","2005","20000000","20000000","0","2024-09"
"092780","동양피스톤","72444149680","5740","12620932","13168460","547528","2024-09"
"088910","동우팜투테이블","50929092720","1980","25721764","25831764","110000","2024-09"
"094170","동운아나텍","345842743600","18350","18847016","19067208","220192","2024-09"
"049770","동원F&B","612635935000","31750","19295620","19295620","0","2024-09"
"013120","동원개발","228382371500","2515","90808100","90808100","0","2024-09"
"018500","동원금속","56280745220","1204","46744805","46754933","10128","2024-09"
"006040","동원산업","1219341145750","33850","36021895","36021895","0","2024-09"
"030720","동원수산","26061308000","5600","4653805","4653805","0","2024-09"
"014820","동원시스템즈","1406077177000","48500","28991282","28991282","0","2024-09"
"111380","동인기연","115153530600","19400","5935749","6128000","192251","2024-09"
"163560","동일고무벨트","101470000000","7300","13900000","13900000","0","2024-09"
"109860","동일금속","72918519500","8620","8459225","9100000","640775","2024-09"
"032960","동일기연","42742887720","11310","3779212","3986323","207111","2024-09"
"004890","동일산업","86101322250","39750","2166071","2425215","259144","2024-09"
"002690","동일제강","27682132240","1459","18973360","20300360","1327000","2024-09"
"023790","동일철강","26279949838","1262","20824049","20841335","17286","2024-09"
"005290","동진쎄미켐","1372766989800","26700","51414494","51414494","0","2024-09"
"025900","동화기업","503151858000","11000","45741078","50557285","4816207","2024-09"
"000020","동화약품","210379088700","7590","27717930","27931470","213540","2024-09"
"000150","두산","2758685676000","204000","13522969","16523835","3000866","2024-09"
"454910","두산로보틱스","4265154684000","65800","64819980","64819980","0","2024-09"
"241560","두산밥캣","3918609982350","39150","100092209","100249166","156957","2024-09"
"034020","두산에너빌리티","13353698752800","20850","640465168","640561146","95978","2024-09"
"131970","두산테스나","488080289850","28850","16917861","17006566","88705","2024-09"
"336260","두산퓨얼셀","1126302078800","17200","65482679","65493726","11047","2024-09"
"016740","두올","108873576810","3495","31151238","32066680","915442","2024-09"
"073190","듀오백","27603277810","2495","11063438","11968040","904602","2024-09"
"030350","드래곤플라이","16445186601","237","69388973","69388973","0","2024-09"
"203650","드림시큐리티","159653626725","3275","48749199","50605754","1856555","2024-09"
"223250","드림씨아이에스","104598028980","4395","23799324","23799324","0","2024-09"
"060570","드림어스컴퍼니","183760422390","2430","75621573","75621573","0","2024-09"
"362990","드림인사이트","37549331520","2290","16397088","16800574","403486","2024-09"
"192650","드림텍","570522004650","8450","67517397","68883113","1365716","2024-09"
"217620","디딤이앤에프","21715711458","381","56996618","57747210","750592","2024-09"
"016670","디모아","18606314740","3770","4935362","4941846","6484","2024-09"
"187870","디바이스이엔지","87988178740","13090","6721786","7036609","314823","2024-09"
"024090","디씨엠","106062805680","12220","8679444","11400000","2720556","2024-09"
"003160","디아이","459976475920","17680","26016769","28300000","2283231","2024-09"
"092200","디아이씨","141034985000","3640","38745875","38888569","142694","2024-09"
"110990","디아이티","248151373140","13460","18436209","18900000","463791","2024-09"
"263690","디알젬","78367231800","7150","10960452","11325610","365158","2024-09"
"214680","디알텍","208278729800","2825","73726984","73727108","124","2024-09"
"347850","디앤디파마텍","490577834950","46550","10538729","10538729","0","2024-09"
"263720","디앤씨미디어","217220342500","17500","12412591","12524473","111882","2024-09"
"376300","디어유","548357178600","23100","23738406","23738406","0","2024-09"
"109740","디에스케이","129544602200","5140","25203230","25710390","507160","2024-09"
"196490","디에이테크놀로지","36209568780","203","178372260","178549360","177100","2024-09"
"066900","디에이피","42857200455","2435","17600493","22744503","5144010","2024-09"
"127120","디엔에이링크","80267319510","3570","22483843","22483843","0","2024-09"
"092070","디엔에프","118380107340","10230","11571858","11571858","0","2024-09"
"039840","디오","230942768240","15980","14451988","14981755","529767","2024-09"
"013570","디와이","112121473095","4545","24669191","26319633","1650442","2024-09"
"219550","디와이디","40270905783","513","78500791","78500791","0","2024-09"
"310870","디와이씨","25030407270","1210","20686287","20687271","984","2024-09"
"210540","디와이파워","137948137500","12500","11035851","11041708","5857","2024-09"
"104460","디와이피엔에프","101009929900","10450","9666022","10713625","1047603","2024-09"
"079810","디이엔티","161054096830","7370","21852659","22028094","175435","2024-09"
"113810","디젠스","28386404370","870","32628051","32628051","0","2024-09"
"043360","디지아이","19039863815","2135","8917969","9000000","82031","2024-09"
"197140","디지캡","32990552400","2600","12688674","13013154","324480","2024-09"
"068930","디지털대성","194692748000","7430","26203600","27675342","1471742","2024-09"
"033130","디지틀조선","63986720308","1724","37115267","37115267","0","2024-09"
"105740","디케이락","74535200290","7330","10168513","10168513","0","2024-09"
"263020","디케이앤디","51335416950","3450","14879831","15069831","190000","2024-09"
"290550","디케이티","163010024500","8150","20001230","20001230","0","2024-09"
"066670","디티씨","51802192200","3300","15697634","18691918","2994284","2024-09"
"187220","디티앤씨","42642252100","3700","11524933","11698021","173088","2024-09"
"383930","디티앤씨알오","91819981280","7190","12770512","12770512","0","2024-09"
"131180","딜리","27953582166","1006","27786861","29350000","1563139","2024-09"
"315640","딥노이드","147756156120","6590","22421268","22421268","0","2024-09"
"223310","딥마인드","50349208140","2205","22834108","22839375","5267","2024-09"
"317120","라닉스","33623672100","3490","9634290","9660000","25710","2024-09"
"462510","라메디텍","88670033750","10250","8650735","8650735","0","2024-09"
"042510","라온시큐어","102386874760","1894","54058540","56025871","1967331","2024-09"
"232680","라온테크","82818363320","6790","12197108","12534234","337126","2024-09"
"418420","라온텍","97753522020","3255","30031804","30108433","76629","2024-09"
"300120","라온피플","105551660720","5060","20860012","20860012","0","2024-09"
"171120","라이온켐텍","87356857500","2475","35295700","35901760","606060","2024-09"
"388790","라이콤","95408073600","3200","29815023","29913930","98907","2024-09"
"347700","라이프시맨틱스","72179845370","3610","19994417","19994417","0","2024-09"
"214260","라파스","154111282250","18350","8398435","8912435","514000","2024-09"
"115390","락앤락","374233582080","8640","43314072","43326411","12339","2024-09"
"200350","래몽래인","131747609500","13180","9996025","9996025","0","2024-09"
"171010","램테크놀러지","52261938560","3655","14298752","14298752","0","2024-09"
"084650","랩지노믹스","257983965250","3475","74239990","74239990","0","2024-09"
"217500","러셀","52069133830","1795","29007874","31812000","2804126","2024-09"
"038390","레드캡투어","131425660920","15720","8360411","8589480","229069","2024-09"
"294140","레몬","93424559350","4450","20994283","21000000","5717","2024-09"
"443250","레뷰코퍼레이션","96981840000","9000","10775760","11279386","503626","2024-09"
"228670","레이","133414136940","8610","15495254","15495254","0","2024-09"
"228850","레이언스","109053529200","6930","15736440","16591014","854574","2024-09"
"412350","레이저쎌","44245748040","5070","8726972","8726972","0","2024-09"
"199550","레이저옵텍","79256468400","6800","11655363","11656947","1584","2024-09"
"281740","레이크머티리얼즈","933373242000","14200","65730510","65730548","38","2024-09"
"277810","레인보우로보틱스","2411402349400","124300","19399858","19399858","0","2024-09"
"215100","로보로보","65097271775","3215","20247985","20348454","100469","2024-09"
"090360","로보스타","201337500000","20650","9750000","9750000","0","2024-09"
"108490","로보티즈","226837860780","17590","12895842","13051842","156000","2024-09"
"067730","로지시스","25152197200","2600","9673922","9673922","0","2024-09"
"071280","로체시스템즈","288625935150","19350","14916069","15296603","380534","2024-09"
"032350","롯데관광개발","737579051440","9680","76196183","76196183","0","2024-09"
"089860","롯데렌탈","1046133014400","28800","36324063","36634063","310000","2024-09"
"000400","롯데손해보험","678496515850","2195","309110030","310336320","1226290","2024-09"
"023530","롯데쇼핑","1806493896000","63900","28270640","28288755","18115","2024-09"
"020150","롯데에너지머티리얼즈","1669212227000","36200","46110835","46110835","0","2024-09"
"280360","롯데웰푸드","1159090103700","131100","8841267","9434574","593307","2024-09"
"286940","롯데이노베이트","341923694200","22600","15129367","15129367","0","2024-09"
"004000","롯데정밀화학","1157611500000","45450","25470000","25800000","330000","2024-09"
"004990","롯데지주","1681625875000","23750","70805300","104909237","34103937","2024-09"
"005300","롯데칠성","1103259307600","118900","9278884","9278884","0","2024-09"
"011170","롯데케미칼","3841427091700","91100","42167147","42775419","608272","2024-09"
"071840","롯데하이마트","183928910400","7950","23135712","23607712","472000","2024-09"
"328130","루닛","1098623433600","38050","28873152","28873152","0","2024-09"
"038060","루멘스","59407290215","1235","48103069","48103069","0","2024-09"
"474170","루미르","161254142400","9400","17154696","17154696",,"자료 없음"
"141080","리가켐바이오","4771982588000","131000","36427348","36567348","140000","2024-09"
"058470","리노공업","2745902808000","180900","15179120","15242370","63250","2024-09"
"016100","리더스코스메틱","48039866740","2620","18335827","19100894","765067","2024-09"
"012700","리드코프","110825709160","4330","25594852","26446135","851283","2024-09"
"302550","리메드","99880140800","3260","30638080","30638080","0","2024-09"
"073570","리튬포어스","60429162090","1670","36185127","36189497","4370","2024-09"
"377450","리파인","208006315200","13680","15205140","17330000","2124860","2024-09"
"277070","린드먼아시아","51184578000","4040","12669450","13692000","1022550","2024-09"
"042500","링네트","75356498880","4680","16101816","19070134","2968318","2024-09"
"193250","링크드","28242226142","446","63323377","63323377","0","2024-09"
"219420","링크제니시스","48226633745","4285","11254757","11469507","214750","2024-09"
"439090","마녀공장","304635636000","18600","16378260","16378260","0","2024-09"
"027740","마니커","58357619342","919","63501218","63511228","10010","2024-09"
"195500","마니커에프앤지","46016640000","2880","15978000","15978000","0","2024-09"
"377480","마음AI","64451411180","10330","6239246","6239246","0","2024-09"
"305090","마이크로디지탈","232674042300","14070","16536890","16536890","0","2024-09"
"098120","마이크로컨텍솔","42977000220","5170","8312766","8312766","0","2024-09"
"424980","마이크로투나노","53270010000","9000","5918890","5918890","0","2024-09"
"038290","마크로젠","177727005170","17810","9979057","10841400","862343","2024-09"
"001080","만호제강","90606671800","30650","2956172","4150000","1193828","2024-09"
"267980","매일유업","273151792200","37850","7216692","7843638","626946","2024-09"
"005990","매일홀딩스","104830742750","8390","12494725","13718304","1223579","2024-09"
"093520","매커스","84599972840","8620","9814382","16163092","6348710","2024-09"
"377030","맥스트","44034484500","2250","19570882","19570882","0","2024-09"
"100590","머큐리","53426327625","3375","15830023","15830023","0","2024-09"
"067280","멀티캠퍼스","178692386850","30150","5926779","5926779","0","2024-09"
"072870","메가스터디","126617722200","11100","11407002","11920959","513957","2024-09"
"215200","메가스터디교육","453488773050","42150","10758927","11461955","703028","2024-09"
"133750","메가엠디","44149970000","2000","22074985","23407077","1332092","2024-09"
"446540","메가터치","84018695000","4045","20771000","20771000","0","2024-09"
"235980","메드팩토","188723505900","5620","33580695","33580695","0","2024-09"
"041920","메디아나","85189711500","4590","18559850","18598223","38373","2024-09"
"014100","메디앙스","25031079295","2215","11300713","11800000","499287","2024-09"
"054180","메디콕스","20899285940","355","58871228","58878283","7055","2024-09"
"086900","메디톡스","1169899244800","173800","6731296","7298497","567201","2024-09"
"078160","메디포스트","229143835200","6720","34098785","34217785","119000","2024-09"
"138040","메리츠금융지주","19426157205000","105000","185011021","190720114","5709093","2024-09"
"408920","메쎄이상","93393150060","2170","43038318","43232455","194137","2024-09"
"021880","메이슨캐피탈","47177166480","310","152184408","152184408","0","2024-09"
"140410","메지온","918240836700","30650","29958918","29958918","0","2024-09"
"241770","메카로","75330697500","7650","9847150","10192640","345490","2024-09"
"090370","메타랩스","40241032464","1616","24901629","24904689","3060","2024-09"
"059210","메타바이오메드","89540387820","3915","22871108","23862351","991243","2024-09"
"118000","메타케어","56353121820","342","164775210","164777364","2154","2024-09"
"058110","멕아이씨에스","38898800300","2510","15497530","16050530","553000","2024-09"
"017180","명문제약","74210894820","2220","33428331","33953454","525123","2024-09"
"009900","명신산업","630690998660","12020","52470133","52470133","0","2024-09"
"012690","모나리자","111144756000","3040","36560775","36571255","10480","2024-09"
"005360","모나미","42802400355","2265","18897307","18897307","0","2024-09"
"070960","모나용평","183068349210","3870","47304483","48133333","828850","2024-09"
"434480","모니터랩","44116125000","3750","11764300","12253300","489000","2024-09"
"080420","모다이노칩","153065514240","1920","79721622","79721622","0","2024-09"
"417970","모델솔루션","60128980000","9400","6396700","6396700","0","2024-09"
"080160","모두투어","172084152660","9940","17312289","18900000","1587711","2024-09"
"087260","모바일어플라이언스","70314179760","2160","32552861","32552861","0","2024-09"
"101330","모베이스","71755789900","3100","23147029","23147029","0","2024-09"
"012860","모베이스전자","126826851280","1745","72680144","73233457","553313","2024-09"
"363260","모비데이즈","83758065600","2640","31726540","32163769","437229","2024-09"
"348030","모비릭스","50323912000","5240","9603800","9603800","0","2024-09"
"250060","모비스","103493680010","3230","32041387","32171314","129927","2024-09"
"288980","모아데이타","54979490142","1591","34556562","34556562","0","2024-09"
"142760","모아라이프플러스","49130723922","1302","37734811","37734811","0","2024-09"
"033200","모아텍","29362447510","3190","9204529","14331185","5126656","2024-09"
"333050","모코엠시스","29397845696","1279","22985024","24444326","1459302","2024-09"
"009680","모토닉","186862671360","8640","21627624","33000000","11372376","2024-09"
"118990","모트렉스","247950220000","10000","24795022","24861990","66968","2024-09"
"006920","모헨즈","28392000000","2600","10920000","10920000","0","2024-09"
"009580","무림P&P","173059483950","2775","62363778","62368324","4546","2024-09"
"001810","무림SP","35132212500","1587","22137500","22137500","0","2024-09"
"009200","무림페이퍼","84050806200","2020","41609310","41609310","0","2024-09"
"033920","무학","152829228360","5770","26486868","28500000","2013132","2024-09"
"008420","문배철강","43659959400","2280","19149105","20503505","1354400","2024-09"
"279600","미디어젠","52938025300","11300","4684781","4684781","0","2024-09"
"095500","미래나노텍","285709896810","10070","28372383","31009999","2637616","2024-09"
"254490","미래반도체","233173700000","16150","14438000","14438000","0","2024-09"
"025560","미래산업","30865354015","991","31145665","31166865","21200","2024-09"
"218150","미래생명자원","88607361105","4545","19495569","20415802","920233","2024-09"
"007120","미래아이앤지","28552654130","1045","27323114","28878608","1555494","2024-09"
"442900","미래에셋드림스팩1호","76646400000","9980","7680000","7680000","0","2024-09"
"100790","미래에셋벤처투자","251791539720","4740","53120578","53124634","4056","2024-09"
"412930","미래에셋비전스팩1호","16644320000","2695","6176000","6176000","0","2024-09"
"446190","미래에셋비전스팩2호","10865250000","2195","4950000","4950000","0","2024-09"
"448830","미래에셋비전스팩3호","10651800000","2165","4920000","4920000","0","2024-09"
"477380","미래에셋비전스팩4호","16402500000","2025","8100000","8100000","0","2024-09"
"477470","미래에셋비전스팩5호","11398400000","2080","5480000","5480000","0","2024-09"
"478440","미래에셋비전스팩6호","13998600000","2020","6930000","6930000","0","2024-09"
"482680","미래에셋비전스팩7호","16323205000","1987","8215000","8215000","0","2024-09"
"085620","미래에셋생명","688934400000","5280","130480000","177016189","46536189","2024-09"
"006800","미래에셋증권","4060336981840","9040","449152321","595316408","146164087","2024-09"
"049950","미래컴퍼니","146721902790","18510","7926629","8817884","891255","2024-09"
"207760","미스터블루","112289003545","1363","82383715","83079783","696068","2024-09"
"002840","미원상사","920015029500","198100","4644195","4750000","105805","2024-09"
"268280","미원에스씨","714887157600","146400","4883109","5000000","116891","2024-09"
"107590","미원홀딩스","185004455000","79900","2315450","2320000","4550","2024-09"
"134380","미원화학","160003105800","79900","2002542","2199268","196726","2024-09"
"003650","미창석유","143127813400","94600","1512979","1739672","226693","2024-09"
"059090","미코","317165696790","10070","31496097","33416778","1920681","2024-09"
"214610","미코바이오메드","70566524460","1620","43559583","43568945","9362","2024-09"
"201490","미투온","65642795790","2145","30602702","31257770","655068","2024-09"
"452200","민테크","145936245000","6650","21945300","21945300","0","2024-09"
"418470","밀리의서재","115845309070","13630","8499289","8499289","0","2024-09"
"206640","바디텍메드","351622336000","16000","21976396","23486560","1510164","2024-09"
"018700","바른손","39212999952","1139","34427568","35119757","692189","2024-09"
"035620","바른손이앤에이","35276934725","475","74267231","74439675","172444","2024-09"
"053030","바이넥스","689502185400","21650","31847676","32684188","836512","2024-09"
"301300","바이브컴퍼니","50973979000","4120","12372325","12394861","22536","2024-09"
"377740","바이오노트","471936534400","4640","101710460","102056048","345588","2024-09"
"064550","바이오니아","607832353050","23550","25810291","25810291","0","2024-09"
"314930","바이오다인","554163088000","18800","29476760","29764103","287343","2024-09"
"208710","바이오로그디바이스","29589398136","449","65900664","65900664","0","2024-09"
"086820","바이오솔루션","128377888000","16000","8023618","8143426","119808","2024-09"
"038460","바이오스마트","81919002600","3555","23043320","23933216","889896","2024-09"
"251120","바이오에프디엔씨","140727658500","16500","8528949","8695700","166751","2024-09"
"199730","바이오인프라","42417280240","8720","4864367","4864367","0","2024-09"
"086040","바이오톡스텍","70114718940","4460","15720789","15958247","237458","2024-09"
"099430","바이오플러스","309097853730","5490","56301977","57930864","1628887","2024-09"
"032980","바이온","29590993610","661","44767010","44777990","10980","2024-09"
"308080","바이젠셀","61547649300","3195","19263740","19263740","0","2024-09"
"043150","바텍","343133313600","23100","14854256","14854256","0","2024-09"
"323990","박셀바이오","291420076050","12690","22964545","22993200","28655","2024-09"
"003610","방림","112907526710","3190","35394209","42314090","6919881","2024-09"
"267790","배럴","35656020000","4520","7888500","7888500","0","2024-09"
"001340","백광산업","410586695100","9300","44149107","44918407","769300","2024-09"
"046310","백금T&A","39159774705","2435","16082043","16418641","336598","2024-09"
"035150","백산","288530000000","13420","21500000","21500000","0","2024-09"
"331520","밸로프","33801281696","689","49058464","50864390","1805926","2024-09"
"199480","뱅크웨어글로벌","76065334140","7530","10101638","10101638","0","2024-09"
"438700","버넥트","38784217200","3480","11144890","11144890","0","2024-09"
"066410","버킷스튜디오","96977294204","1153","84108668","84109926","1258","2024-09"
"002410","범양건영","25376210944","1022","24829952","24831982","2030","2024-09"
"382900","범한퓨얼셀","120841600000","14080","8582500","8761000","178500","2024-09"
"206400","베노티앤알","132919663000","4100","32419430","32420452","1022","2024-09"
"019010","베뉴지","87033000000","2165","40200000","48200000","8000000","2024-09"
"177350","베셀","27296167266","306","89203161","89372043","168882","2024-09"
"424760","벨로크","20188733436","1041","19393596","19665002","271406","2024-09"
"007210","벽산","114203045400","2040","55981885","67560000","11578115","2024-09"
"225530","보광산업","141720348900","3900","36338551","36338727","176","2024-09"
"250000","보라티알","63396314080","9680","6549206","6750733","201527","2024-09"
"002760","보락","74575500000","1245","59900000","59900000","0","2024-09"
"003850","보령","731768038100","11110","65865710","68690000","2824290","2024-09"
"310210","보로노이","2017938668400","112400","17953191","18356592","403401","2024-09"
"006910","보성파워텍","159021928000","3250","48929824","49129824","200000","2024-09"
"000890","보해양조","58133597456","418","139075592","139120129","44537","2024-09"
"226340","본느","69766807940","1663","41952380","41952420","40","2024-09"
"003000","부광약품","337481528030","4930","68454671","68454671","0","2024-09"
"001270","부국증권","163325855000","27500","5939122","10369886","4430764","2024-09"
"026940","부국철강","49100000000","2455","20000000","20000000","0","2024-09"
"014470","부방","90213354561","1681","53666481","60052260","6385779","2024-09"
"011390","부산산업","56812800000","53800","1056000","1056000","0","2024-09"
"005030","부산주공","38288532168","486","78782988","78782988","0","2024-09"
"008470","부스타","31721108175","3925","8081811","8404800","322989","2024-09"
"338220","뷰노","404147114700","29100","13888217","13888217","0","2024-09"
"100120","뷰웍스","230925061650","25150","9181911","10001865","819954","2024-09"
"406820","뷰티스킨","49299858000","13950","3534040","3534040","0","2024-09"
"337930","브랜드엑스코퍼레이션","248561918560","8480","29311547","29311547","0","2024-09"
"099390","브레인즈컴퍼니","49080741210","6210","7903501","8208283","304782","2024-09"
"064480","브리지텍","57488651840","4960","11590454","11952500","362046","2024-09"
"288330","브릿지바이오테라퓨틱스","251602921810","5290","47561989","47561989","0","2024-09"
"365900","브이씨","23831578000","3260","7310300","7310300","0","2024-09"
"089970","브이엠","182409923520","8280","22030184","24075595","2045411","2024-09"
"251630","브이원텍","61508459350","4030","15262645","15942886","680241","2024-09"
"018290","브이티","1123338479550","31650","35492527","35798007","305480","2024-09"
"439580","블루엠텍","251888483550","22550","11170221","11170221","0","2024-09"
"033560","블루콤","59301733325","3475","17065247","17100000","34753","2024-09"
"369370","블리츠웨이스튜디오","79749934182","1674","47640343","49871911","2231568","2024-09"
"126340","비나텍","216072159850","36550","5911687","6085118","173431","2024-09"
"121800","비덴트","256296018720","3320","77197596","77201611","4015","2024-09"
"082800","비보존 제약","193872395520","4080","47517744","48242965","725221","2024-09"
"318410","비비씨","46886250920","8440","5555243","5555243","0","2024-09"
"002070","비비안","24192719880","812","29793990","29793990","0","2024-09"
"100220","비상교육","62237696200","5080","12251515","12996741","745226","2024-09"
"419540","비스토스","42187484925","1835","22990455","22992511","2056","2024-09"
"146320","비씨엔씨","170119753600","13400","12695504","12792923","97419","2024-09"
"200780","비씨월드제약","41138004375","4875","8438565","8892384","453819","2024-09"
"413640","비아이매트릭스","54124119400","7510","7206940","7206940","0","2024-09"
"141000","비아트론","74023505490","6710","11031819","12114710","1082891","2024-09"
"090460","비에이치","505881241320","16120","31382211","34464379","3082168","2024-09"
"083650","비에이치아이","358928754400","11600","30942134","30944375","2241","2024-09"
"445360","비엔케이제1호스팩","9072550000","2105","4310000","4310000","0","2024-09"
"473370","비엔케이제2호스팩","8525250000","2025","4210000","4210000","0","2024-09"
"065170","비엘팜텍","23309813024","262","88968752","88970559","1807","2024-09"
"086670","비엠티","78476496400","8600","9125174","9125174","0","2024-09"
"335890","비올","494856995800","8570","57742940","58419125","676185","2024-09"
"230980","비유테크놀러지","21370405721","229","93320549","93320557","8","2024-09"
"138580","비즈니스온","356491745760","15870","22463248","22556163","92915","2024-09"
"082920","비츠로셀","458124253800","20450","22402164","22872213","470049","2024-09"
"054220","비츠로시스","21679824159","441","49160599","49160599","0","2024-09"
"042370","비츠로테크","181304173000","6920","26200025","26200025","0","2024-09"
"050090","비케이홀딩스","15485579430","786","19701755","19784735","82980","2024-09"
"148780","비큐AI","33363914225","1061","31445725","31445725","0","2024-09"
"307870","비투엔","39409154730","870","45297879","45297879","0","2024-09"
"357880","비트나인","19342206512","1852","10443956","10443956","0","2024-09"
"032850","비트컴퓨터","78506620720","4870","16120456","16623293","502837","2024-09"
"238200","비피도","33169900000","4055","8180000","8180000","0","2024-09"
"093190","빅솔론","68629089840","4560","15050239","19238905","4188666","2024-09"
"065450","빅텍","142977472000","4990","28652800","28652800","0","2024-09"
"210120","빅텐츠","78929711000","25100","3144610","3144610","0","2024-09"
"044480","빌리언스","23991599520","590","40663728","40663728","0","2024-09"
"005180","빙그레","551728382400","62400","8841801","9851241","1009440","2024-09"
"069540","빛과전자","60108237120","1416","42449320","42449320","0","2024-09"
"072950","빛샘전자","31481752320","3930","8010624","8052610","41986","2024-09"
"451250","삐아","95805034700","10100","9485647","9682187","196540","2024-09"
"143240","사람인","181733825880","16740","10856262","11709263","853001","2024-09"
"003960","사조대림","360322392150","43150","8350461","9164467","814006","2024-09"
"008040","사조동아원","144187956462","1023","140946194","141144600","198406","2024-09"
"007160","사조산업","304073700000","60900","4993000","5000000","7000","2024-09"
"014710","사조씨푸드","115536423530","6710","17218543","17218543","0","2024-09"
"006090","사조오양","82166257920","8720","9422736","9422739","3","2024-09"
"452430","사피엔반도체","94068129680","11620","8095364","8096454","1090","2024-09"
"419120","산돌","46898002210","6410","7316381","7774326","457945","2024-09"
"062040","산일전기","1265512217550","41650","30384447","30445200","60753","2024-09"
"122350","삼기","58195083744","1533","37961568","38339428","377860","2024-09"
"419050","삼기이브이","127547615200","2230","57196240","57196240","0","2024-09"
"014970","삼륭물산","59249941600","3980","14886920","15125000","238080","2024-09"
"018310","삼목에스폼","318651244800","22400","14225502","14700000","474498","2024-09"
"053700","삼보모터스","94584207780","4255","22228956","22877190","648234","2024-09"
"009620","삼보산업","19110195083","259","73784537","73785902","1365","2024-09"
"023600","삼보판지","144997468500","9250","15675402","16170000","494598","2024-09"
"001470","삼부토건","100625320800","450","223611824","223611824","0","2024-09"
"028050","삼성E&A","3884720000000","19820","196000000","196000000","0","2024-09"
"006400","삼성SDI","21429353022500","327500","65433139","68764530","3331391","2024-09"
"006660","삼성공조","81830574060","10410","7860766","8126314","265548","2024-09"
"028260","삼성물산","21665588821600","133600","162167581","177784107","15616526","2024-09"
"207940","삼성바이오로직스","74092134000000","1041000","71174000","71174000","0","2024-09"
"032830","삼성생명","18065222767400","100600","179574779","200000000","20425221","2024-09"
"425290","삼성스팩6호","11647200000","2110","5520000","5520000","0","2024-09"
"439250","삼성스팩7호","36420800000","10400","3502000","3502000","0","2024-09"
"448740","삼성스팩8호","46873200000","10050","4664000","4664000","0","2024-09"
"468510","삼성스팩9호","22321000000","2020","11050000","11050000","0","2024-09"
"018260","삼성에스디에스","11231247007200","145200","77350186","77377800","27614","2024-09"
"009150","삼성전기","8657819193600","119100","72693696","74693696","2000000","2024-09"
"005930","삼성전자","337889692330000","56600","5969782550","5969782550","0","2024-09"
"001360","삼성제약","160004503200","1700","94120296","94162079","41783","2024-09"
"010140","삼성중공업","8583057488550","10050","854035571","880000000","25964429","2024-09"
"016360","삼성증권","4206030000000","47100","89300000","89300000","0","2024-09"
"068290","삼성출판사","140500000000","14050","10000000","10000000","0","2024-09"
"029780","삼성카드","4337789751750","40650","106710695","115858891","9148196","2024-09"
"000810","삼성화재","13800504564000","346500","39828296","47374837","7546541","2024-09"
"006110","삼아알미늄","712056734400","48400","14711916","14711916","0","2024-09"
"009300","삼아제약","131832187200","21600","6103342","6370000","266658","2024-09"
"145990","삼양사","480900912500","49750","9666350","10313449","647099","2024-09"
"003230","삼양식품","4012472864000","538000","7458128","7533015","74887","2024-09"
"002170","삼양통상","127099000000","46900","2710000","3000000","290000","2024-09"
"272550","삼양패키징","252484419880","16280","15508871","15788671","279800","2024-09"
"000070","삼양홀딩스","533128576500","71700","7435545","8564271","1128726","2024-09"
"003720","삼영","153051606175","4615","33163945","34000000","836055","2024-09"
"002810","삼영무역","222995515600","12650","17628104","18466948","838844","2024-09"
"361670","삼영에스앤씨","35588648040","6380","5578158","5667658","89500","2024-09"
"054540","삼영엠텍","48944550000","4035","12130000","13000000","870000","2024-09"
"065570","삼영이엔씨","27172308476","1996","13613381","13613381","0","2024-09"
"005680","삼영전자","193378676480","9680","19977136","20000000","22864","2024-09"
"023000","삼원강재","102330386700","2575","39739956","40000000","260044","2024-09"
"004380","삼익THK","180918000000","8740","20700000","21000000","300000","2024-09"
"002450","삼익악기","83481944670","1098","76030915","90530915","14500000","2024-09"
"032280","삼일","22847290560","1473","15510720","16213590","702870","2024-09"
"002290","삼일기업공사","35402000000","2855","12400000","12400000","0","2024-09"
"004440","삼일씨엔에스","55002011040","4320","12731947","12731947","0","2024-09"
"000520","삼일제약","341293734460","16130","21158942","21621100","462158","2024-09"
"009770","삼정펄프","66874224250","26750","2499971","2499971","0","2024-09"
"037460","삼지전자","133101077040","8670","15351912","16318522","966610","2024-09"
"032750","삼진","37544241280","4160","9025058","9031122","6064","2024-09"
"054090","삼진엘앤디","21688601375","875","24786973","24959232","172259","2024-09"
"005500","삼진제약","227622494600","18170","12527380","13900000","1372620","2024-09"
"000250","삼천당제약","2888578022400","124200","23257472","23457472","200000","2024-09"
"004690","삼천리","301999005000","88200","3424025","4055025","631000","2024-09"
"024950","삼천리자전거","48531698680","4010","12102668","13273577","1170909","2024-09"
"038500","삼표시멘트","334943082240","3120","107353552","107916306","562754","2024-09"
"437730","삼현","79585993170","7530","10569189","10569189","0","2024-09"
"017480","삼현철강","73817014200","4780","15442890","15702890","260000","2024-09"
"010960","삼호개발","71328400000","3190","22360000","25000000","2640000","2024-09"
"046390","삼화네트웍스","64451520408","1628","39589386","43172933","3583547","2024-09"
"004450","삼화왕관","57196912300","31700","1804319","2154379","350060","2024-09"
"009470","삼화전기","250994469000","37950","6613820","6613820","0","2024-09"
"011230","삼화전자","49435155900","2925","16900908","16902700","1792","2024-09"
"001820","삼화콘덴서","339639100000","33100","10261000","10395000","134000","2024-09"
"000390","삼화페인트","164191063200","6960","23590670","27203469","3612799","2024-09"
"027580","상보","67429694871","1197","56332243","59181279","2849036","2024-09"
"038540","상상인","88324981464","1614","54724276","55328313","604037","2024-09"
"415580","상상인제3호스팩","11151000000","2100","5310000","5310000","0","2024-09"
"452670","상상인제4호스팩","10518300000","2015","5220000","5220000","0","2024-09"
"001290","상상인증권","50581588316","476","106263841","108337120","2073279","2024-09"
"041650","상신브레이크","65631450900","3390","19360310","21471450","2111140","2024-09"
"091580","상신이디피","133148907810","9990","13328219","13428219","100000","2024-09"
"263810","상신전자","47066792535","3305","14241087","14244718","3631","2024-09"
"089980","상아프론테크","331299038750","21250","15590543","15989037","398494","2024-09"
"042940","상지건설","23675323700","5950","3979046","3981814","2768","2024-09"
"042600","새로닉스","164514603050","13450","12231569","12423574","192005","2024-09"
"075180","새론오토모티브","74496000000","3880","19200000","19200000","0","2024-09"
"107600","새빗켐","112084762500","22500","4981545","4981545","0","2024-09"
"411080","샌즈랩","105332139120","7240","14548638","15248638","700000","2024-09"
"252990","샘씨엔에스","328399914240","5760","57013874","58388063","1374189","2024-09"
"007540","샘표","88882138800","44100","2015468","2875800","860332","2024-09"
"248170","샘표식품","130147986000","28500","4566596","4568286","1690","2024-09"
"378800","샤페론","148906573140","4940","30143031","30143031","0","2024-09"
"294630","서남","84767387565","3535","23979459","23979459","0","2024-09"
"038070","서린바이오","61051522620","7230","8444194","8900676","456482","2024-09"
"006730","서부T&D","391483144640","6070","64494752","66426923","1932171","2024-09"
"079650","서산","24020000000","1201","20000000","20000000","0","2024-09"
"100660","서암기계공업","47187000000","3745","12600000","12600000","0","2024-09"
"007860","서연","148694909100","6850","21707286","23479844","1772558","2024-09"
"200880","서연이화","362915545930","13430","27022751","27028437","5686","2024-09"
"019770","서연탑메탈","42056500000","3610","11650000","11650000","0","2024-09"
"017390","서울가스","202293463200","52100","3882792","5000000","1117208","2024-09"
"043710","서울리거","31725352776","632","50198343","50198880","537","2024-09"
"092190","서울바이오시스","184077768710","4070","45227953","45868383","640430","2024-09"
"046890","서울반도체","516453074400","9160","56381340","58305400","1924060","2024-09"
"004410","서울식품","58087088395","155","374755409","374755559","150","2024-09"
"063170","서울옥션","115165203120","6840","16837018","17774267","937249","2024-09"
"027040","서울전자통신","18580040856","267","69588168","69588847","679","2024-09"
"018680","서울제약","47803207900","4100","11659319","11659319","0","2024-09"
"021050","서원","59580610450","1255","47474590","47474590","0","2024-09"
"093920","서원인텍","107322000000","5770","18600000","18600000","0","2024-09"
"189860","서전기전","50627631600","5220","9698780","9698780","0","2024-09"
"178320","서진시스템","1583379905100","28150","56247954","56247954","0","2024-09"
"122690","서진오토모티브","50717283440","2335","21720464","21844410","123946","2024-09"
"140070","서플러스글로벌","110587626540","3210","34450974","36988000","2537026","2024-09"
"011370","서한","77672138215","791","98194865","100894865","2700000","2024-09"
"065710","서호전기","106993629400","21700","4930582","5150000","219418","2024-09"
"008490","서흥","179684866080","16160","11119113","11569113","450000","2024-09"
"035890","서희건설","272565013200","1410","193308520","229808457","36499937","2024-09"
"357550","석경에이티","245026950000","45050","5439000","5455000","16000","2024-09"
"003100","선광","97998200000","15580","6290000","6600000","310000","2024-09"
"007610","선도전기","50907057000","3000","16969019","18000000","1030981","2024-09"
"067370","선바이오","83060997750","6750","12305333","12313555","8222","2024-09"
"171090","선익시스템","389177574450","44450","8755401","9494405","739004","2024-09"
"136490","선진","157893941120","6640","23779208","23779604","396","2024-09"
"086710","선진뷰티사이언스","122744857200","10220","12010260","12203280","193020","2024-09"
"014620","성광벤드","350190957720","13080","26773009","28600000","1826991","2024-09"
"037350","성도이엔지","65617860000","4620","14203000","15470000","1267000","2024-09"
"014910","성문전자","26112629306","1258","20757257","22460985","1703728","2024-09"
"003080","성보화학","51418555125","2625","19588021","20020000","431979","2024-09"
"004980","성신양회","191715021150","7950","24115097","24516073","400976","2024-09"
"011300","성안머티리얼스","37095211452","453","81887884","81887884","0","2024-09"
"081580","성우전자","72298343745","4755","15204699","15508143","303444","2024-09"
"045300","성우테크론","26039112400","2660","9789140","10151583","362443","2024-09"
"015750","성우하이텍","491948296950","6150","79991593","80000000","8407","2024-09"
"365340","성일하이텍","637210717500","52500","12137347","12137347","0","2024-09"
"000180","성창기업지주","98838017200","1417","69751600","69751600","0","2024-09"
"080470","성창오토텍","30185500000","4135","7300000","7300000","0","2024-09"
"043260","성호전자","94248382005","1545","61002189","61002189","0","2024-09"
"148150","세경하이테크","233282237110","6590","35399429","35860429","461000","2024-09"
"002420","세기상사","32241318400","5800","5558848","5558848","0","2024-09"
"188260","세니젠","20585072900","2900","7098301","7228470","130169","2024-09"
"053060","세동","20217129890","1145","17656882","17657419","537","2024-09"
"340440","세림B&G","38736460035","1365","28378359","28378364","5","2024-09"
"017510","세명전기","76839840000","5040","15246000","15246000","0","2024-09"
"004360","세방","214351021800","11950","17937324","19308690","1371366","2024-09"
"004490","세방전지","926075251200","70400","13154478","14000000","845522","2024-09"
"011560","세보엠이씨","98878691340","9970","9917622","10530000","612378","2024-09"
"396300","세아메카닉스","77128077500","2945","26189500","26489500","300000","2024-09"
"001430","세아베스틸지주","708994092630","19770","35862119","35862119","0","2024-09"
"306200","세아제강","319491410000","114100","2800100","2836300","36200","2024-09"
"003030","세아제강지주","658191096900","162900","4040461","4141657","101196","2024-09"
"019440","세아특수강","114074359230","13670","8344869","8570000","225131","2024-09"
"058650","세아홀딩스","380211438400","97600","3895609","4000000","104391","2024-09"
"013000","세우글로벌","34673201048","1208","28702981","28705031","2050","2024-09"
"100700","세운메디칼","119050525000","2750","43291100","43800000","508900","2024-09"
"024830","세원물산","51937000000","6220","8350000","8350000","0","2024-09"
"091090","세원이앤씨","54828158060","1270","43171778","43180255","8477","2024-09"
"021820","세원정공","71200000000","7120","10000000","10000000","0","2024-09"
"067830","세이브존I&C","80334553890","2130","37715753","41040895","3325142","2024-09"
"258830","세종메디칼","22974088612","412","55762351","55786351","24000","2024-09"
"036630","세종텔레콤","93453315888","492","189945764","200000000","10054236","2024-09"
"039310","세중","30553130562","1686","18121667","18121667","0","2024-09"
"075580","세진중공업","422959952640","7440","56849456","56849456","0","2024-09"
"067770","세진티에스","19868175155","2395","8295689","8396593","100904","2024-09"
"053450","세코닉스","77091125190","5270","14628297","14792803","164506","2024-09"
"222810","세토피아","81189010800","1080","75175010","75659350","484340","2024-09"
"252500","세화피앤씨","38001533240","916","41486390","41486390","0","2024-09"
"321370","센서뷰","56902489200","2160","26343745","26343745","0","2024-09"
"347000","센코","79925178855","2455","32556081","33004976","448895","2024-09"
"331920","셀레믹스","31636073500","3875","8164148","8164148","0","2024-09"
"049180","셀루메드","147785254065","2895","51048447","51057455","9008","2024-09"
"299660","셀리드","102349438450","4850","21102977","21102977","0","2024-09"
"268600","셀리버리","248384003120","6680","37183234","37183234","0","2024-09"
"108860","셀바스AI","272910758640","10140","26914276","26914790","514","2024-09"
"208370","셀바스헬스케어","105442073900","4100","25717579","25740564","22985","2024-09"
"318160","셀바이오휴먼텍","30014997300","3420","8776315","9260901","484586","2024-09"
"308430","셀비온","264971387200","20800","12739009","12739009","0","2024-09"
"068270","셀트리온","38313042467700","185900","206094903","217021190","10926287","2024-09"
"068760","셀트리온제약","2566218502000","62000","41390621","41600387","209766","2024-09"
"068940","셀피글로벌","29334496224","778","37705008","38260597","555589","2024-09"
"060230","소니드","37160941272","812","45764706","46066730","302024","2024-09"
"290690","소룩스","408214087680","8960","45559608","45564340","4732","2024-09"
"032680","소프트센","40460410304","388","104279408","105590764","1311356","2024-09"
"258790","소프트캠프","21221107020","885","23978652","24991284","1012632","2024-09"
"066910","손오공","53187444961","1579","33684259","33784259","100000","2024-09"
"336370","솔루스첨단소재","832015731300","11850","70212298","70217344","5046","2024-09"
"248070","솔루엠","1000189378800","20550","48671016","50005551","1334535","2024-09"
"035610","솔본","99716081325","3885","25666945","27345997","1679052","2024-09"
"357780","솔브레인","1511461318400","195200","7743142","7778566","35424","2024-09"
"036830","솔브레인홀딩스","986591065750","47750","20661593","20964056","302463","2024-09"
"304100","솔트룩스","226841621600","18700","12130568","12130568","0","2024-09"
"328380","솔트웨어","35799807505","1045","34258189","34262778","4589","2024-09"
"004430","송원산업","294240000000","12260","24000000","24000000","0","2024-09"
"086980","쇼박스","265049310000","4245","62438000","62638000","200000","2024-09"
"050960","수산아이앤티","67442490000","9990","6751000","6751000","0","2024-09"
"126720","수산인더스트리","318780063750","22650","14074175","14286000","211825","2024-09"
"017550","수산중공업","106764911430","1711","62399130","62399130","0","2024-09"
"084180","수성웹툰","72361811368","616","117470473","117470473","0","2024-09"
"253840","수젠텍","94337251560","6170","15289668","16743200","1453532","2024-09"
"298830","슈어소프트테크","245569928180","4705","52193396","52619061","425665","2024-09"
"236200","슈프리마","181800402100","26350","6899446","7193273","293827","2024-09"
"094840","슈프리마에이치큐","53090984400","5800","9153618","10471840","1318222","2024-09"
"192440","슈피겐코리아","125721997200","20850","6029832","6216363","186531","2024-09"
"424960","스마트레이더시스템","161639469000","10350","15617340","15617340","0","2024-09"
"099440","스맥","116144307580","3115","37285492","40243394","2957902","2024-09"
"053210","스카이라이프","237414534640","5020","47293732","47522955","229223","2024-09"
"276040","스코넥","38040056220","3030","12554474","12554474","0","2024-09"
"159910","스킨앤스킨","27314020050","755","36177510","36410098","232588","2024-09"
"060240","스타코링크","17593615590","579","30386210","31136323","750113","2024-09"
"115570","스타플렉스","24104004990","3055","7890018","7984508","94490","2024-09"
"330730","스톤브릿지벤처스","67473821520","3870","17435096","18150830","715734","2024-09"
"352090","스톰테크","88277798430","3285","26872998","26872998","0","2024-09"
"253450","스튜디오드래곤","1166269722400","38800","30058498","30058498","0","2024-09"
"408900","스튜디오미르","144233684910","4410","32706051","32706134","83","2024-09"
"204630","스튜디오산타클로스","23613109200","4650","5078088","5089941","11853","2024-09"
"415380","스튜디오삼익","33410151200","8240","4054630","4225498","170868","2024-09"
"026890","스틱인베스트먼트","292023234100","7990","36548590","41678175","5129585","2024-09"
"013810","스페코","70859197450","4835","14655470","14655470","0","2024-09"
"203690","스피어파워","66773121870","5070","13170241","13337850","167609","2024-09"
"049830","승일","41943434600","7100","5907526","6132112","224586","2024-09"
"020710","시공테크","66493009125","3525","18863265","20047970","1184705","2024-09"
"033170","시그네틱스","84871035810","990","85728319","85728319","0","2024-09"
"048870","시너지이노베이션","227861487720","2755","82708344","82708344","0","2024-09"
"025320","시노펙스","542572303000","6500","83472662","83817936","345274","2024-09"
"134790","시디즈","49613208900","29550","1678958","2000000","321042","2024-09"
"269620","시스웍","131663951937","889","148103433","148582691","479258","2024-09"
"429270","시지트로닉스","30191875000","6700","4506250","4506250","0","2024-09"
"418250","시큐레터","52279100100","6550","7981542","7981542","0","2024-09"
"131090","시큐브","34832725590","897","38832470","44000000","5167530","2024-09"
"232830","시큐센","24234467040","2070","11707472","11707472","0","2024-09"
"462870","시프트업","3383413760000","58000","58334720","58334720","0","2024-09"
"016590","신대양제지","182193064020","5940","30672233","40297820","9625587","2024-09"
"290520","신도기연","33990114240","2160","15736164","15929362","193198","2024-09"
"029530","신도리코","343186604200","39800","8622779","10080029","1457250","2024-09"
"004970","신라교역","149641800000","9480","15785000","16000000","215000","2024-09"
"001000","신라섬유","26535351220","1093","24277540","24277540","0","2024-09"
"025870","신라에스지","24760000000","6190","4000000","4000000","0","2024-09"
"215600","신라젠","327441718125","2385","137292125","137367125","75000","2024-09"
"065350","신성델타테크","1220559265200","44900","27183948","27483948","300000","2024-09"
"416180","신성에스티","234119328700","26150","8952938","9039778","86840","2024-09"
"011930","신성이엔지","302499074514","1486","203565999","205848151","2282152","2024-09"
"005390","신성통상","321188251650","2235","143708390","143708390","0","2024-09"
"004170","신세계","1370120251500","148500","9226399","9845181","618782","2024-09"
"035510","신세계 I&C","130800809500","9950","13145810","17200000","4054190","2024-09"
"034300","신세계건설","138122020400","18200","7589122","7760554","171432","2024-09"
"031430","신세계인터내셔날","439442010000","12690","34629000","35700000","1071000","2024-09"
"031440","신세계푸드","134174883150","34650","3872291","3872480","189","2024-09"
"006880","신송홀딩스","69593571450","6450","10789701","11828858","1039157","2024-09"
"162300","신스틸","100703000160","2455","41019552","41471382","451830","2024-09"
"290560","신시웨이","24609005900","6350","3875434","3877972","2538","2024-09"
"002800","신신제약","87230375000","5750","15170500","15170500","0","2024-09"
"472220","신영스팩10호","10060050000","2145","4690000","4690000","0","2024-09"
"430220","신영스팩8호","14669200000","2170","6760000","6760000","0","2024-09"
"445970","신영스팩9호","11738400000","2190","5360000","5360000","0","2024-09"
"005800","신영와코루","81720000000","9080","9000000","9000000","0","2024-09"
"001720","신영증권","633937806400","82300","7702768","16440000","8737232","2024-09"
"009270","신원","93815445000","1250","75052356","102586356","27534000","2024-09"
"017000","신원종합개발","33754474710","3015","11195514","11668027","472513","2024-09"
"002700","신일전자","102134026084","1453","70291828","71047521","755693","2024-09"
"012790","신일제약","85425155790","7390","11559561","11986415","426854","2024-09"
"138070","신진에스엠","39964913500","2375","16827332","17503204","675872","2024-09"
"226330","신테카바이오","70570446875","4625","15258475","15258475","0","2024-09"
"002870","신풍","25434456840","918","27706380","34958700","7252320","2024-09"
"019170","신풍제약","559718889440","11360","49271029","52984990","3713961","2024-09"
"418210","신한제10호스팩","8070300000","2205","3660000","3660000","0","2024-09"
"452980","신한제11호스팩","36940370000","1954","18905000","18905000","0","2024-09"
"474660","신한제12호스팩","11868000000","2150","5520000","5520000","0","2024-09"
"474930","신한제13호스팩","7891600000","2180","3620000","3620000","0","2024-09"
"055550","신한지주","28243282676400","56100","503445324","509393214","5947890","2024-09"
"056700","신화인터텍","49057754881","1691","29011091","29135091","124000","2024-09"
"187270","신화콘텍","30401349865","3305","9198593","10143845","945252","2024-09"
"004080","신흥","134657251300","14260","9443005","9500000","56995","2024-09"
"243840","신흥에스이씨","287782443100","7460","38576735","38919035","342300","2024-09"
"257720","실리콘투","2307095568600","37900","60873234","60873234","0","2024-09"
"222800","심텍","517177042480","16240","31845877","31854143","8266","2024-09"
"036710","심텍홀딩스","73536327030","1587","46336690","48350145","2013455","2024-09"
"160980","싸이맥스","112424708000","11000","10220428","10924243","703815","2024-09"
"356890","싸이버원","35029864800","2940","11914920","11916325","1405","2024-09"
"217330","싸이토젠","167484911220","7260","23069547","23129547","60000","2024-09"
"102280","쌍방울","70634046631","269","262580099","262592129","12030","2024-09"
"010280","쌍용정보통신","39725502140","610","65123774","65123786","12","2024-09"
"004770","써니전자","57557109456","1584","36336559","36702884","366325","2024-09"
"208640","썸에이지","32721459690","235","139240254","139240254","0","2024-09"
"222420","쎄노텍","36459102856","802","45460228","45460231","3","2024-09"
"037760","쎄니트","47854197654","1574","30402921","33832921","3430000","2024-09"
"099320","쎄트렉아이","412863180600","37700","10951278","10951278","0","2024-09"
"049960","쎌바이오텍","92734845000","13550","6843900","9400000","2556100","2024-09"
"088280","쏘닉스","45862198500","2650","17306490","17306490","0","2024-09"
"403550","쏘카","607967484060","18530","32809902","32809902","0","2024-09"
"050890","쏠리드","270884404860","4470","60600538","61095231","494693","2024-09"
"475400","씨메스","264211101000","23100","11437710","11437710",,"자료 없음"
"109670","씨싸이트","53159573890","9110","5835299","5836602","1303","2024-09"
"066790","씨씨에스","98953723396","1636","60485161","65152039","4666878","2024-09"
"222080","씨아이에스","597505293910","8330","71729327","71729327","0","2024-09"
"004920","씨아이테크","64584872970","1290","50065793","50065793","0","2024-09"
"352480","씨앤씨인터내셔널","715792646400","71600","9997104","10013941","16837","2024-09"
"264660","씨앤지하이테크","120512824560","12920","9327618","9627896","300278","2024-09"
"352700","씨앤투스","75740201760","2960","25587906","27276899","1688993","2024-09"
"458870","씨어스테크놀로지","160787020800","12810","12551680","12551680","0","2024-09"
"297090","씨에스베어링","144803700000","5310","27270000","27270000","0","2024-09"
"112610","씨에스윈드","2344908624600","56600","41429481","42171403","741922","2024-09"
"359090","씨엔알리서치","68361458620","1211","56450420","56450891","471","2024-09"
"115530","씨엔플러스","31195017000","459","67963000","67963000","0","2024-09"
"115480","씨유메디칼","37440906124","778","48124558","48224558","100000","2024-09"
"340810","씨유박스","34019140230","3210","10597863","10597863","0","2024-09"
"376290","씨유테크","55091400000","3120","17657500","17657500","0","2024-09"
"189330","씨이랩","40757379960","6690","6092284","6092284","0","2024-09"
"096530","씨젠","1073850261000","23250","46187108","52225994","6038886","2024-09"
"101240","씨큐브","50865203520","4920","10338456","10340947","2491","2024-09"
"060590","씨티씨바이오","190074761250","7950","23908775","24181020","272245","2024-09"
"308170","씨티알모빌리티","48302100000","5610","8610000","8610000","0","2024-09"
"260930","씨티케이","107221159410","5690","18843789","19341591","497802","2024-09"
"052300","씨티프라퍼티","62902495827","373","168639399","168651433","12034","2024-09"
"413630","씨피시스템","92543322500","2500","37017329","38703425","1686096","2024-09"
"013990","아가방컴퍼니","132995308725","4425","30055437","32887536","2832099","2024-09"
"123860","아나패스","221858494500","18300","12123415","12123415","0","2024-09"
"025980","아난티","430296115690","4855","88629478","88629478","0","2024-09"
"008700","아남전자","98252574420","1274","77121330","77124820","3490","2024-09"
"125210","아모그린텍","102939969600","6240","16496790","16496790","0","2024-09"
"002790","아모레G","1769512140000","23200","76272075","82458180","6186105","2024-09"
"090430","아모레퍼시픽","7232642362000","123800","58421990","58492759","70769","2024-09"
"357580","아모센스","79551671760","7090","11220264","11220264","0","2024-09"
"052710","아모텍","54650922040","3740","14612546","14615109","2563","2024-09"
"074430","아미노로직스","105480039644","1201","87826844","87826844","0","2024-09"
"092040","아미코젠","241465440290","4405","54816218","55018347","202129","2024-09"
"083930","아바코","208609160670","14370","14516991","14912798","395807","2024-09"
"149950","아바텍","166699880750","12050","13834015","15607500","1773485","2024-09"
"036010","아비코전자","66996387360","5040","13292934","13292934","0","2024-09"
"002030","아세아","432743685000","257500","1680558","2115648","435090","2024-09"
"183190","아세아시멘트","408264536450","10870","37558835","38501886","943051","2024-09"
"002310","아세아제지","331647665000","8300","39957550","42782510","2824960","2024-09"
"050860","아세아텍","43059619050","2175","19797526","22500000","2702474","2024-09"
"012170","아센디오","44741974752","432","103569386","103569488","102","2024-09"
"136410","아셈스","87262292010","8210","10628781","11019106","390325","2024-09"
"246720","아스타","60917177000","4490","13567300","13567300","0","2024-09"
"067390","아스트","188894756655","549","344070595","344203992","133397","2024-09"
"159010","아스플로","79875202200","6180","12924790","13334739","409949","2024-09"
"127710","아시아경제","45375306600","1300","34904082","34904082","0","2024-09"
"267850","아시아나IDT","196248000000","17680","11100000","11100000","0","2024-09"
"020560","아시아나항공","722538228440","9710","74411764","74411764","0","2024-09"
"154030","아시아종묘","27935158320","2410","11591352","11591352","0","2024-09"
"227610","아우딘퓨쳐스","48493393416","1368","35448387","35583547","135160","2024-09"
"143160","아이디스","150704297250","14950","10080555","10716390","635835","2024-09"
"054800","아이디스홀딩스","80014377540","9060","8831609","10347756","1516147","2024-09"
"332370","아이디피","47300452500","3750","12613454","13273726","660272","2024-09"
"122900","아이마켓코리아","261154022000","8300","31464340","33428840","1964500","2024-09"
"339950","아이비김영","75279504720","1736","43363770","44946655","1582885","2024-09"
"469750","아이비젼웍스","48503584176","1432","33871218","33936481","65263","2024-09"
"460470","아이빔테크놀로지","73008350800","4840","15084370","15084370","0","2024-09"
"099190","아이센스","522005995540","18890","27633986","27637273","3287","2024-09"
"461300","아이스크림미디어","167364002040","13080","12795413","13063433","268020","2024-09"
"289010","아이스크림에듀","30070068000","2400","12529195","12864037","334842","2024-09"
"214430","아이쓰리시스템","232546347000","33500","6941682","7106760","165078","2024-09"
"040910","아이씨디","82698549570","5070","16311351","18574275","2262924","2024-09"
"368600","아이씨에이치","63248391840","3680","17187063","17538346","351283","2024-09"
"456010","아이씨티케이","93875461600","7100","13221896","13221896","0","2024-09"
"052860","아이앤씨","25609691802","1578","16229209","17862854","1633645","2024-09"
"464500","아이언디바이스","63351140320","4640","13653263","13653263","0","2024-09"
"010780","아이에스동서","646001286400","21400","30186976","30186976","0","2024-09"
"038880","아이에이","60629451589","199","304670611","315334702","10664091","2024-09"
"307180","아이엘사이언스","84507784375","3125","27042491","27042828","337","2024-09"
"101390","아이엠","30279251520","2880","10513629","10548085","34456","2024-09"
"461030","아이엠비디엑스","215873350000","15400","14017750","14017750","0","2024-09"
"451220","아이엠티","69690307350","8850","7874611","7874611","0","2024-09"
"090150","아이윈","34949935680","880","39715836","41875293","2159457","2024-09"
"123010","아이윈플러스","23279001026","718","32422007","32658542","236535","2024-09"
"031310","아이즈비전","44022818554","1802","24429977","25334636","904659","2024-09"
"185490","아이진","76359139800","2825","27029784","27029784","0","2024-09"
"059100","아이컴포넌트","29958600010","4535","6606086","7070860","464774","2024-09"
"262840","아이퀘스트","41590317080","2210","18819148","19290000","470852","2024-09"
"175250","아이큐어","93237364075","2495","37369685","37558368","188683","2024-09"
"052460","아이크래프트","28579467040","2390","11957936","14607936","2650000","2024-09"
"119830","아이텍","116037595900","5450","21291302","21434297","142995","2024-09"
"052770","아이톡시","64947408396","1326","48979946","48979946","0","2024-09"
"124500","아이티센","143171931590","6170","23204527","23204527","0","2024-09"
"372800","아이티아이즈","34321151700","5830","5886990","6026990","140000","2024-09"
"084850","아이티엠반도체","376534722200","18200","20688721","22682934","1994213","2024-09"
"114840","아이패밀리에스씨","350466560400","20350","17221944","17221944","0","2024-09"
"027360","아주IB투자","232202613988","1961","118410308","120945406","2535098","2024-09"
"139990","아주스틸","133648673760","5040","26517594","26517744","150","2024-09"
"032080","아즈텍WB","23529822509","1121","20990029","21491029","501000","2024-09"
"013310","아진산업","110591234700","2850","38803942","38806582","2640","2024-09"
"059120","아진엑스텍","70127552780","7660","9155033","9748596","593563","2024-09"
"009320","아진전자부품","56349637110","1143","49299770","49299770","0","2024-09"
"158430","아톤","87197449920","4080","21371924","22602474","1230550","2024-09"
"321820","아티스트유나이티드","207319223100","15510","13366810","13366810","0","2024-09"
"001540","안국약품","81489667050","7170","11365365","13042420","1677055","2024-09"
"053800","안랩","563409955000","57500","9798434","11126506","1328072","2024-09"
"065660","안트로젠","148403438250","15250","9731373","9731373","0","2024-09"
"297570","알로이스","38637279288","1116","34621218","34621218","0","2024-09"
"001780","알루코","225614207560","2330","96830132","96830132","0","2024-09"
"260660","알리코제약","57501287530","3830","15013391","15327021","313630","2024-09"
"354320","알멕","198132811000","31000","6391381","6391381","0","2024-09"
"361570","알비더블유","64572581205","2255","28635291","28635291","0","2024-09"
"131370","알서포트","150794117310","2895","52087778","53267083","1179305","2024-09"
"140670","알에스오토메이션","95618309400","10350","9238484","9303140","64656","2024-09"
"096610","알에프세미","51550708615","2965","17386411","17386411","0","2024-09"
"061040","알에프텍","94912897920","3040","31221348","32089259","867911","2024-09"
"148250","알엔투테크놀로지","28733171625","4005","7174325","7391186","216861","2024-09"
"347860","알체라","48443269600","2200","22019668","22019668","0","2024-09"
"196170","알테오젠","20293681240000","382000","53124820","53148528","23708","2024-09"
"123750","알톤","20611969843","1619","12731297","12746297","15000","2024-09"
"085810","알티캐스트","40258910131","1357","29667583","30447327","779744","2024-09"
"043100","알파녹스","22350509280","2805","7968096","7975920","7824","2024-09"
"117670","알파홀딩스","37743429465","945","39940137","39940137","0","2024-09"
"314140","알피바이오","53369525140","6170","8649842","8666361","16519","2024-09"
"291650","압타머사이언스","41941222440","2470","16980252","16980252","0","2024-09"
"293780","압타바이오","195863184000","7920","24730200","24730200","0","2024-09"
"018250","애경산업","430242574320","16740","25701468","26409935","708467","2024-09"
"161000","애경케미칼","504012151440","10440","48277026","48648709","371683","2024-09"
"196300","애니젠","75642676200","12600","6003387","6003387","0","2024-09"
"310200","애니플러스","123000488590","2765","44484806","45520979","1036173","2024-09"
"299910","애닉","32483121920","6880","4721384","4721384","0","2024-09"
"179530","애드바이오텍","30940402940","3385","9140444","9140444","0","2024-09"
"205500","액션스퀘어","55873113060","1076","51926685","51928120","1435","2024-09"
"052790","액토즈소프트","67622945930","6190","10924547","11330638","406091","2024-09"
"290740","액트로","51701091580","5540","9332327","10065011","732684","2024-09"
"238090","앤디포스","89107537590","3915","22760546","23541303","780757","2024-09"
"092600","앤씨앤","28995451968","1184","24489402","25083517","594115","2024-09"
"129890","앱코","55606708008","1161","47895528","50643410","2747882","2024-09"
"174900","앱클론","281764044870","16170","17425111","17425111","0","2024-09"
"255440","야스","127201663260","10540","12068469","13058000","989531","2024-09"
"030960","양지사","129393779400","9420","13736070","15980000","2243930","2024-09"
"102120","어보브반도체","159872926260","9690","16498754","17780753","1281999","2024-09"
"263540","어스앤에어로스페이스","85022108500","5950","14289430","14294091","4661","2023-12"
"238120","얼라인드","42705321120","2970","14378896","14378896","0","2024-09"
"019990","에너토크","61435657140","6420","9569417","9756088","186671","2024-09"
"011090","에넥스","32794316233","553","59302561","59991641","689080","2024-09"
"270660","에브리봇","193255203600","15800","12231342","12231342","0","2024-09"
"038680","에스넷","66077978735","3635","18178261","19549677","1371416","2024-09"
"137310","에스디바이오센서","1095009820700","8950","122347466","124477353","2129887","2024-09"
"217480","에스디생명공학","54756837359","499","109733141","109733141","0","2024-09"
"121890","에스디시스템","18129532344","1364","13291446","13291446","0","2024-09"
"304360","에스바이오메딕스","391722296600","33350","11745796","11745796","0","2024-09"
"389500","에스비비테크","85137559920","14280","5962014","6174904","212890","2024-09"
"042110","에스씨디","71721072976","1484","48329564","48329564","0","2024-09"
"298060","에스씨엠생명과학","40225559260","1966","20460610","20467248","6638","2024-09"
"065420","에스아이리소스","18179982436","254","71574734","71577299","2565","2024-09"
"103230","에스앤더블류","26064000000","3620","7200000","7200000","0","2024-09"
"260970","에스앤디","102403491600","35400","2892754","2892754","0","2024-09"
"101490","에스앤에스텍","472427010000","22550","20950200","21451447","501247","2024-09"
"095910","에스에너지","28432447700","1525","18644228","19504503","860275","2024-09"
"275630","에스에스알","17422801760","3220","5410808","6017989","607181","2024-09"
"031330","에스에이엠티","307754686385","3155","97545067","99995067","2450000","2024-09"
"060540","에스에이티","38624476452","1478","26132934","26133306","372","2024-09"
"351320","에스에이티이엔지","35731442148","1623","22015676","22015886","210","2024-09"
"056190","에스에프에이","645574427700","20550","31414814","35908760","4493946","2024-09"
"080000","에스엔유","58064596122","1697","34216026","34322870","106844","2024-09"
"005850","에스엘","1529041338400","33200","46055462","46448520","393058","2024-09"
"214310","에스엘에너지","22487615640","6120","3674447","3679130","4683","2024-09"
"246250","에스엘에스바이오","42054084440","2740","15348206","15348206","0","2024-09"
"041510","에스엠","1598049362000","69800","22894690","23353627","458937","2024-09"
"010580","에스엠벡셀","135105221888","1216","111106268","111251760","145492","2024-09"
"007820","에스엠코어","93368258550","4775","19553562","20033946","480384","2024-09"
"464080","에스오에스랩","97073246700","5490","17681830","17681830","0","2024-09"
"109610","에스와이","181719228050","3805","47758010","48907400","1149390","2024-09"
"365330","에스와이스틸텍","172334300000","5630","30610000","30610000","0","2024-09"
"012750","에스원","2130045057000","63000","33810239","37999178","4188939","2024-09"
"031860","에스유홀딩스","17965788152","1196","15021562","15026356","4794","2024-09"
"306040","에스제이그룹","56584726960","6010","9415096","9865828","450732","2024-09"
"457940","에스케이증권제10호스팩","7050300000","2130","3310000","3310000","0","2024-09"
"472230","에스케이증권제11호스팩","8683950000","2090","4155000","4155000","0","2024-09"
"473000","에스케이증권제12호스팩","6951000000","2100","3310000","3310000","0","2024-09"
"473950","에스케이증권제13호스팩","9083100000","2055","4420000","4420000","0","2024-09"
"435870","에스케이증권제8호스팩","7830600000","2105","3720000","3720000","0","2024-09"
"455910","에스케이증권제9호스팩","10692600000","2130","5020000","5020000","0","2024-09"
"096630","에스코넥","55459567755","711","78002205","79052205","1050000","2024-09"
"069510","에스텍","91332600000","10860","8410000","10910000","2500000","2024-09"
"234300","에스트래픽","117511318050","4270","27520215","27809848","289633","2024-09"
"039440","에스티아이","292972494360","19880","14737047","15830000","1092953","2024-09"
"098660","에스티오","35744195360","2945","12137248","12500976","363728","2024-09"
"052020","에스티큐브","278932609020","5980","46644249","46694249","50000","2024-09"
"237690","에스티팜","1990661310000","99000","20107690","20107690","0","2024-09"
"050760","에스폴리텍","24538559941","1589","15442769","16334678","891909","2024-09"
"288620","에스퓨얼셀","74120335920","10620","6979316","6979316","0","2024-09"
"443670","에스피소프트","148585531720","6140","24199598","24201392","1794","2024-09"
"317830","에스피시스템스","53294562320","5240","10170718","10773818","603100","2024-09"
"058610","에스피지","457962484000","20650","22177360","22177360","0","2024-09"
"043340","에쎈테크","44650000000","470","95000000","95000000","0","2024-09"
"023960","에쓰씨엔지니어링","59903753478","1763","33978306","33978308","2","2024-09"
"298690","에어부산","272801842560","2340","116581984","116640000","58016","2024-09"
"054630","에이디칩스","12594094838","158","79709461","79709461","0","2024-09"
"200710","에이디테크놀로지","189655944240","14640","12954641","13440822","486181","2024-09"
"096690","에이루트","42609947656","1273","33472072","33477189","5117","2024-09"
"078520","에이블씨엔씨","181318681260","6970","26014158","26014161","3","2024-09"
"298380","에이비엘바이오","1837827929250","38250","48047789","48047789","0","2024-09"
"203400","에이비온","214410562000","8500","25224772","25224772","0","2024-09"
"195990","에이비프로바이오","150884590180","530","284687906","284689721","1815","2024-09"
"003800","에이스침대","286093209500","27100","10556945","11090000","533055","2024-09"
"088800","에이스테크","123068122019","971","126743689","127068928","325239","2024-09"
"241840","에이스토리","64308217050","6930","9279685","9539994","260309","2024-09"
"453860","에이에스텍","131300509500","23300","5635215","5657215","22000","2024-09"
"312610","에이에프더블류","32674360344","1613","20256888","20256888","0","2024-09"
"015260","에이엔피","32030327980","710","45113138","45116894","3756","2024-09"
"172670","에이엘티","79287378750","8950","8858925","8960259","101334","2024-09"
"445090","에이직랜드","332306513100","30850","10771686","10771686","0","2024-09"
"295310","에이치브이엠","178647984310","15010","11901931","11901931","0","2024-09"
"072990","에이치시티","72494673920","10240","7079558","7287341","207783","2024-09"
"239610","에이치엘사이언스","82505806200","16200","5092951","5392115","299164","2024-09"
"462020","에이치엠씨제6호스팩","8863800000","2040","4345000","4345000","0","2024-09"
"477340","에이치엠씨제7호스팩","14982450000","1995","7510000","7510000","0","2024-09"
"148930","에이치와이티씨","43895100900","4515","9722060","10175213","453153","2024-09"
"044780","에이치케이","23737389219","1293","18358383","18505787","147404","2024-09"
"357230","에이치피오","119887057955","2905","41269211","42089487","820276","2024-09"
"355690","에이텀","33943274400","6280","5404980","5404980","0","2024-09"
"071670","에이테크솔루션","62600000000","6260","10000000","10000000","0","2024-09"
"045660","에이텍","110135888400","14600","7543554","8260000","716446","2024-09"
"224110","에이텍모빌리티","64123890230","13070","4906189","5340000","433811","2024-09"
"021080","에이티넘인베스트","116136301875","2525","45994575","48000000","2005425","2024-09"
"200470","에이팩트","119881712070","2830","42361029","42362093","1064","2024-09"
"262260","에이프로","99973829940","6940","14405451","14468152","62701","2024-09"
"007460","에이프로젠","290041468100","1090","266093090","286851768","20758678","2024-09"
"003060","에이프로젠바이오로직스","160824264084","814","197572806","198407845","835039","2024-09"
"397030","에이프릴바이오","495324561600","22600","21917016","21917016","0","2024-09"
"244920","에이플러스에셋","92917618230","4110","22607693","22607693","0","2024-09"
"278470","에이피알","1984308631500","266500","7445811","7622678","176867","2024-09"
"230240","에치에프알","137274676040","10460","13123774","13309000","185226","2024-09"
"230360","에코마케팅","333246427110","10590","31468029","31468029","0","2024-09"
"038870","에코바이오","54789903330","3910","14012763","14014949","2186","2024-09"
"097780","에코볼트","59264045750","875","67730338","67730338","0","2024-09"
"448280","에코아이","187565046570","18990","9877043","9877043","0","2024-09"
"101360","에코앤드림","674706988700","38450","17547646","17786114","238468","2024-09"
"128540","에코캡","32749181640","1260","25991414","26690460","699046","2024-09"
"086520","에코프로","10276039410000","78000","131744095","133138340","1394245","2024-09"
"450080","에코프로머티","7659929318200","110900","69070598","69070598","0","2024-09"
"247540","에코프로비엠","15293568684600","156600","97660081","97801344","141263","2024-09"
"383310","에코프로에이치엔","655581268000","43000","15246076","15304932","58856","2024-09"
"038110","에코플라스틱","112902253780","2810","40178738","41169370","990632","2024-09"
"073540","에프알텍","14272800000","1252","11400000","11400000","0","2024-09"
"064850","에프앤가이드","121063622520","10610","11410332","11410332","0","2024-09"
"036810","에프에스티","346835140960","17380","19955992","21756789","1800797","2024-09"
"173940","에프엔씨엔터","55233196700","3700","14927891","15392808","464917","2024-09"
"083500","에프엔에스테크","78255386000","9790","7993400","8575722","582322","2024-09"
"054940","엑사이엔씨","23719086820","715","33173548","33173548","0","2024-09"
"373110","엑셀세라퓨틱스","65074033520","5960","10918462","10918462","0","2024-09"
"205100","엑셈","124126542600","1725","71957416","71963431","6015","2024-09"
"356680","엑스게이트","155221598080","5440","28533382","28543492","10110","2024-09"
"070300","엑스큐어","38918539880","4660","8351618","8351618","0","2024-09"
"317770","엑스페릭스","70422441420","3070","22938906","22938906","0","2024-09"
"373200","엑스플러스","51782135184","684","75704876","75705657","781","2024-09"
"069920","엑시온그룹","46626414912","1332","35004816","35194116","189300","2024-09"
"092870","엑시콘","145653064850","11650","12502409","13050797","548388","2024-09"
"317870","엔바이오니아","155758592500","18310","8506750","8506750","0","2024-09"
"067570","엔브이에이치코리아","104068407090","2490","41794541","42170000","375459","2024-09"
"236810","엔비티","58624371250","3635","16127750","16975426","847676","2024-09"
"333620","엔시스","97019442510","9390","10332209","10556344","224135","2024-09"
"101400","엔시트론","26791497026","431","62161246","62162413","1167","2024-09"
"036570","엔씨소프트","4205943665000","210500","19980730","21954022","1973292","2024-09"
"078860","엔에스이엔엠","94807815100","9010","10522510","10531054","8544","2024-09"
"422040","엔에이치스팩23호","15071800000","2105","7160000","7160000","0","2024-09"
"437780","엔에이치스팩24호","10663600000","2120","5030000","5030000","0","2024-09"
"438580","엔에이치스팩25호","6628900000","2195","3020000","3020000","0","2024-09"
"439410","엔에이치스팩26호","18348000000","2085","8800000","8800000","0","2024-09"
"440820","엔에이치스팩27호","16224000000","2080","7800000","7800000","0","2024-09"
"451700","엔에이치스팩29호","28771750000","2005","14350000","14350000","0","2024-09"
"466910","엔에이치스팩30호","18200000000","2000","9100000","9100000","0","2024-09"
"481890","엔에이치스팩31호","12816900000","2020","6345000","6345000","0","2024-09"
"265740","엔에프씨","54037390000","6050","8931800","8931800","0","2024-09"
"354200","엔젠바이오","40940682320","2980","13738484","13738484","0","2024-09"
"455900","엔젤로보틱스","364667296400","24400","14945381","14945381","0","2024-09"
"419080","엔젯","91688178360","9080","10097817","10517817","420000","2024-09"
"208860","엔지스테크널러지","41831348265","2205","18971133","18971133","0","2024-09"
"183490","엔지켐생명과학","112410838144","1408","79837243","85065562","5228319","2024-09"
"085310","엔케이","62078813414","787","78880322","79983352","1103030","2024-09"
"182400","엔케이맥스","172744574320","2020","85517116","85518831","1715","2024-09"
"348370","엔켐","3727095293900","179300","20786923","20786923","0","2024-09"
"069410","엔텔스","36341824810","3665","9915914","10244824","328910","2024-09"
"227950","엔투텍","42569542830","411","103575530","103575530","0","2024-09"
"291230","엔피","91057750595","2065","44095763","44095775","12","2024-09"
"198080","엔피디","53407258800","2480","21535185","21535185","0","2024-09"
"048830","엔피케이","22023177666","1178","18695397","18723923","28526","2024-09"
"096870","엘디티","15660848000","2345","6678400","6678400","0","2024-09"
"290650","엘앤씨바이오","419897332410","18510","22684891","22684891","0","2024-09"
"066970","엘앤에프","3338993836500","99500","33557727","36296338","2738611","2024-09"
"156100","엘앤케이바이오","170459067150","8550","19936733","19936743","10","2024-09"
"073110","엘엠에스","37831467120","6540","5784628","8895755","3111127","2024-09"
"083310","엘오티베큠","155651782780","9620","16180019","17810033","1630014","2024-09"
"037950","엘컴텍","102975816540","1220","84406407","84447519","41112","2024-09"
"170920","엘티씨","89802966880","9680","9277166","9805620","528454","2024-09"
"058630","엠게임","118126344900","6350","18602574","19543877","941303","2024-09"
"058970","엠로","553568630600","46700","11853718","11853718","0","2024-09"
"019590","엠벤처투자","104963185182","921","113966542","113966542","0","2024-09"
"169330","엠브레인","39154004190","2205","17756918","18256918","500000","2024-09"
"097520","엠씨넥스","295623571840","17120","17267732","17977732","710000","2024-09"
"373170","엠아이큐브솔루션","38187509400","7580","5037930","5037930","0","2024-09"
"179290","엠아이텍","282228712160","8720","32365678","32365678","0","2024-09"
"009780","엠에스씨","89232000000","5070","17600000","17600000","0","2024-09"
"123040","엠에스오토텍","170519954700","3100","55006437","69172213","14165776","2024-09"
"323230","엠에프엠코리아","6967193212","161","43274492","43274492","0","2024-06"
"032790","엠젠솔루션","59832767136","1398","42798832","42798832","0","2024-09"
"033160","엠케이전자","177051205100","8470","20903330","22066331","1163001","2024-09"
"347890","엠투아이","91608372800","5600","16358638","16913204","554566","2024-09"
"033310","엠투엔","79085747088","1998","39582456","40342231","759775","2024-09"
"259630","엠플러스","114805680510","9510","12072101","12282402","210301","2024-09"
"105550","엣지파운드리","129765128850","2270","57165255","57165255","0","2024-09"
"060850","영림원소프트랩","55453420000","6820","8131000","8131000","0","2024-09"
"014440","영보화학","65910000000","3380","19500000","20000000","500000","2024-09"
"143540","영우디에스피","32328232000","740","43686800","44599895","913095","2024-09"
"111770","영원무역","1740657477900","40700","42767997","44311468","1543471","2024-09"
"009970","영원무역홀딩스","1047922289400","90300","11604898","13635592","2030694","2024-09"
"003520","영진약품","436198502790","2385","182892454","182892731","277","2024-09"
"000670","영풍","657951255000","382500","1720134","1842040","121906","2024-09"
"036560","영풍정밀","409500000000","26000","15750000","15750000","0","2024-09"
"006740","영풍제지","54149410170","1226","44167545","46482148","2314603","2024-09"
"012280","영화금속","38579682810","762","50629505","51664505","1035000","2024-09"
"265560","영화테크","94103426600","8870","10609180","10690180","81000","2024-09"
"012160","영흥","32585404834","478","68170303","101310372","33140069","2024-09"
"036000","예림당","44087606178","1914","23034277","23034277","0","2024-09"
"250930","예선테크","17647398180","540","32680367","33000440","320073","2024-09"
"053280","예스24","149664055480","5990","24985652","25000000","14348","2024-09"
"015360","예스코홀딩스","218331000000","51000","4281000","6000000","1719000","2024-09"
"122640","예스티","381157051250","18910","20156375","20930108","773733","2024-09"
"045060","오공","45828039670","2705","16941974","16941974","0","2024-09"
"080520","오디텍","35498743840","3430","10349488","11746609","1397121","2024-09"
"007310","오뚜기","1437638686000","418000","3439327","4007830","568503","2024-09"
"039830","오로라","55248709100","5590","9883490","10762890","879400","2024-09"
"322310","오로스테크놀로지","145993430700","15850","9210942","9366542","155600","2024-09"
"046120","오르비텍","66987743680","2470","27120544","27449486","328942","2024-09"
"014940","오리엔탈정공","162603821730","3570","45547289","45573661","26372","2024-09"
"002630","오리엔트바이오","53355656700","450","118568126","118583005","14879","2024-09"
"065500","오리엔트정공","37405607166","1179","31726554","31742912","16358","2024-09"
"271560","오리온","3901491375600","98700","39528788","39536132","7344","2024-09"
"001800","오리온홀딩스","994991040620","16540","60156653","62645422","2488769","2024-09"
"010470","오리콤","71485167600","6160","11604735","11975050","370315","2024-09"
"417860","오브젠","42844037380","9670","4430614","4430614","0","2024-09"
"352910","오비고","85557919540","6770","12637802","12637802","0","2024-09"
"053980","오상자이엘","70300800050","3725","18872698","18982783","110085","2024-09"
"036220","오상헬스케어","173726187390","12670","13711617","14489416","777799","2024-09"
"052420","오성첨단소재","139669307484","1676","83334909","86315192","2980283","2024-09"
"039200","오스코텍","1206603752800","31550","38244176","38244176","0","2024-09"
"226400","오스테오닉","115841226150","5850","19801919","20661601","859682","2024-09"
"031510","오스템","34890305436","1332","26193923","28000000","1806077","2024-09"
"368970","오에스피","30468481600","3260","9346160","9346160","0","2024-09"
"138080","오이솔루션","103565756800","10160","10193480","10624095","430615","2024-09"
"080580","오킨스전자","95991540300","5580","17202785","17679298","476513","2024-09"
"067170","오텍","49719911500","3500","14205689","15391605","1185916","2024-09"
"353590","오토앤","61545224600","4780","12875570","12875570","0","2024-09"
"173130","오파스넷","100431746800","7700","13043084","13046473","3389","2024-09"
"440320","오픈놀","41720275000","4255","9805000","9805000","0","2024-09"
"049480","오픈베이스","67494456000","2250","29997536","31422383","1424847","2024-09"
"394280","오픈엣지테크놀로지","257184233790","11770","21850827","21850827","0","2024-09"
"309930","오하임앤컴퍼니","41788779945","2035","20535027","21290990","755963","2024-09"
"244460","올리패스","18290883206","454","40288289","40290730","2441","2024-09"
"226950","올릭스","518870512300","30100","17238223","17238223","0","2024-09"
"057540","옴니시스템","46288393320","780","59344094","61449355","2105261","2024-09"
"131030","옵투스제약","96533342160","6320","15274263","16153162","878899","2024-09"
"082210","옵트론텍","59565003365","2135","27899299","28566538","667239","2024-09"
"109080","옵티시스","32771644230","6890","4756407","5636000","879593","2024-09"
"380540","옵티코어","35167914950","1225","28708502","29779596","1071094","2024-09"
"153710","옵티팜","76577180760","5220","14669958","14669958","0","2024-09"
"432430","와이랩","82932716000","5050","16422320","16422320","0","2024-09"
"338840","와이바이오로직스","168667872720","11420","14769516","14769516","0","2024-09"
"122990","와이솔","170733358610","6170","27671533","28186941","515408","2024-09"
"232140","와이씨","897709849860","11190","80224294","82045350","1821056","2024-09"
"112290","와이씨켐","163487512650","16170","10110545","10110545","0","2024-09"
"065530","와이어블","68409425370","1430","47838759","52860000","5021241","2024-09"
"067900","와이엔텍","115113831240","6360","18099659","18199659","100000","2024-09"
"007530","와이엠","51554809650","2710","19023915","19174452","150537","2024-09"
"155650","와이엠씨","72992924040","4035","18089944","19474358","1384414","2024-09"
"273640","와이엠텍","122677587450","11610","10566545","10966000","399455","2024-09"
"251370","와이엠티","133615460160","8190","16314464","16314464","0","2024-09"
"066430","와이오엠","21921268320","560","39145122","39153476","8354","2024-09"
"209640","와이제이링크","215456830950","15150","14221573","14221573",,"자료 없음"
"273060","와이즈버즈","48340272850","958","50459575","50459582","7","2024-09"
"019210","와이지-원","172905167850","5150","33573819","33573819","0","2024-09"
"122870","와이지엔터테인먼트","772477468700","41650","18546878","18691049","144171","2024-09"
"011690","와이투솔루션","96175844060","2630","36568762","36574394","5632","2024-09"
"332570","와이팜","103349506440","2505","41257288","42233850","976562","2024-09"
"079000","와토스코리아","36457673670","5130","7106759","7200000","93241","2024-09"
"403490","우듬지팜","84725011090","1874","45210785","45212464","1679","2024-09"
"316140","우리금융지주","12363250307400","16650","742537556","742591501","53945","2024-09"
"032820","우리기술","367755019900","2315","158857460","158859048","1588","2024-09"
"041190","우리기술투자","636986056080","8180","77871156","84000000","6128844","2024-09"
"115440","우리넷","82643788100","7900","10461239","10754239","293000","2024-09"
"046970","우리로","49778833079","1147","43399157","43824999","425842","2024-09"
"082850","우리바이오","165225823000","3500","47207378","48456578","1249200","2024-09"
"215360","우리산업","109129347850","11950","9132163","9132163","0","2024-09"
"072470","우리산업홀딩스","56651187000","3000","18883729","18887341","3612","2024-09"
"073560","우리손에프앤지","96655749628","1396","69237643","69237643","0","2024-09"
"037400","우리엔터프라이즈","32253611880","1330","24250836","26223346","1972510","2024-09"
"153490","우리이앤엘","43346288700","857","50579100","51480000","900900","2024-09"
"101170","우림피티에스","67670538240","5120","13216902","13500000","283098","2024-09"
"006980","우성","41170766240","16040","2566756","3090000","523244","2024-09"
"066590","우수AMS","118161097535","3055","38677937","39073104","395167","2024-09"
"017370","우신시스템","129362704640","8320","15548402","18314054","2765652","2024-09"
"103840","우양","61046776440","3730","16366428","16366428","0","2024-09"
"046940","우원개발","41661376750","2305","18074350","18074350","0","2024-09"
"215380","우정바이오","32934522920","2095","15720536","15879576","159040","2024-09"
"065680","우주일렉트로","116879368340","14540","8038471","9530000","1491529","2024-09"
"105840","우진","164288368240","8290","19817656","20323614","505958","2024-09"
"018620","우진비앤지","29002719684","1004","28887171","28889293","2122","2024-09"
"010400","우진아이엔에스","22410762675","3325","6740079","7622000","881921","2024-09"
"457550","우진엔텍","216022198700","23300","9271339","9271339","0","2024-09"
"049800","우진플라임","46500000000","2325","20000000","20000000","0","2024-09"
"016880","웅진","69011316048","888","77715446","79927080","2211634","2024-09"
"095720","웅진씽크빅","194716377792","1728","112683089","115505985","2822896","2024-09"
"396470","워트","146692000000","9100","16120000","16120000","0","2024-09"
"005820","원림","32991553200","16040","2056830","2297970","241140","2024-09"
"307280","원바이오젠","46114741400","1300","35472878","36959013","1486135","2024-09"
"032940","원익","69043121895","3795","18193181","18193230","49","2024-09"
"240810","원익IPS","1398851087500","28750","48655690","49083901","428211","2024-09"
"074600","원익QnC","623025600000","23700","26288000","26288000","0","2024-09"
"104830","원익머트리얼즈","265398400000","21050","12608000","12608000","0","2024-09"
"014190","원익큐브","54579199482","1542","35395071","35399906","4835","2024-09"
"217820","원익피앤이","125647160720","2840","44241958","47454559","3212601","2024-09"
"030530","원익홀딩스","173771336375","2275","76383005","77237981","854976","2024-09"
"012620","원일특강","31900000000","7250","4400000","4400000","0","2024-09"
"382840","원준","212346148380","13980","15189281","15271581","82300","2024-09"
"336570","원텍","526193905140","5890","89336826","89340619","3793","2024-09"
"376980","원티드랩","41301892875","4625","8930139","9754994","824855","2024-09"
"008370","원풍","53517363900","4900","10921911","12000000","1078089","2024-09"
"008290","원풍물산","21296226601","533","39955397","40693679","738282","2024-09"
"101160","월덱스","314039086860","19020","16510993","16510993","0","2024-09"
"336060","웨이버스","64479812800","1339","48155200","48155200","0","2024-09"
"095270","웨이브일렉트로","60550745710","4745","12760958","14971256","2210298","2024-09"
"010600","웰바이오텍","49552926545","545","90922801","90923407","606","2024-09"
"065950","웰크론","62258300485","2285","27246521","28231302","984781","2024-09"
"076080","웰크론한텍","33021029976","1496","22072881","22594156","521275","2024-09"
"043590","웰킵스하이텍","19814166176","742","26703728","27136762","433034","2024-09"
"196700","웹스","19147403952","1333","14364144","14364144","0","2024-09"
"069080","웹젠","467343685900","15860","29466815","34950884","5484069","2024-09"
"053580","웹케시","91683915690","7170","12787157","13636248","849091","2024-09"
"071460","위니아","21802751835","613","35567295","35967295","400000","2024-09"
"377460","위니아에이드","26030247855","1691","15393405","15393405","0","2024-09"
"044340","위닉스","95953977280","6070","15807904","17873425","2065521","2024-09"
"330350","위더스제약","93717728000","7100","13199680","13202139","2459","2024-09"
"348350","위드텍","75061248000","7680","9773600","10183600","410000","2024-09"
"112040","위메이드","1099214456700","32700","33615121","33948483","333362","2024-09"
"101730","위메이드맥스","320891793480","9720","33013559","33295292","281733","2024-09"
"123420","위메이드플레이","76863692990","7390","10401041","11469842","1068801","2024-09"
"065370","위세아이텍","30801491890","4435","6945094","7383954","438860","2024-09"
"038620","위즈코프","37705530600","600","62842551","66546465","3703914","2024-09"
"299900","위지윅스튜디오","211112127464","1246","169431884","171048884","1617000","2024-09"
"036090","위지트","82443859065","699","117945435","118392284","446849","2024-09"
"136540","윈스","153790047360","12440","12362544","13644162","1281618","2024-09"
"097800","윈팩","182477508843","1567","116450229","116450229","0","2024-09"
"192390","윈하이텍","40968716250","3750","10924991","10924991","0","2024-09"
"008600","윌비스","28359537090","431","65799390","67236039","1436649","2024-09"
"335870","윙스풋","18850006860","1130","16681422","16681422","0","2024-09"
"033270","유나이티드제약","305994395200","20800","14711269","16333822","1622553","2024-09"
"014830","유니드","433522063700","65300","6638929","6767600","128671","2024-09"
"446070","유니드비티플러스","44172928800","4320","10225215","10611215","386000","2024-09"
"036200","유니셈","197970036690","6730","29416053","30664223","1248170","2024-09"
"018000","유니슨","115516612904","686","168391564","168391564","0","2024-09"
"000910","유니온","68066658840","4360","15611619","15611619","0","2024-09"
"047400","유니온머티리얼","101640000000","2420","42000000","42000000","0","2024-09"
"203450","유니온커뮤니티","32632690950","2650","12314223","14079007","1764784","2024-09"
"011330","유니켐","138635468629","1543","89848003","96997167","7149164","2024-09"
"077500","유니퀘스트","95580451350","4425","21600102","21794015","193913","2024-09"
"011320","유니크","76799762625","3975","19320695","19320695","0","2024-09"
"086390","유니테스트","203328170000","10000","20332817","21134126","801309","2024-09"
"241690","유니테크노","87849834540","3590","24470706","24470706","0","2024-09"
"142210","유니트론텍","89060742685","4705","18928957","19246092","317135","2024-09"
"088340","유라클","51094802400","11800","4330068","4330068","0","2024-09"
"048430","유라테크","75704012720","6610","11452952","11520000","67048","2024-09"
"206650","유바이오로직스","458140209780","12540","36534307","36534307","0","2024-09"
"089850","유비벨록스","99501001200","6840","14546930","14730199","183269","2024-09"
"084440","유비온","15612537600","792","19712800","19712800","0","2024-09"
"032620","유비케어","189523767870","3735","50742642","52197139","1454497","2024-09"
"264450","유비쿼스","140928996130","14170","9945589","10245706","300117","2024-09"
"078070","유비쿼스홀딩스","158358845260","9590","16512914","18150700","1637786","2024-09"
"002920","유성기업","51679712500","2015","25647500","25947500","300000","2024-09"
"024800","유성티엔에스","66263473152","1984","33398928","37051812","3652884","2024-09"
"000700","유수홀딩스","126659395720","5170","24498916","26041812","1542896","2024-09"
"054930","유신","65400000000","21800","3000000","3000000","0","2024-09"
"069330","유아이디","17493040840","1240","14107291","14191091","83800","2024-09"
"049520","유아이엘","104786186400","4900","21384936","21784936","400000","2024-09"
"435380","유안타제10호스팩","12004350000","2095","5730000","5730000","0","2024-09"
"444920","유안타제11호스팩","10794400000","2060","5240000","5240000","0","2024-09"
"446150","유안타제12호스팩","9778500000","2050","4770000","4770000","0","2024-09"
"449020","유안타제13호스팩","19605950000","2015","9730000","9730000","0","2024-09"
"450940","유안타제14호스팩","9556700000","2105","4540000","4540000","0","2024-09"
"473050","유안타제15호스팩","14160200000","2020","7010000","7010000","0","2024-09"
"474490","유안타제16호스팩","11185300000","2030","5510000","5510000","0","2024-09"
"430700","유안타제9호스팩","11056400000","2110","5240000","5240000","0","2024-09"
"003470","유안타증권","555882097155","2885","192680103","199596576","6916473","2024-09"
"263770","유에스티","49729273785","2115","23512659","23700172","187513","2024-09"
"072130","유엔젤","56900487840","4760","11953884","13195454","1241570","2024-09"
"000220","유유제약","71689241390","4430","16182673","17032351","849678","2024-09"
"388720","유일로보틱스","366509888000","32000","11453434","11453434","0","2024-09"
"340930","유일에너테크","78099190500","2290","34104450","34204450","100000","2024-09"
"023410","유진기업","237487000905","3465","68538817","77310863","8772046","2024-09"
"056080","유진로봇","202565620800","5400","37512152","37512152","0","2024-09"
"468760","유진스팩10호","9137200000","2155","4240000","4240000","0","2024-09"
"442130","유진스팩9호","7785000000","2250","3460000","3460000","0","2024-09"
"084370","유진테크","795194042500","35750","22243190","22916042","672852","2024-09"
"240600","유진테크놀로지","44017413900","6420","6856295","6928151","71856","2024-09"
"001200","유진투자증권","370570950075","4035","91839145","96866418","5027273","2024-09"
"221800","유투바이오","36683387000","3250","11287196","11287196","0","2024-09"
"179900","유티아이","344910727400","21800","15821593","16286895","465302","2024-09"
"263050","유틸렉스","81868608000","2225","36794880","36798858","3978","2024-09"
"000100","유한양행","10995296315000","149000","73793935","80209064","6415129","2024-09"
"003460","유화증권","101349551075","2215","45756005","56702415","10946410","2024-09"
"191410","육일씨엔에쓰","18856761165","1683","11204255","11204255","0","2024-09"
"372170","윤성에프앤씨","414910496000","52000","7979048","7979048","0","2024-09"
"146060","율촌","29921367994","1246","24013939","24015595","1656","2024-09"
"008730","율촌화학","653480000000","26350","24800000","24800000","0","2024-09"
"072770","율호","143988400200","2050","70238244","70238244","0","2024-09"
"008250","이건산업","51633038200","5050","10224364","10952635","728271","2024-09"
"039020","이건홀딩스","69850987725","3225","21659221","22584709","925488","2024-09"
"025820","이구산업","147139471600","4400","33440789","33442000","1211","2024-09"
"067920","이글루","52353845000","5000","10470769","10996119","525350","2024-09"
"044960","이글벳","61190361545","4985","12274897","12641883","366986","2024-09"
"303530","이노뎁","52769481800","7420","7111790","7339299","227509","2024-09"
"296640","이노룰스","28460505760","5630","5055152","5178252","123100","2024-09"
"302430","이노메트리","90216679500","9180","9827525","9833208","5683","2024-09"
"214320","이노션","789600000000","19740","40000000","40000000","0","2024-09"
"462350","이노스페이스","168762492000","18000","9375694","9375694","0","2024-09"
"274400","이노시뮬레이션","38473543920","4920","7819826","7819826","0","2024-09"
"056090","이노시스","120240278550","1278","94084725","94084725","0","2024-09"
"073490","이노와이어리스","129417458920","17020","7603846","7603846","0","2024-09"
"215790","이노인스트루먼트","18409069596","457","40282428","40283149","721","2024-09"
"344860","이노진","22122300000","1850","11958000","12030000","72000","2024-09"
"088390","이녹스","105309057480","11220","9385834","9385844","10","2024-09"
"272290","이녹스첨단소재","445215332100","23100","19273391","20227658","954267","2024-09"
"053350","이니텍","67000660355","3995","16771129","19790916","3019787","2024-09"
"452400","이닉스","107224278960","11820","9071428","9071428","0","2024-09"
"264850","이랜시스","159652605240","5270","30294612","30294612","0","2024-09"
"054210","이랜텍","147579204330","5930","24886881","25291210","404329","2024-09"
"009730","이렘","60134089574","1306","46044479","46056774","12295","2024-09"
"065440","이루온","34551953946","1307","26436078","27275020","838942","2024-09"
"139480","이마트","1684987403700","62900","26788353","27875819","1087466","2024-09"
"115610","이미지스","58308281500","3700","15758995","15758995","0","2024-09"
"478110","이베스트스팩6호","10115300000","2015","5020000","5020000","0","2024-09"
"131400","이브이첨단소재","124831987030","2095","59585674","59589882","4208","2024-09"
"351330","이삭엔지니어링","65313537600","7880","8288520","8288520","0","2024-09"
"080010","이상네트웍스","50750811550","5350","9486133","9835071","348938","2024-09"
"457190","이수스페셜티케미컬","1227477065000","41000","29938465","30208280","269815","2024-09"
"086890","이수앱지스","232286800510","6470","35902133","35902133","0","2024-09"
"007660","이수페타시스","2839764213100","44900","63246419","63246419","0","2024-09"
"005950","이수화학","170007576200","7700","22078906","22722739","643833","2024-09"
"015020","이스타코","25979160612","668","38890959","42851600","3960641","2024-09"
"047560","이스트소프트","124152308720","12080","10277509","11603992","1326483","2024-09"
"239340","이스트에이드","45325664160","1680","26979562","26979634","72","2024-09"
"067010","이씨에스","31547668500","2770","11389050","12294000","904950","2024-09"
"093230","이아이디","354065768064","1392","254357592","254384360","26768","2024-09"
"418620","이에이트","136554249550","14150","9650477","9650477","0","2024-09"
"456070","이엔셀","246090190500","23100","10653255","10653255","0","2024-09"
"102710","이엔에프테크놀로지","244036238880","17080","14287836","14287836","0","2024-09"
"074610","이엔플러스","106760230695","1455","73374729","73374729","0","2024-09"
"041520","이엘씨","64222684290","5490","11698121","12188730","490609","2024-09"
"063760","이엘피","20528029500","2325","8829260","9325130","495870","2024-09"
"123570","이엠넷","55411369755","2595","21353129","22276078","922949","2024-09"
"083470","이엠앤아이","28786205778","1349","21338922","21340329","1407","2024-09"
"095190","이엠코리아","101063091560","2230","45319772","45319772","0","2024-09"
"091120","이엠텍","476676422000","29000","16437118","17132936","695818","2024-09"
"102460","이연제약","291254937080","15880","18340991","18586811","245820","2024-09"
"039030","이오테크닉스","2024690196900","167300","12102153","12319550","217397","2024-09"
"294090","이오플로우","182918310590","6010","30435659","30435659","0","2024-09"
"088290","이원컴포텍","36782879282","1174","31331243","31331669","426","2024-09"
"084680","이월드","251129532038","1771","141800978","141806193","5215","2024-09"
"353810","이지바이오","119071747200","3560","33447120","34191720","744600","2024-09"
"099750","이지케어텍","109080434220","16230","6720914","6834776","113862","2024-09"
"377330","이지트로닉스","45319257600","5730","7909120","8139954","230834","2024-09"
"035810","이지홀딩스","168062145495","2605","64515219","65145845","630626","2024-09"
"160600","이큐셀","106346383500","3100","34305285","34482552","177267","2024-09"
"092130","이크레더블","152953720000","12700","12043600","12043600","0","2024-09"
"096040","이트론","245561522409","271","906131079","906131295","216","2024-09"
"134060","이퓨쳐","15924874320","4140","3846588","4769250","922662","2024-09"
"001840","이화공영","48321189040","2440","19803766","19805760","1994","2024-09"
"000760","이화산업","33516000000","11970","2800000","2800000","0","2024-09"
"024810","이화전기","196810080587","899","218921113","218948640","27527","2024-09"
"014990","인디에프","54454742750","725","75109990","75112995","3005","2024-09"
"041830","인바디","304176877450","23350","13026847","13683782","656935","2024-09"
"352940","인바이오","24615408450","2265","10867730","10867730","0","2024-09"
"101140","인바이오젠","93257770480","9340","9984772","10044216","59444","2024-09"
"079950","인베니아","16865460000","774","21790000","23200000","1410000","2024-09"
"389470","인벤티지랩","192716141540","19210","10032074","10032074","0","2024-09"
"277410","인산가","51903511614","1377","37693182","38356789","663607","2024-09"
"060150","인선이엔티","250560519690","5590","44822991","46563612","1740621","2024-09"
"033230","인성정보","98560667667","1967","50107101","50515380","408279","2024-09"
"450520","인스웨이브시스템즈","47716355610","3245","14704578","14704578","0","2024-09"
"006490","인스코비","204352319925","1725","118465113","119368998","903885","2024-09"
"465480","인스피언","114151312720","11260","10137772","10137772",,"자료 없음"
"037330","인지디스플레","62991355064","1562","40327372","43885224","3557852","2024-09"
"100030","인지소프트","46288803500","16850","2747110","3283714","536604","2024-09"
"023800","인지컨트롤스","94349295340","6220","15168697","15809197","640500","2024-09"
"034590","인천도시가스","105523174400","25600","4121999","4374754","252755","2024-09"
"211050","인카금융서비스","250068843520","5120","48841571","51379800","2538229","2024-09"
"083640","인콘","25678021608","333","77111176","77720351","609175","2024-09"
"064090","인크레더블버즈","199957517520","4020","49740676","49742745","2069","2024-09"
"216050","인크로스","87991685100","7290","12070190","12843222","773032","2024-09"
"049070","인탑스","311612311770","19590","15906703","17200000","1293297","2024-09"
"119610","인터로조","312050211300","24900","12532137","13216478","684341","2024-09"
"017250","인터엠","20974303812","1036","20245467","21045467","800000","2024-09"
"129260","인터지스","62071090400","2200","28214132","29747874","1533742","2024-09"
"051370","인터플렉스","234441093600","10050","23327472","23327472","0","2024-09"
"064290","인텍플러스","161842445440","13060","12392224","12863962","471738","2024-09"
"189300","인텔리안테크","520886392200","49950","10428156","10733334","305178","2024-09"
"150840","인트로메딕","251537720850","5850","42997901","42997901","0","2024-09"
"048530","인트론바이오","192067427250","5870","32720175","34150762","1430587","2024-09"
"023810","인팩","71700000000","7170","10000000","10000000","0","2024-09"
"115310","인포바인","42593913880","19880","2142551","3192883","1050332","2024-09"
"039290","인포뱅크","49795835670","5970","8341011","8693978","352967","2024-09"
"071200","인피니트헬스케어","105062512430","4310","24376453","24396458","20005","2024-09"
"101930","인화정공","223340663000","23500","9503858","9615733","111875","2024-09"
"249420","일동제약","382394090540","13690","27932366","28062501","130135","2024-09"
"000230","일동홀딩스","89433352800","7920","11292090","11540400","248310","2024-09"
"013360","일성건설","65640229200","1215","54024880","54024880","0","2024-09"
"003120","일성아이에스","107960260320","15840","6815673","13300000","6484327","2024-09"
"333430","일승","88360355520","2880","30680679","30726747","46068","2024-09"
"068330","일신바이오","50762291244","1218","41676758","44216140","2539382","2024-09"
"003200","일신방직","172110544800","8080","21300810","23280000","1979190","2024-09"
"007110","일신석재","98102555670","1267","77429010","77456610","27600","2024-09"
"007570","일양약품","230950788400","12850","17972824","19085664","1112840","2024-09"
"178780","일월지엠엘","124101377000","8650","14346980","14349195","2215","2024-09"
"008500","일정실업","14522072930","12290","1181617","1200000","18383","2024-09"
"019540","일지테크","55429063570","4195","13213126","13513500","300374","2024-09"
"081000","일진다이아","173217186000","12200","14198130","14202975","4845","2024-09"
"020760","일진디스플","46254365393","899","51450907","51513741","62834","2024-09"
"103590","일진전기","1158557636700","24300","47677269","47685390","8121","2024-09"
"094820","일진파워","157270934870","10430","15078709","15078709","0","2024-09"
"271940","일진하이솔루스","725537536200","19980","36313190","36313190","0","2024-09"
"015860","일진홀딩스","185321714110","4030","45985537","49347483","3361946","2024-09"
"226320","잇츠한불","209990885200","11920","17616685","21929315","4312630","2024-09"
"049550","잉크테크","75190072295","3835","19606277","19606277","0","2024-09"
"389020","자람테크놀로지","192876497100","31450","6132798","6197730","64932","2024-09"
"254120","자비스","57923152620","1886","30712170","30754270","42100","2024-09"
"043910","자연과환경","67920282946","599","113389454","113391457","2003","2024-09"
"234920","자이글","46318047450","3450","13425521","13530910","105389","2024-09"
"289220","자이언트스텝","147773256600","6680","22121745","22121745","0","2024-09"
"317400","자이에스앤디","151878392200","3985","38112520","38782520","670000","2024-09"
"033240","자화전자","329793172800","15640","21086520","22155870","1069350","2024-09"
"174880","장원테크","11454988050","2650","4322637","4381265","58628","2024-09"
"049630","재영솔루텍","56048322710","670","83654213","83654213","0","2024-09"
"417840","저스템","54964984000","7750","7092256","7249175","156919","2024-09"
"000950","전방","22721031800","19940","1139470","1680000","540530","2024-09"
"079900","전진건설로봇","317317062000","21850","14522520","15360574","838054","2024-09"
"110020","전진바이오팜","20563389740","2270","9058762","9058762","0","2024-09"
"208140","정다운","85796119500","2625","32684236","32684246","10","2024-09"
"040420","정상제이엘에스","96952435580","6490","14938742","15677552","738810","2024-09"
"045510","정원엔시스","27167202891","863","31479957","32209292","729335","2024-09"
"217190","제너셈","72959527680","8320","8769174","8769174","0","2024-09"
"095700","제넥신","404769134200","8900","45479678","45540494","60816","2024-09"
"072520","제넨바이오","28838655818","389","74135362","74163194","27832","2024-09"
"122310","제노레이","81428755280","6040","13481582","14553844","1072262","2024-09"
"361390","제노코","110636637750","14750","7500789","7500789","0","2024-09"
"187420","제노포커스","73630372710","3110","23675361","23675361","0","2024-09"
"225220","제놀루션","53445834000","2960","18056025","19190021","1133996","2024-09"
"123330","제닉","183097652400","23400","7824686","7968680","143994","2024-09"
"381620","제닉스","118717176000","27150","4372640","4372640","0","2024-09"
"159580","제로투세븐","84036908020","4195","20032636","20032636","0","2024-09"
"147830","제룡산업","116827071900","6100","19151979","20000000","848021","2024-09"
"033100","제룡전기","857732640600","53400","16062409","16062409","0","2024-09"
"079370","제우스","365434065510","11910","30682961","31016990","334029","2024-09"
"054950","제이브이엠","236694242400","20550","11517968","12089892","571924","2024-09"
"023440","제이스코홀딩스","95660641300","1630","58687510","58687510","0","2024-09"
"090470","제이스텍","98375639670","5670","17350201","17476594","126393","2024-09"
"287410","제이시스메디칼","960860460300","12900","74485307","75692193","1206886","2024-06"
"137950","제이씨케미칼","98422725360","4560","21583931","22267814","683883","2024-09"
"033320","제이씨현시스템","78118217385","4135","18891951","19114432","222481","2024-09"
"417500","제이아이테크","110294274560","3490","31602944","32784744","1181800","2024-09"
"204270","제이앤티씨","1321138576150","23150","57068621","57848466","779845","2024-09"
"194370","제이에스코퍼레이션","226948773600","17040","13318590","13335601","17011","2024-09"
"026040","제이에스티나","25239802478","1762","14324519","16503790","2179271","2024-09"
"452160","제이엔비","56450011390","5870","9616697","9617527","830","2024-09"
"126880","제이엔케이글로벌","89197273550","3850","23168123","23204903","36780","2024-09"
"322510","제이엘케이","166251701760","10480","15863712","16195712","332000","2024-09"
"033050","제이엠아이","29992646976","942","31839328","32579342","740014","2024-09"
"094970","제이엠티","53144586120","3180","16712134","16748240","36106","2024-09"
"418550","제이오","511354741170","17290","29575173","31772273","2197100","2024-09"
"025620","제이준코스메틱","22819225800","5100","4474358","4484846","10488","2024-09"
"420570","제이투케이바이오","85307870080","14930","5713856","5732807","18951","2024-09"
"089790","제이티","42588299200","4660","9139120","10315513","1176393","2024-09"
"030000","제일기획","1873656412500","18500","101278725","115041225","13762500","2024-09"
"052670","제일바이오","56184286080","2080","27011676","29129064","2117388","2024-09"
"271980","제일약품","212452717860","14580","14571517","14704872","133355","2024-09"
"412540","제일엠앤에스","214452922650","10410","20600665","20600665","0","2024-09"
"001560","제일연마","57782940000","8490","6806000","9900000","3094000","2024-09"
"199820","제일일렉트릭","197980200000","8910","22220000","22220000","0","2024-09"
"038010","제일테크노스","54885600000","6600","8316000","9000000","684000","2024-09"
"002620","제일파마홀딩스","134782877500","8780","15351125","15973355","622230","2024-09"
"276730","제주맥주","28907796475","2435","11871785","11886605","14820","2024-09"
"080220","제주반도체","409586544640","12160","33683104","34442833","759729","2024-09"
"006220","제주은행","260243069400","8100","32128774","32128774","0","2024-09"
"089590","제주항공","710637199020","8820","80571111","80640985","69874","2024-09"
"216080","제테마","324493651030","18170","17858759","17858759","0","2024-09"
"229000","젠큐릭스","34375231275","2255","15244005","15244005","0","2024-09"
"082270","젬백스","753124805680","18980","39679916","39994174","314258","2024-09"
"044060","조광ILI","70075958688","732","95732184","95732184","0","2024-09"
"004910","조광페인트","62226112640","6080","10234558","12800000","2565442","2024-09"
"004700","조광피혁","182975534500","51500","3552923","6649138","3096215","2024-09"
"001550","조비","54098847760","10420","5191828","5192239","411","2024-09"
"462520","조선내화","202620191400","17100","11849134","11855168","6034","2024-09"
"120030","조선선재","90175263500","93100","968585","1257651","289066","2024-09"
"034940","조아제약","42132564720","1360","30979827","30979827","0","2024-09"
"067000","조이시티","111146479140","1590","69903446","69903446","0","2024-09"
"018470","조일알미늄","205143388020","1620","126631721","126631721","0","2024-09"
"002600","조흥","103920000000","173200","600000","600000","0","2024-09"
"185750","종근당","1349931581000","107000","12616183","13174420","558237","2024-09"
"063160","종근당바이오","157721321250","28750","5485959","5485962","3","2024-09"
"001630","종근당홀딩스","268971527000","56500","4760558","5009861","249303","2024-09"
"033340","좋은사람들","63211763816","652","96950558","96950558","0","2024-09"
"036930","주성엔지니어링","1278608083050","27050","47268321","47268321","0","2024-09"
"109070","주성코퍼레이션","216476814300","4100","52799223","52810230","11007","2024-09"
"044380","주연테크","22632219909","351","64479259","66403852","1924593","2024-09"
"072020","중앙백신","101124028800","10550","9585216","9658687","73471","2024-09"
"000440","중앙에너비스","101534821500","22900","4433835","6227130","1793295","2024-09"
"051980","중앙첨단소재","1192827610000","11960","99734750","99961003","226253","2024-09"
"228760","지노믹트리","392958034560","16380","23990112","24362333","372221","2024-09"
"314130","지놈앤컴퍼니","121250889495","3915","30970853","30970853","0","2024-09"
"013890","지누스","481718928400","23600","20411819","20735204","323385","2024-09"
"389030","지니너스","49027212150","1470","33351845","33351845","0","2024-09"
"043610","지니뮤직","159817454500","2750","58115438","58115438","0","2024-09"
"263860","지니언스","82559136330","9570","8626869","9444600","817731","2024-09"
"303030","지니틱스","42704701640","1195","35736152","35745668","9516","2024-09"
"036180","지더블유바이텍","53929030348","577","93464524","93464524","0","2024-09"
"208350","지란지교시큐리티","22692001200","2900","7824828","8838549","1013721","2024-09"
"144510","지씨셀","530458077300","35300","15027141","15800344","773203","2024-09"
"358570","지아이이노베이션","652654890360","14760","44217811","44217811","0","2024-09"
"382480","지아이텍","90832934925","2325","39067929","39357140","289211","2024-09"
"382800","지앤비에스 에코","103749814480","3280","31631041","31631041","0","2024-09"
"051160","지어소프트","136698411300","9410","14526930","15474430","947500","2024-09"
"053050","지에스이","116801690315","3895","29987597","29987597","0","2024-09"
"119850","지엔씨에너지","76215379170","5110","14914947","16448909","1533962","2024-09"
"065060","지엔코","34731428116","322","107861578","108008044","146466","2024-09"
"204840","지엘팜텍","82937535694","1079","76865186","76865206","20","2024-09"
"013870","지엠비코리아","72379302600","3795","19072280","19072280","0","2024-09"
"071320","지역난방공사","558674398000","48250","11578744","11578744","0","2024-09"
"270520","지오릿에너지","157520459712","992","158790786","158790786","0","2024-09"
"311320","지오엘리먼트","86283590400","6840","12614560","12614560","0","2024-09"
"388050","지투파워","140287713120","7520","18655281","18709437","54156","2024-09"
"088790","진도","22654894080","1820","12447744","12447744","0","2024-09"
"018120","진로발효","117002067520","17680","6617764","6621120","3356","2024-09"
"109820","진매트릭스","65682096270","3290","19964163","20393640","429477","2024-09"
"086060","진바이오텍","29405154605","3415","8610587","8610587","0","2024-09"
"036890","진성티이씨","168877407400","8450","19985492","22482268","2496776","2024-09"
"363250","진시스템","67366867680","9930","6784176","7006491","222315","2024-09"
"003780","진양산업","83330000000","6410","13000000","13000000","0","2024-09"
"007370","진양제약","65378741760","5760","11350476","12574867","1224391","2024-09"
"010640","진양폴리","68300000000","6830","10000000","10000000","0","2024-09"
"100250","진양홀딩스","177747028560","3180","55895292","55895292","0","2024-09"
"051630","진양화학","41791000000","2645","15800000","15800000","0","2024-09"
"272450","진에어","541618493340","10510","51533634","52200000","666366","2024-09"
"285800","진영","43343584960","2480","17477252","17477270","18","2024-09"
"011000","진원생명과학","182809717590","2290","79829571","80039035","209464","2024-09"
"002780","진흥기업","109496451342","753","145413614","145471745","58131","2024-09"
"085660","차바이오텍","971424141750","17250","56314443","56314443","0","2024-09"
"261780","차백신연구소","107433115740","4005","26824748","26824748","0","2024-09"
"351870","차이커뮤니케이션","100724147000","9050","11129740","11131089","1349","2024-09"
"009310","참엔지니어링","31648651500","375","84396404","84867419","471015","2024-09"
"094850","참좋은여행","62576824475","4675","13385417","14000000","614583","2024-09"
"004650","창해에탄올","71017605360","9360","7587351","9190885","1603534","2024-09"
"278280","천보","532248000000","53600","9930000","10000000","70000","2024-09"
"000650","천일고속","58009745100","40650","1427054","1429220","2166","2024-09"
"362320","청담글로벌","130601748640","6490","20123536","20551290","427754","2024-09"
"012600","청호ICT","116119947330","2490","46634517","46634517","0","2024-09"
"066360","체리부로","34813162890","726","47952015","47952015","0","2024-09"
"033250","체시스","44192000000","1381","32000000","32000000","0","2024-09"
"047820","초록뱀미디어","131865872400","5400","24419606","24453930","34324","2024-09"
"094360","칩스앤미디어","263361399000","13020","20227450","20823124","595674","2024-09"
"016920","카스","28358764126","1154","24574319","26493538","1919219","2024-09"
"284620","카이노스메드","135411362960","4870","27805208","28180793","375585","2024-09"
"035720","카카오","16435962300100","37450","438877498","443530908","4653410","2024-09"
"293490","카카오게임즈","1370373059750","16750","81813317","82667326","854009","2024-09"
"323410","카카오뱅크","10314737709950","21650","476431303","476963637","532334","2024-09"
"377300","카카오페이","3203860466800","23800","134615986","134615986","0","2024-09"
"140430","카티스","49819403620","3115","15993388","17922947","1929559","2024-09"
"042000","카페24","602036408100","24900","24178169","24253054","74885","2024-09"
"006380","카프로","618528628380","3660","168996893","168999996","3103","2024-09"
"313760","캐리","45517935120","6220","7317996","7417913","99917","2024-09"
"317530","캐리소프트","28326069750","4125","6866926","6971196","104270","2024-09"
"071850","캐스텍코리아","50947969800","2100","24260938","24529188","268250","2024-09"
"050110","캠시스","79317729783","1083","73238901","73824118","585217","2024-09"
"452300","캡스톤파트너스","36721069900","2605","14096380","14096380","0","2024-09"
"451760","컨텍","132656346000","9000","14739594","14940476","200882","2024-09"
"078340","컴투스","428887501050","37550","11421771","12737755","1315984","2024-09"
"063080","컴투스홀딩스","137504707500","20850","6594950","6595192","242","2024-09"
"307930","컴퍼니케이","76801200000","4920","15610000","15610000","0","2024-09"
"079190","케스피온","22448825144","596","37665814","38355514","689700","2024-09"
"263700","케어랩스","57326937945","2955","19399979","19414200","14221","2024-09"
"214370","케어젠","817713214690","16690","48994201","53715000","4720799","2024-09"
"221980","케이디켐","47035705360","12560","3744881","4034800","289919","2024-09"
"038530","케이바이오","29913681819","259","115496841","115714347","217506","2024-09"
"001620","케이비아이동국실업","62657976453","563","111293031","111293031","0","2024-09"
"424140","케이비제21호스팩","16692150000","2165","7710000","7710000","0","2024-09"
"192250","케이사인","65517422949","957","68461257","70671257","2210000","2024-09"
"431190","케이쓰리아이","41849210780","5590","7486442","7486442","0","2024-09"
"029460","케이씨","223412159310","19230","11617897","13554044","1936147","2024-09"
"115500","케이씨에스","78360000000","6530","12000000","12000000","0","2024-09"
"281820","케이씨텍","696029851000","34750","20029636","20861556","831920","2024-09"
"089150","케이씨티","37558500000","2190","17150000","17150000","0","2024-09"
"025880","케이씨피드","44829786240","2840","15785136","16715858","930722","2024-09"
"093320","케이아이엔엑스","344866478100","71300","4836837","4880000","43163","2024-09"
"093640","케이알엠","125775475200","3860","32584320","32584320","0","2024-09"
"073010","케이에스피","161680004790","4035","40069394","40191250","121856","2024-09"
"105330","케이엔더블유","62370683790","3930","15870403","16060028","189625","2024-09"
"053080","케이엔솔","202152537600","15600","12958496","12999807","41311","2024-09"
"199430","케이엔알시스템","79986367680","7360","10867713","10867713","0","2024-09"
"432470","케이엔에스","131419523400","15150","8674556","8674556","0","2024-09"
"272110","케이엔제이","129127021350","16130","8005395","8005395","0","2024-09"
"039420","케이엘넷","55247566110","2585","21372366","24154730","2782364","2024-09"
"083550","케이엠","36445025760","3160","11533236","12374226","840990","2024-09"
"032500","케이엠더블유","304231546120","7640","39820883","39820883","0","2024-09"
"225430","케이엠제약","18935280469","679","27887011","27887050","39","2024-09"
"102370","케이옥션","112614061500","4350","25888290","27229210","1340920","2024-09"
"068100","케이웨더","33582665700","3450","9734106","9939614","205508","2024-09"
"381970","케이카","623476024620","12940","48182073","48182073","0","2024-09"
"036030","케이티알파","199998095280","4080","49019141","49019283","142","2024-09"
"064820","케이프","142856847360","5120","27901728","30901728","3000000","2024-09"
"256940","케이피에스","102180186100","5450","18748658","18748658","0","2024-09"
"024880","케이피에프","77595047860","4010","19350386","20682798","1332412","2024-09"
"042040","케이피엠테크","51984977136","298","174446232","174460917","14685","2024-09"
"054410","케이피티유","22562189360","3940","5726444","5726444","0","2024-09"
"258610","케일럼","40508990487","1527","26528481","26787133","258652","2024-09"
"274090","켄코아에어로스페이스","121771721180","9430","12913226","12913226","0","2024-09"
"089010","켐트로닉스","299599163100","20100","14905431","15334346","428915","2024-09"
"220260","켐트로스","123496057800","4650","26558292","26558307","15","2024-09"
"052400","코나아이","198186918880","13570","14604784","14899999","295215","2024-09"
"402030","코난테크놀로지","160340432000","14000","11452888","11452888","0","2024-09"
"391710","코닉오토메이션","85283461740","2055","41500468","41503222","2754","2024-09"
"046070","코다코","144219271360","10280","14029112","14064588","35476","2024-09"
"047770","코데즈컴바인","55113918140","1460","37749259","37842602","93343","2024-09"
"080530","코디","64643068168","1498","43152916","43300427","147511","2024-09"
"104540","코렌텍","79910875000","6250","12785740","12785740","0","2024-09"
"027050","코리아나","75888000000","2480","30600000","40000000","9400000","2024-09"
"007810","코리아써키트","247309262970","10470","23620751","23620751","0","2024-09"
"190650","코리아에셋투자증권","35772800000","5600","6388000","6388000","0","2024-09"
"123410","코리아에프티","140318937360","5040","27841059","27841064","5","2024-09"
"003690","코리안리","1340134486600","9100","147267526","165367526","18100000","2024-09"
"036690","코맥스","45885746130","2885","15904938","15904938","0","2024-09"
"049430","코메론","97480414500","10850","8984370","9048000","63630","2024-09"
"183300","코미코","533766884000","51800","10304380","10460684","156304","2024-09"
"041960","코미팜","297917158000","4300","69283060","70622233","1339173","2024-09"
"089890","코세스","145957294400","8900","16399696","16584962","185266","2024-09"
"360350","코셈","40951623400","7220","5671970","5671970","0","2024-09"
"082660","코스나인","47827116000","480","99639825","99640869","1044","2024-09"
"192820","코스맥스","1626967930800","143400","11345662","11349509","3847","2024-09"
"044820","코스맥스비티아이","83031550910","8690","9554839","9603921","49082","2024-09"
"222040","코스맥스엔비티","68858700600","3350","20554836","20628000","73164","2024-09"
"241710","코스메카코리아","798864000000","74800","10680000","10680000","0","2024-09"
"005070","코스모신소재","3311647692400","101900","32498996","32510756","11760","2024-09"
"005420","코스모화학","842097680050","21950","38364359","38408228","43869","2024-09"
"355150","코스텍시스","58985735710","7810","7552591","7797350","244759","2024-09"
"071950","코아스","33137550400","10070","3290720","3290720","0","2024-09"
"166480","코아스템켐온","359555504040","14760","24360129","32870376","8510247","2024-09"
"045970","코아시아","107270003725","4325","24802313","26314876","1512563","2024-09"
"196450","코아시아씨엠","38693263434","854","45308271","45319582","11311","2024-09"
"384470","코어라인소프트","95467885200","7440","12831705","12832064","359","2024-09"
"029960","코엔텍","355610870400","7320","48580720","50000000","1419280","2024-09"
"002020","코오롱","182830648480","14480","12626426","12626426","0","2024-09"
"138490","코오롱ENP","212800000000","5600","38000000","38000000","0","2024-09"
"003070","코오롱글로벌","170101171460","9020","18858223","18932713","74490","2024-09"
"450140","코오롱모빌리티그룹","141981917830","2315","61331282","62777250","1445968","2024-09"
"102940","코오롱생명과학","235547417520","18960","12423387","12423387","0","2024-09"
"120110","코오롱인더","881763798550","32050","27512131","27519091","6960","2024-09"
"021240","코웨이","4731620951400","65800","71909133","73799619","1890486","2024-09"
"033290","코웰패션","130354967040","2460","52989824","56156301","3166477","2024-09"
"056360","코위버","45132106500","4875","9257868","9796800","538932","2024-09"
"282880","코윈테크","150516445820","13780","10922819","11141807","218988","2024-09"
"121850","코이즈","28302431712","932","30367416","30614175","246759","2024-09"
"448710","코츠테크놀로지","96089606350","21650","4438319","5166069","727750","2024-09"
"126730","코칩","99987531270","12210","8188987","8503460","314473","2024-09"
"015710","코콤","81744839725","4925","16597937","17530500","932563","2024-09"
"052330","코텍","98692845450","7850","12572337","15574552","3002215","2024-09"
"322780","코퍼스코리아","37448171250","1015","36894750","37932613","1037863","2024-09"
"036420","콘텐트리중앙","194866481400","10200","19104557","19262308","157751","2024-09"
"200130","콜마비앤에이치","413751035320","14210","29116892","29415558","298666","2024-09"
"024720","콜마홀딩스","238016037460","6940","34296259","34296259","0","2024-09"
"031820","콤텍시스템","68273026824","564","121051466","121051466","0","2024-09"
"294570","쿠콘","138995782290","13630","10197783","10254685","56902","2024-09"
"192400","쿠쿠홀딩스","767636109500","24700","31078385","35562185","4483800","2024-09"
"284740","쿠쿠홈시스","528047049000","23550","22422380","22437330","14950","2024-09"
"317690","퀀타매트릭스","115596502890","6990","16537411","16537411","0","2024-09"
"078940","퀀타피아","151577916950","2855","53092090","53094278","2188","2024-09"
"227100","퀀텀온","17609329522","1123","15680614","15680614","0","2024-09"
"432720","퀄리타스반도체","135621977440","9820","13810792","13810792","0","2024-09"
"365270","큐라클","78249179520","5640","13873968","13873968","0","2024-09"
"348080","큐라티스","35070472320","832","42152010","42152010","0","2024-09"
"060280","큐렉소","273248433500","6650","41089990","41089990","0","2024-09"
"372320","큐로셀","436095531600","30900","14113124","14113124","0","2024-09"
"051780","큐로홀딩스","18599711566","137","135764318","136422450","658132","2024-09"
"115180","큐리언트","168862484860","5230","32287282","32292671","5389","2024-09"
"445680","큐리옥스바이오시스템즈","379883016800","23600","16096738","16096738","0","2024-09"
"182360","큐브엔터","195555683840","14080","13888898","14571557","682659","2024-09"
"405100","큐알티","168149998500","14260","11791725","12289301","497576","2024-09"
"066310","큐에스아이","59272166850","6630","8939995","9271621","331626","2024-09"
"016600","큐캐피탈","49214646204","282","174520022","178247112","3727090","2024-09"
"355390","크라우드웍스","46563266330","11030","4221511","4224606","3095","2024-09"
"264900","크라운제과","100815657910","8390","12016169","12523850","507681","2024-09"
"005740","크라운해태홀딩스","84858136500","5900","14382735","14847347","464612","2024-09"
"259960","크래프톤","15773072727000","347000","45455541","47900115","2444574","2024-09"
"096240","크레버스","132523385970","15710","8435607","11138180","2702573","2024-09"
"040350","크레오에스지","104960922036","692","151677633","152074086","396453","2024-09"
"110790","크리스에프앤씨","132051626840","6520","20253317","23430960","3177643","2024-09"
"045520","크린앤사이언스","31686060000","5180","6117000","6500000","383000","2024-09"
"036170","클라우드에어","52979710332","879","60272708","61365626","1092918","2024-09"
"214150","클래시스","3340788609000","51000","65505659","65505659","0","2024-09"
"352770","클리노믹스","22530021696","586","38447136","38886113","438977","2024-09"
"237880","클리오","399561404400","22800","17524623","18071353","546730","2024-09"
"139670","키네마스터","38897321550","2755","14118810","14118810","0","2024-09"
"020120","키다리스튜디오","129350540080","3490","37063192","37063766","574","2024-09"
"413600","키움제6호스팩","9038050000","2635","3430000","3430000","0","2024-09"
"433530","키움제7호스팩","9195200000","2240","4105000","4105000","0","2024-09"
"446840","키움제8호스팩","13435800000","2285","5880000","5880000","0","2024-09"
"039490","키움증권","3279451959900","135900","24131361","25526706","1395345","2024-09"
"054780","키이스트","85093499075","4355","19539265","19547793","8528","2024-09"
"219130","타이거일렉","121486939600","19240","6314290","6314290","0","2024-09"
"360070","탑머티리얼","267024912400","33350","8006744","8076743","69999","2024-09"
"065130","탑엔지니어링","62138359980","4005","15515196","17189982","1674786","2024-09"
"134580","탑코미디어","45672743500","2110","21645850","22025767","379917","2024-09"
"014580","태경비케이","121365640000","4400","27583100","27583100","0","2024-09"
"015890","태경산업","149358912500","5110","29228750","29228750","0","2024-09"
"006890","태경케미컬","123426160110","10890","11333899","11600000","266101","2024-09"
"023160","태광","333687421800","12900","25867242","26500000","632758","2024-09"
"003240","태광산업","531910792000","632000","841631","1113400","271769","2024-09"
"011280","태림포장","142841176075","2075","68839121","70805940","1966819","2024-09"
"323280","태성","698450746500","27050","25820730","25820730","0","2024-09"
"053620","태양","50552546850","6350","7961031","8600000","638969","2024-09"
"004100","태양금속","111639130900","3065","36423860","36700000","276140","2024-09"
"009410","태영건설","1330097939940","4620","287899987","287905337","5350","2024-09"
"044490","태웅","283304514960","14160","20007381","20007381","0","2024-09"
"124560","태웅로직스","102345772720","2830","36164584","38416584","2252000","2024-09"
"001420","태원물산","27865806600","3800","7333107","7600000","266893","2024-09"
"191420","테고사이언스","135951490680","16980","8006566","8108834","102268","2024-09"
"073640","테라사이언스","59577565530","654","91097195","95587404","4490209","2024-09"
"066700","테라젠이텍스","111058665130","3470","32005379","32474435","469056","2024-09"
"095610","테스","282413738600","16100","17541226","19768226","2227000","2024-09"
"055490","테이팩스","80988657000","16980","4769650","4769650","0","2024-09"
"064520","테크엘","45137954440","2020","22345522","22351062","5540","2024-09"
"089030","테크윙","1497525860600","41900","35740474","37353645","1613171","2024-09"
"054450","텔레칩스","189092201760","12810","14761296","15144233","382937","2024-09"
"078000","텔코웨어","51071989670","9890","5164003","9240077","4076074","2024-09"
"200230","텔콘RF제약","66137629250","550","120250235","120250235","0","2024-09"
"214420","토니모리","184050412700","7700","23902651","24054799","152148","2024-09"
"393210","토마토시스템","98434912000","6400","15380455","15614544","234089","2024-09"
"215480","토박스코리아","23162820120","2585","8960472","9400000","439528","2024-09"
"051360","토비스","306227780300","20050","15273206","16167058","893852","2024-09"
"045340","토탈소프트","43218102000","5050","8558040","8558040","0","2024-09"
"108230","톱텍","190558125240","5230","36435588","38023245","1587657","2024-09"
"079970","투비소프트","7638197259","913","8366043","9290500","924457","2024-09"
"199800","툴젠","436143607200","54900","7944328","7946828","2500","2024-09"
"417790","트루엔","93168679900","8900","10468391","10999650","531259","2024-09"
"290090","트윔","61262783750","8750","7001461","7432268","430807","2024-09"
"026150","특수건설","108260862270","6170","17546331","17546331","0","2024-09"
"464280","티디에스팜","77740950000","14700","5288500","5530000","241500","2024-09"
"322180","티라유텍","92674254750","5610","16519475","16519475","0","2024-09"
"117730","티로보틱스","128426832000","7200","17837060","17837060","0","2024-09"
"033830","티비씨","80544373800","852","94535650","100000000","5464350","2024-09"
"057680","티사이언티픽","62484935377","877","71248501","71248501","0","2024-09"
"204610","티쓰리","84048264342","1434","58611063","63851720","5240657","2024-09"
"064760","티씨케이","1042577500000","89300","11675000","11675000","0","2024-09"
"246710","티앤알바이오팹","150612327720","6990","21546828","21546828","0","2024-09"
"340570","티앤엘","602979221700","74700","8072011","8128000","55989","2024-09"
"043220","티에스넥스젠","82347791535","579","142224165","142224165","0","2024-09"
"277880","티에스아이","123182683520","6110","20160832","20160832","0","2024-09"
"131290","티에스이","594282152000","55100","10785520","11061429","275909","2024-09"
"019180","티에이치엔","56880000000","3160","18000000","18000000","0","2024-09"
"425420","티에프이","179844900000","15900","11311000","11381000","70000","2024-09"
"131100","티엔엔터테인먼트","43972228384","1568","28043513","28048252","4739","2024-09"
"356860","티엘비","112482971300","11510","9772630","9832630","60000","2024-09"
"062860","티엘아이","42843237000","5800","7386765","9872720","2485955","2024-09"
"363280","티와이홀딩스","120376099000","3400","35404735","50429268","15024533","2024-09"
"321550","티움바이오","159276017160","6120","26025493","26025493","0","2024-09"
"091810","티웨이항공","663810509725","3085","215173585","215378976","205391","2024-09"
"004870","티웨이홀딩스","66185432112","593","111611184","111611693","509","2024-09"
"425040","티이엠씨","189108651420","8940","21153093","21316062","162969","2024-09"
"241790","티이엠씨씨엔에스","56629337710","5830","9713437","10002634","289197","2024-09"
"104480","티케이케미칼","132980019942","1463","90895434","90895434","0","2024-09"
"081150","티플랙스","73411916050","3025","24268402","24268402","0","2024-09"
"130740","티피씨글로벌","21606116964","1916","11276679","11276679","0","2024-09"
"084730","팅크웨어","105106837380","10030","10479246","11109424","630178","2024-09"
"440110","파두","1039268599600","21100","49254436","49334436","80000","2024-09"
"034230","파라다이스","889511347500","10300","86360325","91771623","5411298","2024-09"
"033540","파라텍","50706797805","1355","37421991","37751063","329072","2024-09"
"388870","파로스아이바이오","125301021780","9690","12930962","12930962","0","2024-09"
"043200","파루","22275526156","533","41792732","41804315","11583","2024-09"
"214450","파마리서치","2381816637000","229500","10378286","10498238","119952","2024-09"
"208340","파멥신","233760977175","2915","80192445","80201108","8663","2024-09"
"005690","파미셀","299720049930","4995","60004014","60016964","12950","2024-09"
"177830","파버나인","37362473780","3140","11898877","14288753","2389876","2024-09"
"037070","파세코","115039785600","5760","19972185","20000000","27815","2024-09"
"150900","파수","54881701655","4855","11304161","11685422","381261","2024-09"
"037030","파워넷","54136518975","2475","21873341","21878974","5633","2024-09"
"047310","파워로직스","181223237250","4950","36610755","36610755","0","2024-09"
"368770","파이버프로","150720377250","4610","32694225","32854225","160000","2024-09"
"170790","파이오링크","53841678540","8060","6680109","6856330","176221","2024-09"
"049120","파인디앤씨","55237781888","1184","46653532","46653532","0","2024-09"
"038950","파인디지털","31163621400","3800","8200953","10210765","2009812","2024-09"
"441270","파인엠텍","220727335410","5970","36972753","36987901","15148","2024-09"
"106240","파인테크닉스","16522608342","1041","15871862","15923057","51195","2024-09"
"131760","파인텍","35483603311","817","43431583","43431583","0","2024-09"
"065690","파커스","14050554638","1054","13330697","14049331","718634","2024-09"
"140860","파크시스템스","1436170554000","207000","6938022","6983609","45587","2024-09"
"091700","파트론","356212203650","7010","50814865","58918214","8103349","2024-09"
"032800","판타지오","37249153971","163","228522417","229785294","1262877","2024-09"
"318010","팜스빌","43432023160","5620","7728118","7929338","201220","2024-09"
"036580","팜스코","74239932320","2120","35018836","36727943","1709107","2024-09"
"027710","팜스토리","144778359649","1309","110602261","111416600","814339","2024-09"
"004720","팜젠사이언스","85060724350","4690","18136615","18178525","41910","2024-09"
"225590","패션플랫폼","22738911216","888","25606882","26636713","1029831","2024-09"
"054300","팬스타엔터프라이즈","32946178776","492","66963778","66985895","22117","2024-09"
"068050","팬엔터테인먼트","57869942060","2140","27042029","27694076","652047","2024-09"
"028670","팬오션","1865647596880","3490","534569512","534569512","0","2024-09"
"222110","팬젠","55132918890","4830","11414683","11414683","0","2024-09"
"271830","팸텍","60694368615","2115","28697101","29490202","793101","2024-09"
"010820","퍼스텍","172025722980","3540","48594837","48771938","177101","2024-09"
"016800","퍼시스","399570706800","44650","8948952","11500000","2551048","2024-09"
"263750","펄어비스","2244879435500","36550","61419410","64247855","2828445","2024-09"
"251970","펌텍코리아","433323590700","34950","12398386","12400000","1614","2024-09"
"001020","페이퍼코리아","145183929312","816","177921482","177983313","61831","2024-09"
"168360","펨트론","158810598640","7460","21288284","21288284","0","2024-09"
"087010","펩트론","1924546871500","93500","20583389","20657350","73961","2024-09"
"090080","평화산업","54188529633","987","54902259","54902259","0","2024-09"
"010770","평화홀딩스","39209918725","2725","14388961","14625466","236505","2024-09"
"064800","포니링크","185670412680","1473","126049160","127807298","1758138","2024-09"
"119500","포메탈","34356972800","2900","11847232","11847232","0","2024-09"
"389140","포바이포","59814025160","5420","11035798","11112735","76937","2024-09"
"105760","포스뱅크","61584502350","6510","9459985","9459985","0","2024-09"
"022100","포스코DX","4015705627550","26450","151822519","152034729","212210","2024-09"
"058430","포스코스틸리온","222250889000","37100","5990590","6000000","9410","2024-09"
"009520","포스코엠텍","655823054250","15750","41639559","41642703","3144","2024-09"
"047050","포스코인터내셔널","8539268798700","50100","170444487","175922788","5478301","2024-09"
"003670","포스코퓨처엠","17926263616000","231500","77435264","77463220","27956","2024-09"
"189690","포시에스","61867344990","2270","27254337","27321969","67632","2024-09"
"318020","포인트모바일","52969331000","4250","12463372","12662272","198900","2024-09"
"256630","포인트엔지니어링","71260174144","1252","56917072","57997072","1080000","2024-09"
"331380","포커스에이치엔에스","77760801680","3490","22281032","22725452","444420","2024-09"
"472850","폰드그룹","209537130960","6480","32335977","32343933","7956","2024-09"
"039980","폴라리스AI","157259424735","2205","71319467","72152777","833310","2024-09"
"041910","폴라리스AI파마","82492839660","6610","12480006","12698263","218257","2024-09"
"234100","폴라리스세원","67798863398","1246","54413213","54413213","0","2024-09"
"041020","폴라리스오피스","232023313310","4670","49683793","49725498","41705","2024-09"
"114630","폴라리스우노","39592244111","521","75992791","77757548","1764757","2024-09"
"290720","푸드나무","40091619210","3210","12489601","13403058","913457","2024-09"
"005670","푸드웰","47706980420","5060","9428257","10000000","571743","2024-09"
"094940","푸른기술","48219664300","6100","7904863","8361386","456523","2024-09"
"057880","푸른소나무","215672327790","8790","24536101","24580368","44267","2024-09"
"007330","푸른저축은행","102416368800","8740","11718120","15082800","3364680","2024-09"
"017810","풀무원","381535724250","10350","36863355","38120542","1257187","2024-09"
"093380","풍강","26607316050","2775","9588222","9879313","291091","2024-08"
"023900","풍국주정","127890000000","10150","12600000","12600000","0","2024-09"
"103140","풍산","1901073748800","69600","27314278","28024278","710000","2024-09"
"005810","풍산홀딩스","383704558400","27400","14003816","14417292","413476","2024-09"
"371950","풍원정밀","222397958160","10570","21040488","21040488","0","2024-09"
"370090","퓨런티어","130091097000","15900","8181830","8181830","0","2024-09"
"445180","퓨릿","107322803200","6400","16769188","16769188","0","2024-09"
"151910","퓨처코어","121645902080","640","190071722","190071722","0","2024-09"
"220100","퓨쳐켐","628657601600","28450","22096928","22102155","5227","2024-09"
"035200","프럼파스트","23319719540","2755","8464508","9730590","1266082","2024-09"
"334970","프레스티지바이오로직스","442195562110","7190","61501469","61501469","0","2024-09"
"321260","프로이천","58921390770","2090","28192053","28192084","31","2024-09"
"053610","프로텍","284850000000","31650","9000000","11000000","2000000","2024-09"
"303360","프로티아","35541113400","2760","12877215","12877215","0","2024-09"
"377220","프롬바이오","60866500000","2150","28310000","28310000","0","2024-09"
"335810","프리시젼바이오","38386008430","3305","11614526","11614526","0","2024-09"
"053160","프리엠스","69139923600","12900","5359684","6000000","640316","2024-09"
"405000","플라즈맵","48763698280","1870","26076844","26076844","0","2024-09"
"041590","플래스크","103917099150","789","131707350","131707350","0","2024-09"
"367000","플래티어","38651305230","4770","8102999","8388207","285208","2024-09"
"075130","플랜티넷","31092774774","1997","15569742","16622320","1052578","2024-09"
"009810","플레이그램","54372282830","358","151877885","151887500","9615","2024-09"
"237820","플레이디","85172209600","6640","12827140","12827140","0","2024-09"
"023770","플레이위드","36820644000","4200","8766820","8766820","0","2024-09"
"019570","플루토스","19411967860","370","52464778","52470042","5264","2024-09"
"300080","플리토","83387442050","15170","5496865","5501817","4952","2024-09"
"033790","피노","187298100000","8250","22702800","22822800","120000","2024-09"
"032580","피델릭스","46823757358","1414","33114397","33132064","17667","2024-09"
"051380","피씨디렉트","40876081645","2765","14783393","15340072","556679","2024-09"
"241820","피씨엘","52248846861","883","59171967","59171967","0","2024-09"
"237750","피앤씨테크","29754428000","4580","6496600","6496600","0","2024-09"
"460940","피앤에스미캐닉스","81026184800","12520","6471740","6471740","0","2024-09"
"319660","피에스케이","593817637000","20500","28966714","28966714","0","2024-09"
"031980","피에스케이홀딩스","1106150863500","51300","21562395","21562395","0","2024-09"
"002230","피에스텍","60163576200","3640","16528455","19370673","2842218","2024-09"
"043370","피에이치에이","198848108340","10180","19533213","21000000","1466787","2024-09"
"239890","피엔에이치테크","68159279300","6860","9935755","9935755","0","2024-09"
"347740","피엔케이피부임상연구센타","69749525265","2415","28881791","30010576","1128785","2024-09"
"137400","피엔티","1190263603200","51200","23247336","23743086","495750","2024-09"
"257370","피엔티엠에스","60934339040","4960","12285149","12504861","219712","2024-09"
"147760","피엠티","36408849090","3365","10819866","10819866","0","2024-09"
"128660","피제이메탈","81603084010","3290","24803369","24803369","0","2024-09"
"006140","피제이전자","76703400000","5160","14865000","15000000","135000","2024-09"
"376180","피코그램","60708047400","3300","18396378","18491378","95000","2024-09"
"304840","피플바이오","78658251320","3740","21031618","21089464","57846","2024-09"
"087600","픽셀플러스","45295766190","6990","6480081","8166558","1686477","2024-09"
"291810","핀텔","22601846880","1990","11357712","11357712","0","2024-09"
"378340","필에너지","322906829940","15170","21285882","21285882","0","2024-09"
"161580","필옵틱스","499123483000","21850","22843180","22843180","0","2024-09"
"347770","핌스","51656914920","2260","22857042","22857042","0","2024-09"
"163730","핑거","95265757530","10370","9186669","9360608","173939","2024-09"
"417180","핑거스토리","41846187500","2500","16738475","16739405","930","2024-09"
"446750","하나26호스팩","12813750000","2125","6030000","6030000","0","2024-09"
"448370","하나27호스팩","11998700000","2135","5620000","5620000","0","2024-09"
"454750","하나28호스팩","15016170000","2085","7202000","7202000","0","2024-09"
"454640","하나29호스팩","11558140000","2140","5401000","5401000","0","2024-09"
"469880","하나30호스팩","15011775000","2055","7305000","7305000","0","2024-09"
"469900","하나31호스팩","11658400000","2080","5605000","5605000","0","2024-09"
"475240","하나32호스팩","6960000000","2175","3200000","3200000","0","2024-09"
"475250","하나33호스팩","7936500000","2145","3700000","3700000","0","2024-09"
"406760","하나금융21호스팩","15375750000","2075","7410000","7410000","0","2024-09"
"418170","하나금융22호스팩","13552550000","2255","6010000","6010000","0","2024-09"
"435620","하나금융25호스팩","44697780000","10390","4302000","4302000","0","2024-09"
"086790","하나금융지주","17750471851800","63900","277785162","287240880","9455718","2024-09"
"299030","하나기술","218261043000","27300","7994910","7994910","0","2024-09"
"067310","하나마이크론","688349061120","10470","65744896","65744896","0","2024-09"
"166090","하나머티리얼즈","566125063700","29050","19487954","19777674","289720","2024-09"
"293480","하나제약","190294346000","11000","17299486","17772946","473460","2024-09"
"039130","하나투어","735771770000","47500","15489932","16039185","549253","2024-09"
"136480","하림","301040660970","2835","106187182","106209702","22520","2024-09"
"003380","하림지주","501867693960","5160","97261181","112005621","14744440","2024-09"
"450330","하스","63785113260","8140","7836009","7836009","0","2024-09"
"101670","하이드로리튬","82194325780","1666","49336330","51086330","1750000","2024-09"
"365590","하이딥","127264953942","882","144291331","144447309","155978","2024-09"
"149980","하이로닉","111620963000","6680","16709725","18594363","1884638","2024-09"
"013030","하이록코리아","277759604250","22950","12102815","12856050","753235","2024-09"
"352820","하이브","8047256608300","193900","41502097","41652097","150000","2024-09"
"126700","하이비젼시스템","243124492100","19100","12729031","14942112","2213081","2024-09"
"106080","하이소닉","94248810410","5990","15734359","15735465","1106","2024-09"
"071090","하이스틸","63780021160","3160","20183551","20191471","7920","2024-09"
"450050","하이제8호스팩","10529400000","2100","5014000","5014000","0","2024-09"
"160190","하이젠알앤엠","207207840000","7430","27888000","30888000","3000000","2024-09"
"221840","하이즈항공","34259427752","1832","18700561","18700561","0","2024-09"
"106190","하이텍팜","162678749400","15300","10632598","10633173","575","2024-09"
"019490","하이트론","95194989050","3170","30029965","30044269","14304","2024-09"
"000080","하이트진로","1455367852400","21200","68649427","70133611","1484184","2024-09"
"000140","하이트진로홀딩스","197639412750","9250","21366423","23206765","1840342","2024-09"
"065650","하이퍼코퍼레이션","131009206500","1230","106511550","106681728","170178","2024-09"
"066130","하츠","61704728540","5140","12004811","12800000","795189","2024-09"
"004590","한국가구","55425000000","3695","15000000","15000000","0","2024-09"
"036460","한국가스공사","3512836218500","40250","87275434","92313000","5037566","2024-09"
"039340","한국경제TV","115470893940","5430","21265358","23000000","1734642","2024-09"
"005430","한국공항","175541311400","57400","3058211","3166355","108144","2024-09"
"071050","한국금융지주","4092508608800","77600","52738513","55725992","2987479","2024-09"
"034950","한국기업평가","380066209200","85200","4460871","4540514","79643","2024-09"
"010040","한국내화","77961624400","2200","35437102","41067062","5629960","2024-09"
"025540","한국단자","784971500000","76100","10315000","10415000","100000","2024-09"
"222980","한국맥널티","40676751920","3745","10861616","11031483","169867","2024-09"
"010100","한국무브넥스","103988184300","3415","30450420","30450420","0","2024-09"
"256840","한국비엔씨","334214084560","5030","66444152","67912443","1468291","2024-09"
"219750","한국비티비","63245329550","967","65403650","65426885","23235","2024-09"
"004090","한국석유","220291193080","17480","12602471","12694120","91649","2024-09"
"025550","한국선재","61722790560","2790","22122864","23300000","1177136","2024-09"
"002200","한국수출포장","98494450050","2650","37167717","40000000","2832283","2024-09"
"002960","한국쉘석유","417950000000","321500","1300000","1300000","0","2024-09"
"017890","한국알콜","186254366650","9050","20580593","21605760","1025167","2024-09"
"000240","한국앤컴퍼니","1534433932800","16200","94718144","94935240","217096","2024-09"
"080720","한국유니온제약","15410411825","2725","5655197","7912828","2257631","2024-09"
"123890","한국자산신탁","358535471150","2930","122367055","123977752","1610697","2024-09"
"015760","한국전력","14797271974850","23050","641964077","641964077","0","2024-09"
"063570","한국전자금융","154684876800","5100","30330368","34147728","3817360","2024-09"
"041460","한국전자인증","64826259375","3425","18927375","19000000","72625","2024-09"
"006200","한국전자홀딩스","32014797510","730","43855887","46803136","2947249","2024-09"
"101680","한국정밀기계","19998590220","2380","8402769","8404000","1231","2024-09"
"039740","한국정보공학","21609579915","2695","8018397","8018397","0","2024-09"
"053300","한국정보인증","158128135550","3850","41072243","42441361","1369118","2024-09"
"025770","한국정보통신","288521375280","8080","35708091","37444271","1736180","2024-09"
"458610","한국제12호스팩","9221400000","2180","4230000","4230000","0","2024-09"
"464440","한국제13호스팩","9223200000","2135","4320000","4320000","0","2024-09"
"477530","한국제14호스팩","10942750000","2275","4810000","4810000","0","2024-09"
"479880","한국제15호스팩","14049150000","2045","6870000","6870000","0","2024-09"
"027970","한국제지","190531021440","1002","190150720","190178237","27517","2024-09"
"023350","한국종합기술","45569147700","4380","10403915","10950000","546085","2024-09"
"025890","한국주강","21954893520","1970","11144616","11309259","164643","2024-09"
"000970","한국주철관","137885317700","6410","21510970","22800500","1289530","2024-09"
"104700","한국철강","274327944000","8000","34290993","42450000","8159007","2024-09"
"062970","한국첨단소재","19736818000","2000","9868409","9868409","0","2024-09"
"017960","한국카본","530075124420","10770","49217746","51908452","2690706","2024-09"
"023760","한국캐피탈","177323906025","567","312740575","315609576","2869001","2024-09"
"054040","한국컴퓨터","64999329980","4805","13527436","16071290","2543854","2024-09"
"161890","한국콜마","1657076405400","70200","23605077","23605077","0","2024-09"
"021650","한국큐빅","39812718050","2450","16250089","16350563","100474","2024-09"
"161390","한국타이어앤테크놀로지","4415992858600","36200","121988753","123875069","1886316","2024-09"
"034830","한국토지신탁","224280559143","1041","215447223","252489230","37042007","2024-09"
"007280","한국특강","93834938873","1543","60813311","60813311","0","2024-09"
"032300","한국파마","235039406550","21550","10906701","10906701","0","2024-09"
"037230","한국팩키지","59392051711","1993","29800327","29800327","0","2024-09"
"047810","한국항공우주","5575576120400","57200","97475107","97475107","0","2024-09"
"123690","한국화장품","106042668600","6600","16067071","16068000","929","2024-09"
"003350","한국화장품제조","289638059300","79900","3625007","4532000","906993","2024-09"
"030520","한글과컴퓨터","415916726400","17280","24069255","24179744","110489","2024-09"
"052600","한네트","45098430000","3900","11563700","11563700","0","2024-09"
"011500","한농화성","287374635800","18790","15294020","15637042","343022","2024-09"
"002390","한독","202736841090","14730","13763533","13763533","0","2024-09"
"256150","한독크린텍","54494293000","7000","7784899","8395000","610101","2024-09"
"092460","한라IMS","104599552000","6400","16343680","17109680","766000","2024-09"
"053690","한미글로벌","143215424000","14080","10171550","10957550","786000","2024-09"
"042700","한미반도체","9395422676400","98200","95676402","96993634","1317232","2024-09"
"008930","한미사이언스","2650991589900","39150","67713706","68391550","677844","2024-09"
"128940","한미약품","4222511262000","333000","12680214","12810991","130777","2024-09"
"452190","한빛레이저","99476018255","4295","23160889","23162757","1868","2024-09"
"047080","한빛소프트","33485366338","1349","24822362","24822362","0","2024-09"
"009240","한샘","849936486400","51200","16600322","23533928","6933606","2024-09"
"452280","한선엔지니어링","149792025000","8810","17002500","17002500","0","2024-09"
"020000","한섬","340625124840","15860","21476994","23398500","1921506","2024-09"
"003680","한성기업","28579158300","5060","5648055","6209515","561460","2024-09"
"066980","한성크린텍","112173660000","2160","51932250","51935125","2875","2024-09"
"105630","한세실업","622248856200","15800","39382839","40000000","617161","2024-09"
"069640","한세엠케이","40387359680","1472","27437065","30106502","2669437","2024-09"
"016450","한세예스24홀딩스","189919414045","4835","39280127","40000000","719873","2024-09"
"010420","한솔PNS","21517662600","1050","20493012","20493012","0","2024-09"
"009180","한솔로지스틱스","62552244820","2230","28050334","28057025","6691","2024-09"
"114810","한솔아이원스","191501700390","6930","27633723","29113174","1479451","2024-09"
"070590","한솔인티큐브","15465922832","1132","13662476","13879521","217045","2024-09"
"213500","한솔제지","223027021840","9380","23776868","23800576","23708","2024-09"
"014680","한솔케미칼","1410098258000","124400","11335195","11335195","0","2024-09"
"004710","한솔테크닉스","137922899630","4390","31417517","32109878","692361","2024-09"
"004150","한솔홀딩스","93950957510","2290","41026619","42008577","981958","2024-09"
"025750","한솔홈데코","55670517959","691","80565149","80565149","0","2024-09"
"226440","한송네오텍","100580954580","1530","65739186","65739186","0","2024-09"
"042520","한스바이오메드","110908800660","8540","12986979","13526367","539388","2024-09"
"004960","한신공영","77986531480","6740","11570702","11570702","0","2024-09"
"011700","한신기계","113049797745","3495","32346151","32446151","100000","2024-09"
"430690","한싹","52188506160","4790","10895304","10895327","23","2024-09"
"078350","한양디지텍","167961711240","11320","14837607","15244382","406775","2024-09"
"045100","한양이엔지","279687780120","16660","16787982","18000000","1212018","2024-09"
"001750","한양증권","157324680240","12360","12728534","12728534","0","2024-09"
"018880","한온시스템","2054623455500","3850","533668430","533800000","131570","2024-09"
"009420","한올바이오파마","2413809328000","47600","50710280","52240638","1530358","2024-09"
"320000","한울반도체","79981681780","2860","27965623","27965627","4","2024-09"
"091440","한울소재과학","69346570650","4935","14051990","14606671","554681","2024-09"
"014130","한익스프레스","40179000000","3405","11800000","12000000","200000","2024-09"
"024740","한일단조","107128339360","3430","31232752","31532546","299794","2024-09"
"005860","한일사료","162146163775","4115","39403685","39403685","0","2024-09"
"300720","한일시멘트","986976945000","14250","69261540","69261540","0","2024-09"
"002220","한일철강","49194554800","2020","24353740","26697460","2343720","2024-09"
"006390","한일현대시멘트","267301703760","13830","19327672","19327672","0","2024-09"
"003300","한일홀딩스","410674834080","13320","30831444","30832884","1440","2024-09"
"007770","한일화학","42295500000","12050","3510000","3510000","0","2024-09"
"051600","한전KPS","2022750000000","44950","45000000","45000000","0","2024-09"
"052690","한전기술","2685871453000","70600","38043505","38220000","176495","2024-09"
"130660","한전산업","437492000000","13420","32600000","32600000","0","2024-09"
"198940","한주라이트메탈","38607596416","992","38918948","38922978","4030","2024-09"
"058450","한주에이알티","34581725930","2395","14439134","14452469","13335","2024-09"
"107640","한중엔시에스","363327207600","40600","8948946","8948946","0","2024-09"
"002320","한진","277953850670","19210","14469227","14947628","478401","2024-09"
"003480","한진중공업홀딩스","89095656160","3415","26089504","29529812","3440308","2024-09"
"180640","한진칼","6015427077300","90700","66322239","66762279","440040","2024-09"
"005110","한창","22551214950","1254","17983425","18606407","622982","2024-09"
"079170","한창산업","39652726490","7670","5169847","5200000","30153","2024-09"
"009460","한창제지","43497597294","729","59667486","59667486","0","2024-09"
"372910","한컴라이프케어","113465064600","4100","27674406","27674406","0","2024-09"
"054920","한컴위드","61325781045","2465","24878613","28217081","3338468","2024-09"
"457370","한켐","136461193000","17000","8027129","8027134","5","2024-09"
"002680","한탑","21618708903","697","31016799","32316799","1300000","2024-09"
"000880","한화","1907840880000","27500","69376032","74958735","5582703","2024-09"
"452260","한화갤러리아","252879283845","1305","193777229","193859610","82381","2024-09"
"088350","한화생명","2133948310000","2840","751390250","868530000","117139750","2024-09"
"000370","한화손해보험","539947389420","4670","115620426","116738915","1118489","2024-09"
"009830","한화솔루션","3463172305550","20450","169348279","171892536","2544257","2024-09"
"272210","한화시스템","3594010476420","19220","186993261","188919389","1926128","2024-09"
"012450","한화에어로스페이스","17004488952000","374000","45466548","45581161","114613","2024-09"
"082740","한화엔진","1272239408750","15250","83425535","83447142","21607","2024-09"
"042660","한화오션","9115316313250","29750","306397187","306413394","16207","2024-09"
"489790","한화인더스트리얼솔루션즈","2176309814400","43200","50377542","50488390","110848","2024-09"
"003530","한화투자증권","734644782780","3435","213870388","214547775","677387","2024-09"
"430460","한화플러스제3호스팩","12639200000","2135","5920000","5920000","0","2024-09"
"455310","한화플러스제4호스팩","10701900000","2115","5060000","5060000","0","2024-09"
"195870","해성디에스","470900000000","27700","17000000","17000000","0","2024-09"
"034810","해성산업","200622992400","6770","29634120","32556857","2922737","2024-09"
"059270","해성에어로보틱스","70632665660","6340","11140799","11140799","0","2024-09"
"076610","해성옵틱스","27912408426","1098","25421137","25453198","32061","2024-09"
"101530","해태제과식품","152211379880","5740","26517662","29116822","2599160","2024-09"
"220180","핸디소프트","61523360000","3170","19408000","19408000","0","2024-09"
"143210","핸즈코퍼레이션","41095963960","1912","21493705","21875747","382042","2024-09"
"214180","헥토이노베이션","153842853340","12430","12376738","13257185","880447","2024-09"
"234340","헥토파이낸셜","133374761700","16050","8309954","9453000","1143046","2024-09"
"084990","헬릭스미스","166919969000","3625","46046888","46092797","45909","2024-09"
"187660","현대ADM","81650305940","3860","21152929","21836250","683321","2024-09"
"000720","현대건설","3156935937750","28350","111355765","111355765","0","2024-09"
"170030","현대공업","78887496980","5260","14997623","15340000","342377","2024-09"
"453340","현대그린푸드","391651268450","11570","33850585","33880914","30329","2024-09"
"086280","현대글로비스","9157500000000","122100","75000000","75000000","0","2024-09"
"064350","현대로템","6941449834800","63600","109142293","109142293","0","2024-09"
"079430","현대리바트","159907905900","7950","20114202","20535282","421080","2024-09"
"012330","현대모비스","22502160750000","250000","90008643","92995094","2986451","2024-09"
"319400","현대무벡스","369030758340","3165","116597396","117741058","1143662","2024-09"
"048410","현대바이오","673743435840","16920","39819352","39821608","2256","2024-09"
"052260","현대바이오랜드","156300000000","5210","30000000","30000000","0","2024-09"
"069960","현대백화점","997689240900","45650","21855186","23402441","1547255","2024-09"
"004560","현대비앤지스틸","189993018600","12600","15078811","15078811","0","2024-09"
"016790","현대사료","187340898626","994","188471729","188471729","0","2024-09"
"004310","현대약품","101537186730","3885","26135698","32000000","5864302","2024-08"
"041440","현대에버다임","135597011200","7600","17841712","17915944","74232","2024-09"
"039010","현대에이치티","45837100000","5900","7769000","8625000","856000","2024-09"
"017800","현대엘리베이","1621117283800","44900","36105062","39092385","2987323","2024-09"
"307950","현대오토에버","3831009305200","139700","27423116","27423982","866","2024-09"
"011210","현대위아","1293651793650","48550","26645763","27195083","549320","2024-09"
"090850","현대이지웰","120156586660","5060","23746361","23746361","0","2024-09"
"004020","현대제철","3492539370450","26550","131545739","133445785","1900046","2024-09"
"005440","현대지에프홀딩스","682860838380","4380","155904301","155904301","0","2024-09"
"005380","현대차","46576498808500","228500","203835881","209416191","5580310","2024-09"
"001500","현대차증권","281607550560","8880","31712562","31712562","0","2024-09"
"011760","현대코퍼레이션","217638703920","18120","12010966","13228966","1218000","2024-09"
"227840","현대코퍼레이션홀딩스","91833907410","10410","8821701","9100836","279135","2024-09"
"126560","현대퓨처넷","426844250625","3875","110153355","110202945","49590","2024-09"
"001450","현대해상","2352435000000","30000","78414500","89400000","10985500","2024-09"
"057050","현대홈쇼핑","536327087500","46850","11447750","12000000","552250","2024-09"
"460930","현대힘스","353692048710","10010","35333871","35333871","0","2024-09"
"092300","현우산업","51599200980","2820","18297589","18672816","375227","2024-09"
"138360","협진","40103065180","830","48316946","48348248","31302","2024-09"
"011080","형지I&C","15374206791","603","25496197","25503364","7167","2024-09"
"093240","형지엘리트","45372283420","1340","33859913","34164255","304342","2024-09"
"003010","혜인","52344333010","4870","10748323","12712747","1964424","2024-09"
"111110","호전실업","74488772080","8090","9207512","9749984","542472","2024-09"
"008770","호텔신라","1621843387700","43700","37113121","39248121","2135000","2024-09"
"060560","홈센타홀딩스","94570305960","745","126940008","127669525","729517","2024-09"
"064240","홈캐스트","93117618950","2710","34360745","35038012","677267","2024-09"
"039610","화성밸브","103167064000","9910","10410400","10410400","0","2024-09"
"378850","화승알앤에이","71310401430","3755","18990786","18993623","2837","2024-09"
"241590","화승엔터프라이즈","525309022920","8670","60589276","60589276","0","2024-09"
"006060","화승인더","202819796300","4100","49468243","55320000","5851757","2024-09"
"013520","화승코퍼레이션","83082207782","1871","44405242","50051252","5646010","2024-09"
"010690","화신","314473391050","9050","34748441","34920410","171969","2024-09"
"126640","화신정공","47395590320","1352","35055910","36373887","1317977","2024-09"
"133820","화인베스틸","26325504772","854","30826118","30826118","0","2024-09"
"127980","화인써키트","80154322180","6770","11839634","11840684","1050","2024-09"
"061250","화일약품","102563809152","1376","74537652","76877652","2340000","2024-09"
"010660","화천기계","59950000000","2725","22000000","22000000","0","2024-09"
"000850","화천기공","59400000000","27000","2200000","2200000","0","2024-09"
"016580","환인제약","201983336100","13230","15267070","18600070","3333000","2024-09"
"032560","황금에스티","90889983700","5350","16988782","17000000","11218","2024-09"
"004800","효성","831736619000","49750","16718324","16740407","22083","2024-09"
"094280","효성ITX","136765342350","12390","11038365","11558200","519835","2024-09"
"097870","효성오앤비","48760200000","6180","7890000","8490000","600000","2024-09"
"298040","효성중공업","3622267249000","389000","9311741","9324548","12807","2024-09"
"298020","효성티앤씨","1275286395000","295500","4315690","4327682","11992","2024-09"
"298000","효성화학","150234330000","39750","3779480","3791811","12331","2024-09"
"093370","후성","640313758920","5970","107255236","107255330","94","2024-09"
"081660","휠라홀딩스","2377899984900","39950","59521902","60095839","573937","2024-09"
"290270","휴네시온","33757065160","3640","9273919","9607672","333753","2024-09"
"005870","휴니드","107342018000","8200","13090490","14116015","1025525","2024-09"
"353190","휴럼","30399436948","772","39377509","39378420","911","2024-09"
"192410","휴림네트웍스","33844980400","2380","14220580","14235530","14950","2024-09"
"090710","휴림로봇","119767013944","1093","109576408","109623165","46757","2024-09"
"078590","휴림에이텍","29695514926","553","53698942","54210339","511397","2024-09"
"205470","휴마시스","172220144480","1522","113153840","129375009","16221169","2024-09"
"115160","휴맥스","73996361868","1716","43121423","43970124","848701","2024-09"
"028080","휴맥스홀딩스","33081715740","3030","10918058","12577506","1659448","2024-09"
"175140","휴먼테크놀로지","100691566560","4680","21515292","21515292","0","2024-09"
"200670","휴메딕스","324209212550","31450","10308719","11229930","921211","2024-09"
"079980","휴비스","83756764400","2545","32910320","34500000","1589680","2024-09"
"065510","휴비츠","97248381300","8940","10877895","12159371","1281476","2024-09"
"215090","휴센텍","149904424845","1505","99604269","99649272","45003","2024-09"
"005010","휴스틸","225314180750","4010","56188075","56188075","0","2024-09"
"263920","휴엠앤씨","49878901278","1017","49045134","49045134","0","2024-09"
"243070","휴온스","328337515600","27800","11810702","11979665","168963","2024-09"
"084110","휴온스글로벌","447052467750","36750","12164693","12621492","456799","2024-09"
"145020","휴젤","2947791496000","268000","10999222","12604033","1604811","2024-09"
"024060","흥구석유","256936236390","17670","14540817","15000000","459183","2024-09"
"010240","흥국","54744591720","4945","11070696","12322696","1252000","2024-09"
"189980","흥국에프엔비","70189550058","1814","38693247","40137827","1444580","2024-09"
"000540","흥국화재","214570434300","3340","64242645","64242645","0","2024-09"
"003280","흥아해운","467315117690","1945","240264842","240424899","160057","2024-09"
"037440","희림","56873462600","4505","12624520","13922475","1297955","2024-09"
"238490","힘스","48839736000","4400","11099940","11312236","212296","2024-09"