종목코드,종목명,자기주식 제외 시가총액(A*B),종가,자기주식 제외 발행주식수(B=C-D),총발행주식수(C),자기주식수(D),자기주식수 반영시점
"060310","3S","104978939310","2055","51084642","51084642","0","2024-09"
"095570","AJ네트웍스","216147571500","4830","44751050","45252759","501709","2024-09"
"006840","AK홀딩스","166590971150","12770","13045495","13247561","202066","2024-09"
"054620","APS","108653275120","5980","18169444","19894221","1724777","2024-09"
"265520","AP시스템","263903754380","17570","15020134","15281421","261287","2024-09"
"211270","AP위성","146316895080","10280","14233161","15082304","849143","2024-09"
"109960","AP헬스케어","64134270478","562","114117919","114153169","35250","2024-09"
"139050","BF랩스","24234697905","2805","8639821","8644551","4730","2024-09"
"027410","BGF","348858452070","3645","95708766","95716791","8025","2024-09"
"282330","BGF리테일","1933074178500","111900","17275015","17283906","8891","2024-09"
"126600","BGF에코머티리얼즈","217973184000","3520","61924200","62766899","842699","2024-09"
"138930","BNK금융지주","3107423145440","9760","318383519","320436727","2053208","2024-09"
"001460","BYC","205709156500","32950","6243070","6246150","3080","2024-09"
"013720","CBI","50053933752","1123","44571624","44628136","56512","2024-09"
"083790","CG인바이츠","173011909500","2250","76894182","76894182","0","2024-09"
"001040","CJ","2954783286000","109200","27058455","29176998","2118543","2024-09"
"079160","CJ CGV","927248016800","5600","165580003","165580003","0","2024-09"
"035760","CJ ENM","1279017492300","61700","20729619","21929154","1199535","2024-09"
"311690","CJ 바이오사이언스","109258898980","11990","9112502","9112502","0","2024-09"
"000120","CJ대한통운","1781100019700","89300","19945129","22812344","2867215","2024-09"
"011150","CJ씨푸드","112104011760","3120","35930773","35930773","0","2024-09"
"097950","CJ제일제당","4137171438500","281500","14696879","15054186","357307","2024-09"
"051500","CJ프레시웨이","221523794760","18660","11871586","11871586","0","2024-09"
"058820","CMG제약","313202010220","2255","138892244","138892244","0","2024-09"
"023460","CNH","9393155115","285","32958439","37200000","4241561","2024-09"
"056730","CNT85","55701358400","800","69626698","74111186","4484488","2024-09"
"000480","CR홀딩스","236812608480","5740","41256552","46890490","5633938","2024-09"
"065770","CS","20090519550","1035","19411130","19411130","0","2024-09"
"083660","CSA 코스믹","49822937454","841","59242494","61247181","2004687","2024-09"
"000590","CS홀딩스","72572615800","69700","1041214","1154482","113268","2024-09"
"012030","DB","299726906277","1569","191030533","201173933","10143400","2024-09"
"456440","DB금융스팩11호","12065050000","2270","5315000","5315000","0","2024-09"
"477760","DB금융스팩12호","12118000000","2075","5840000","5840000","0","2024-09"
"016610","DB금융투자","229312090070","5630","40730389","42446389","1716000","2024-09"
"005830","DB손해보험","6574759855500","109500","60043469","70800000","10756531","2024-09"
"000990","DB하이텍","1607527669350","38650","41591919","44398588","2806669","2024-09"
"139130","DGB금융지주","1362757294080","8190","166392832","169145833","2753001","2024-09"
"099520","DGI","58000622016","1284","45171824","45281824","110000","2024-09"
"060900","DGP","29672965900","1175","25253588","25258229","4641","2024-09"
"290120","DH오토리드","42433902430","2735","15515138","15515138","0","2024-09"
"025440","DH오토웨어","32628096380","212","153906115","153906120","5","2024-09"
"001530","DI동일","755461941000","39000","19370819","25215672","5844853","2024-09"
"000210","DL","881183606700","42100","20930727","20955884","25157","2024-09"
"375500","DL이앤씨","1196136104800","31100","38460968","38693623","232655","2024-09"
"068790","DMS","131293471680","5580","23529296","24573061","1043765","2024-09"
"007340","DN오토모티브","934827950700","18060","51762345","60564965","8802620","2024-09"
"004840","DRB동일","88749236220","4605","19272364","19930000","657636","2024-09"
"241520","DSC인베스트먼트","75047056000","2870","26148800","27496125","1347325","2024-09"
"155660","DSR","64000000000","4000","16000000","16000000","0","2024-09"
"069730","DSR제강","52488000000","3645","14400000","14400000","0","2024-09"
"017860","DS단석","407367578000","69500","5861404","5861404","0","2024-09"
"180400","DXVX","127476422640","2590","49218696","49219432","736","2024-09"
"017940","E1","427849574000","74000","5781751","6860000","1078249","2024-09"
"245620","EDGC","57441040175","415","138412145","138493951","81806","2024-09"
"037370","EG","61323550920","7110","8624972","8624972","0","2024-09"
"050120","ES큐브","24162969028","1804","13394107","13564086","169979","2024-09"
"383220","F&F","2325954169500","61500","37820393","38307075","486682","2024-09"
"007700","F&F홀딩스","529397050150","13550","39069893","39114367","44474","2024-09"
"214270","FSN","66827503140","2010","33247514","33250463","2949","2024-09"
"130500","GH신소재","46689555930","3210","14545033","14545052","19","2024-09"
"114090","GKL","680412370000","11000","61855670","61855670","0","2024-09"
"078930","GS","3869097366750","41650","92895495","92915378","19883","2024-09"
"083450","GST","287013892900","15430","18601030","18618260","17230","2024-09"
"006360","GS건설","1575537891200","18560","84888895","85581490","692595","2024-09"
"001250","GS글로벌","282546066850","3425","82495202","82533764","38562","2024-09"
"007070","GS리테일","2203234852800","21300","103438256","104717922","1279666","2024-09"
"297890","HB솔루션","303900497670","4155","73140914","73140914","0","2024-09"
"440290","HB인베스트먼트","52479171360","1936","27107010","27107010","0","2024-09"
"078150","HB테크놀러지","220359452640","2480","88854618","92715916","3861298","2024-09"
"012630","HDC","550340846000","11000","50030986","59741721","9710735","2024-09"
"039570","HDC랩스","186092259300","8100","22974353","25957601","2983248","2024-09"
"089470","HDC현대EP","104197849260","4020","25919863","31900000","5980137","2024-09"
"294870","HDC현대산업개발","1421350659500","22150","64169330","65907330","1738000","2024-09"
"009540","HD한국조선해양","13789352850000","195000","70714630","70773116","58486","2024-09"
"267250","HD현대","5731209673000","81100","70668430","78993085","8324655","2024-09"
"267270","HD현대건설기계","983761647300","55700","17661789","18305586","643797","2024-09"
"443060","HD현대마린솔루션","5422900000000","122000","44450000","44450000","0","2024-09"
"071970","HD현대마린엔진","719047120400","21200","33917317","33917339","22","2024-09"
"010620","HD현대미포","4215770298600","105700","39884298","39942149","57851","2024-09"
"322000","HD현대에너지솔루션","253120000000","22600","11200000","11200000","0","2024-09"
"042670","HD현대인프라코어","1479099125760","7680","192591032","192655867","64835","2024-09"
"267260","HD현대일렉트릭","11175734592000","310500","35992704","36047135","54431","2024-09"
"329180","HD현대중공업","17008929025600","191600","88773116","88773116","0","2024-09"
"097230","HJ중공업","208170850000","2500","83268340","83274281","5941","2024-09"
"195940","HK이노엔","1372583218950","48450","28329891","28329891","0","2024-09"
"014790","HL D&I","94078623485","2485","37858601","37858601","0","2024-09"
"028300","HLB","9121723755200","69700","130871216","131127236","256020","2024-09"
"003580","HLB글로벌","202992950025","4275","47483731","47489591","5860","2024-09"
"278650","HLB바이오스텝","191544812550","2275","84195522","86730589","2535067","2024-09"
"067630","HLB생명과학","1078159000590","9090","118609351","118679271","69920","2024-09"
"024850","HLB이노베이션","332494144380","3645","91219244","91226268","7024","2024-09"
"047920","HLB제약","666197702350","20950","31799413","31799994","581","2024-09"
"115450","HLB테라퓨틱스","659173085620","8260","79803037","80139933","336896","2024-09"
"046210","HLB파나진","129873487135","3065","42373079","42373079","0","2024-09"
"204320","HL만도","1699847744000","36200","46957120","46957120","0","2024-09"
"060980","HL홀딩스","338140227600","35600","9498321","10169410","671089","2024-09"
"011200","HMM","12868498541280","17180","749039496","749039496","0","2024-09"
"403870","HPSP","2442507008500","30500","80082197","82934144","2851947","2024-09"
"036640","HRS","83904266250","5250","15981765","16354800","373035","2024-09"
"035000","HS애드","104053074480","6420","16207644","16567409","359765","2024-09"
"002460","HS화성","85277208290","9010","9464729","10150000","685271","2024-09"
"487570","HS효성","149360948100","40300","3706227","3725927","19700","2024-09"
"298050","HS효성첨단소재","1170621764000","262000","4468022","4479948","11926","2024-09"
"439730","IBKS제20호스팩","9460450000","2195","4310000","4310000","0","2024-09"
"442770","IBKS제21호스팩","9135700000","2170","4210000","4210000","0","2024-09"
"448760","IBKS제22호스팩","9657400000","2180","4430000","4430000","0","2024-09"
"467930","IBKS제23호스팩","9157950000","2165","4230000","4230000","0","2024-09"
"469480","IBKS제24호스팩","9242550000","2185","4230000","4230000","0","2024-09"
"003560","IHQ","61224765840","10760","5690034","5772083","82049","2024-09"
"095340","ISC","1199201651200","58600","20464192","21197058","732866","2024-09"
"175330","JB금융지주","3261949151580","17010","191766558","195083198","3316640","2024-09"
"234080","JW생명과학","173117313720","11180","15484554","15834554","350000","2024-09"
"067290","JW신약","85315465719","1683","50692493","50841502","149009","2024-09"
"001060","JW중외제약","673522586700","29300","22987119","23285930","298811","2024-09"
"096760","JW홀딩스","221978384320","3080","72070904","73924942","1854038","2024-09"
"035900","JYP Ent.","1663279561800","50200","33133059","35532492","2399433","2024-09"
"318000","KBG","50021325750","5750","8699361","8740223","40862","2024-09"
"024840","KBI메탈","102249767735","2935","34838081","34909199","71118","2024-09"
"105560","KB금융","35609161136000","94400","377215690","393528423","16312733","2024-09"
"024120","KB오토시스","42895000000","3730","11500000","11500000","0","2024-09"
"455250","KB제25호스팩","11365200000","2640","4305000","4305000","0","2024-09"
"458320","KB제26호스팩","12221100000","2220","5505000","5505000","0","2024-09"
"464680","KB제27호스팩","25732570000","1994","12905000","12905000","0","2024-09"
"476470","KB제28호스팩","11588025000","2105","5505000","5505000","0","2024-09"
"478390","KB제29호스팩","12751000000","2050","6220000","6220000","0","2024-09"
"486630","KB제30호스팩","10699650000","2015","5310000","5310000","0","2024-09"
"002380","KCC","2037105367000","277000","7354171","8886471","1532300","2024-09"
"021320","KCC건설","84967557360","4260","19945436","21400000","1454564","2024-09"
"344820","KCC글라스","632950320100","39700","15943333","15970512","27179","2024-09"
"036670","KCI","83929560000","7800","10760200","11270000","509800","2024-09"
"009070","KCTC","138314093750","4625","29905750","30000000","94250","2024-09"
"009440","KC그린홀딩스","18584983200","840","22124980","22434980","310000","2024-09"
"119650","KC코트렐","29024876708","452","64214329","64214329","0","2024-09"
"044180","KD","12527548579","469","26711191","26717799","6608","2024-09"
"092220","KEC","180285300618","898","200763141","200763141","0","2024-09"
"046440","KG모빌리언스","165664993230","4465","37103022","38825568","1722546","2024-09"
"003620","KG모빌리티","1005589780480","5120","196404254","196404254","0","2024-09"
"016380","KG스틸","664818923340","6670","99673002","100008897","335895","2024-09"
"151860","KG에코솔루션","227427199960","5420","41960738","49603002","7642264","2024-09"
"035600","KG이니시스","249947602320","9390","26618488","27904434","1285946","2024-09"
"001390","KG케미칼","281407754400","4110","68469040","68469040","0","2024-09"
"226360","KH 건설","60474013950","2555","23668890","23756732","87842","2024-09"
"111870","KH 미래물산","43747975260","8910","4909986","4930249","20263","2024-09"
"033180","KH 필룩스","125157155370","6630","18877399","18903579","26180","2024-09"
"060720","KH바텍","198336978000","9000","22037442","23677442","1640000","2024-09"
"015590","KIB플러그에너지","91000911744","384","236981541","236981544","3","2024-09"
"001940","KISCO홀딩스","239959702000","19000","12629458","16176380","3546922","2024-09"
"058400","KNN","101706024960","768","132429720","132429720","0","2024-09"
"025000","KPX케미칼","228250608000","48000","4755221","4840000","84779","2024-09"
"092230","KPX홀딩스","219754583100","55900","3931209","4224646","293437","2024-09"
"000040","KR모터스","32645844180","543","60121260","60132868","11608","2024-09"
"044450","KSS해운","209067881500","9260","22577525","23085880","508355","2024-09"
"101000","KS인더스트리","66141144800","2195","30132640","30149619","16979","2024-09"
"030200","KT","10545925747500","42900","245825775","252021685","6195910","2024-09"
"033780","KT&G","11717673392400","106800","109716043","130322497","20606454","2024-09"
"058850","KTcs","112298637840","2960","37938729","42685000","4746271","2024-09"
"058860","KTis","82673411400","2700","30619782","34802000","4182218","2024-09"
"122450","KX","149467845600","3600","41518846","45335964","3817118","2024-09"
"052900","KX하이텍","54290375280","999","54344720","55107517","762797","2024-09"
"376190","LB루셈","112545000000","4575","24600000","24600000","0","2024-09"
"061970","LB세미콘","169884216960","3880","43784592","43784592","0","2024-09"
"309960","LB인베스트먼트","91981772000","4000","22995443","23217239","221796","2024-09"
"093050","LF","423299001840","15290","27684696","29240000","1555304","2024-09"
"003550","LG","11702261109600","77400","151192004","157300993","6108989","2024-09"
"034220","LG디스플레이","5285000000000","10570","500000000","500000000","0","2024-09"
"051900","LG생활건강","5116264965000","349000","14659785","15618197","958412","2024-09"
"373220","LG에너지솔루션","90909000000000","388500","234000000","234000000","0","2024-09"
"032640","LG유플러스","4263897251840","9920","429828352","436611361","6783009","2024-09"
"011070","LG이노텍","4583815005900","193700","23664507","23667107","2600","2024-09"
"066570","LG전자","15848675277400","97300","162884638","163647814","763176","2024-09"
"037560","LG헬로비전","204459723600","2640","77446865","77446865","0","2024-09"
"051910","LG화학","23189584675500","328500","70592343","70592343","0","2024-09"
"079550","LIG넥스원","5513973080000","253000","21794360","22000000","205640","2024-09"
"225190","LK삼양","129154779800","2545","50748440","50748440","0","2024-09"
"006260","LS","3254357022000","119000","27347538","32200000","4852462","2024-09"
"010120","LS ELECTRIC","4471980936800","150800","29655046","30000000","344954","2024-09"
"000680","LS네트웍스","261626006480","3320","78803014","78803016","2","2024-09"
"060370","LS마린솔루션","451728558060","16510","27360906","28706781","1345875","2024-09"
"417200","LS머트리얼즈","1100032235340","16260","67652659","67652659","0","2024-09"
"229640","LS에코에너지","847655749200","27950","30327576","30624879","297303","2024-09"
"078020","LS증권","221785044800","4400","50405692","55481190","5075498","2024-09"
"108320","LX세미콘","1040915200000","64000","16264300","16264300","0","2024-09"
"001120","LX인터내셔널","1079037060000","30000","35967902","38760000","2792098","2024-09"
"108670","LX하우시스","375891390000","42000","8949795","8967670","17875","2024-09"
"383800","LX홀딩스","543555043770","7130","76234929","76280690","45761","2024-09"
"476080","M83","110235600000","14160","7785000","7785000","0","2024-09"
"086960","MDS테크","98948026008","1066","92821788","92821788","0","2024-09"
"023150","MH에탄올","38232857640","5960","6414909","7378526","963617","2024-09"
"038340","MIT","39924432729","1233","32379913","32424892","44979","2024-09"
"035420","NAVER","26740106099200","176800","151244944","160784508","9539564","2024-09"
"160550","NEW","66974654400","2400","27906106","27906106","0","2024-09"
"053290","NE능률","58916284455","3565","16526307","16526307","0","2024-09"
"181710","NHN","524059017600","15920","32918280","33766123","847843","2024-09"
"060250","NHN KCP","276850829720","7160","38666317","40160611","1494294","2024-09"
"104200","NHN벅스","47795229090","3535","13520574","14827550","1306976","2024-09"
"005940","NH투자증권","4529567584080","13860","326808628","327492299","683671","2024-09"
"034310","NICE","396452641310","11330","34991407","37503477","2512070","2024-09"
"030190","NICE평가정보","650363363400","11100","58591294","60107670","1516376","2024-09"
"008260","NI스틸","114114466830","3990","28600117","28600117","0","2024-09"
"004250","NPC","177674592600","5240","33907365","36720000","2812635","2024-09"
"222160","NPX","79551289560","8040","9894439","9894439","0","2024-09"
"456040","OCI","698294610000","78000","8952495","8952495","0","2024-09"
"010060","OCI홀딩스","1260194298000","66000","19093853","19563983","470130","2024-09"
"178920","PI첨단소재","590263072200","20100","29366322","29366322","0","2024-09"
"024940","PN풍년","53008555200","5640","9398680","10000000","601320","2024-09"
"005490","POSCO홀딩스","26089168755000","345000","75620779","82624377","7003598","2024-09"
"218410","RFHIC","296373231360","11520","25726843","26484442","757599","2024-09"
"327260","RF머트리얼즈","52417027230","6330","8280731","8433231","152500","2024-09"
"091340","S&K폴리텍","26880300330","2510","10709283","11703721","994438","2024-09"
"010950","S-Oil","6619868169600","58800","112582792","112582792","0","2024-09"
"419530","SAMG엔터","109870360500","13830","7944350","8590930","646580","2024-09"
"019550","SBI인베스트먼트","115055675742","714","161142403","162066575","924172","2024-09"
"034120","SBS","288242042760","15540","18548394","18551238","2844","2024-09"
"036120","SCI평가정보","81168134985","2385","34032761","35500000","1467239","2024-09"
"246960","SCL사이언스","64239596820","8820","7283401","7283401","0","2024-09"
"099220","SDN","68581512726","1266","54171811","56171811","2000000","2024-09"
"036540","SFA반도체","577156796480","3520","163964999","164460303","495304","2024-09"
"255220","SG","238937166160","2870","83253368","93851574","10598206","2024-09"
"040610","SG&G","52677640246","1561","33746086","34087196","341110","2024-09"
"049470","SGA","19885381100","340","58486415","58862249","375834","2024-09"
"184230","SGA솔루션즈","31055905986","498","62361257","62599161","237904","2024-09"
"016250","SGC E&C","51109555600","15800","3234782","3243585","8803","2024-09"
"005090","SGC에너지","423572914800","29400","14407242","14409333","2091","2024-09"
"001380","SG글로벌","132419401135","2945","44964143","44964143","0","2024-09"
"004060","SG세계물산","68180591948","343","198777236","202424960","3647724","2024-09"
"001770","SHD","21296811340","17530","1214878","1214878","0","2024-09"
"002360","SH에너지화학","55752886272","512","108892356","111133730","2241374","2024-09"
"009160","SIMPAC","222505015600","4100","54269516","65429516","11160000","2024-09"
"033530","SJG세종","126740020815","4685","27052299","27820961","768662","2024-09"
"123700","SJM","52510481770","3365","15604898","15604898","0","2024-09"
"025530","SJM홀딩스","48448367825","3575","13551991","14934008","1382017","2024-09"
"034730","SK","8074463686900","148100","54520349","72502703","17982354","2024-09"
"011790","SKC","4970413234000","145900","34067260","37868298","3801038","2024-09"
"018670","SK가스","1535630370600","171100","8975046","9230244","255198","2024-09"
"001740","SK네트웍스","1000671524400","5160","193928590","221277902","27349312","2024-09"
"006120","SK디스커버리","586191665800","33100","17709718","18785855","1076137","2024-09"
"210980","SK디앤디","155732981670","8370","18606091","18617382","11291","2024-09"
"302440","SK바이오사이언스","4386864525000","57100","76827750","76827750","0","2024-09"
"326030","SK바이오팜","9648192400000","123200","78313250","78313250","0","2024-09"
"402340","SK스퀘어","11786295445600","88400","133329134","134749960","1420826","2024-09"
"361610","SK아이이테크놀로지","2359829414000","33100","71293940","71297592","3652","2024-09"
"100090","SK오션플랜트","845312711040","14280","59195568","59195568","0","2024-09"
"096770","SK이노베이션","10674094067400","112100","95219394","95735590","516196","2024-09"
"475150","SK이터닉스","538705152000","16000","33669072","33691895","22823","2024-09"
"001510","SK증권","207780913906","502","413906203","472590171","58683968","2024-09"
"285130","SK케미칼","880091518600","51100","17222926","17253783","30857","2024-09"
"017670","SK텔레콤","11964212420400","56200","212886342","214790053","1903711","2024-09"
"000660","SK하이닉스","129056954316300","187300","689038731","728002365","38963634","2024-09"
"048550","SM C&C","161907002649","1687","95973327","96714620","741293","2024-09"
"063440","SM Life Design","62921853518","1367","46029154","46029154","0","2024-09"
"003570","SNT다이내믹스","593437051500","26500","22393851","33252697","10858846","2024-09"
"064960","SNT모티브","539327607800","45050","11971756","14623136","2651380","2024-09"
"100840","SNT에너지","260451403440","13180","19761108","20680783","919675","2024-09"
"036530","SNT홀딩스","332572226000","23000","14459662","16303886","1844224","2024-09"
"067160","SOOP","965466216000","90600","10656360","11494767","838407","2024-09"
"005610","SPC삼립","409313761500","50500","8105223","8629009","523786","2024-09"
"011810","STX","156759053000","5060","30980050","31017927","37877","2024-09"
"465770","STX그린로지스","74017952400","10360","7144590","7171032","26442","2024-09"
"077970","STX엔진","484141727350","21050","22999607","23008904","9297","2024-09"
"002820","SUN&L","38481620760","3190","12063204","12607989","544785","2024-09"
"289080","SV인베스트먼트","87623164000","1646","53234000","53234000","0","2024-09"
"084870","TBH글로벌","29199546600","1400","20856819","20856819","0","2024-09"
"002710","TCC스틸","1082625686100","41300","26213697","26213697","0","2024-09"
"089230","THE E&M","30120829857","1377","21874241","21882953","8712","2024-09"
"032540","TJ미디어","73001631160","5240","13931609","13931609","0","2024-09"
"022220","TKG애강","52364319369","1011","51794579","51794579","0","2024-09"
"069260","TKG휴켐스","766650122460","19980","38370877","40878588","2507711","2024-09"
"007980","TP","66121212726","1359","48654314","51175130","2520816","2024-09"
"048770","TPC","42070615880","2680","15697991","15697991","0","2024-09"
"246690","TS인베스트먼트","42020209600","1030","40796320","41477862","681542","2024-09"
"317240","TS트릴리온","29786621715","279","106762085","107240922","478837","2024-09"
"002900","TYM","132858839065","3095","42926927","45050956","2124029","2024-09"
"024070","WISCOM","31649094470","2065","15326438","15326438","0","2024-09"
"057030","YBM넷","58182727465","3595","16184347","16312697","128350","2024-09"
"037270","YG PLUS","169990818800","2680","63429410","63429410","0","2024-09"
"040300","YTN","134820000000","3210","42000000","42000000","0","2024-09"
"051390","YW","30076439700","3725","8074212","11355368","3281156","2024-09"
"052220","iMBC","58075000000","2525","23000000","23000000","0","2024-09"
"079940","가비아","178239242500","13750","12962854","13535684","572830","2024-09"
"078890","가온그룹","58728583860","3655","16068012","17410157","1342145","2024-09"
"000500","가온전선","283007325600","39700","7128648","7357946","229298","2024-09"
"399720","가온칩스","449767728000","39150","11488320","11488320","0","2024-09"
"036620","감성코퍼레이션","333487478100","3675","90744892","90744892","0","2024-09"
"000860","강남제비스코","168025000000","25850","6500000","6500000","0","2024-09"
"198440","강동씨앤엘","96462187040","1585","60859424","60931896","72472","2024-09"
"217730","강스템바이오텍","112668839490","2010","56054149","56054149","0","2024-09"
"035250","강원랜드","3416152116300","16850","202738998","213940500","11201502","2024-09"
"114190","강원에너지","318701063600","12200","26123038","26123038","0","2024-09"
"094480","갤럭시아머니트리","343261082500","8750","39229838","39229838","0","2024-09"
"011420","갤럭시아에스엠","70802585080","2570","27549644","27549644","0","2024-09"
"039240","경남스틸","74598605060","2765","26979604","26979604","0","2024-09"
"053950","경남제약","25520263455","717","35593115","35593402","287","2024-09"
"002100","경농","164176133500","9190","17864650","19522575","1657925","2024-09"
"009450","경동나비엔","1281975068400","88700","14452932","14568592","115660","2024-09"
"267290","경동도시가스","111093453220","18860","5890427","5895406","4979","2024-09"
"012320","경동인베스트","171593702400","78700","2180352","2365023","184671","2024-09"
"011040","경동제약","175660340400","6520","26941770","30768766","3826996","2024-09"
"000050","경방","144010260600","5780","24915270","27415270","2500000","2024-09"
"214390","경보제약","177867038400","7440","23906860","23906860","0","2024-09"
"012610","경인양행","125752159680","3040","41365842","41616365","250523","2024-09"
"009140","경인전자","26702008500","20500","1302537","1570797","268260","2024-09"
"024910","경창산업","85223392600","2395","35583880","35819005","235125","2024-09"
"013580","계룡건설","121971864690","13770","8857797","8930907","73110","2024-09"
"012200","계양전기","42098872392","1548","27195654","27222829","27175","2024-09"
"002140","고려산업","78948544000","3200","24671420","24939425","268005","2024-09"
"049720","고려신용정보","138977647680","9980","13925616","14300000","374384","2024-09"
"010130","고려아연","16935984296000","824000","20553379","20703283","149904","2024-09"
"002240","고려제강","493512269250","19750","24987963","25000000","12037","2024-09"
"014570","고려제약","55673763240","5160","10789489","11000000","210511","2024-09"
"348150","고바이오랩","150922291500","7790","19373850","19373850","0","2024-09"
"098460","고영","638194699600","9700","65793268","68654755","2861487","2024-09"
"035290","골드앤에스","23313798720","489","47676480","47676480","0","2024-09"
"215000","골프존","397537620000","66200","6005100","6275415","270315","2024-09"
"121440","골프존뉴딘홀딩스","163149850710","4005","40736542","42836818","2100276","2024-09"
"366030","공구우먼","104207710000","4600","22653850","22653850","0","2024-09"
"009290","광동제약","234070774080","5840","40080612","52420851","12340239","2024-09"
"014200","광림","91136252176","1006","90592696","90706696","114000","2024-09"
"017040","광명전기","67953380320","1568","43337615","43337615","0","2024-09"
"029480","광무","218236068940","3970","54971302","55009083","37781","2024-09"
"017900","광전자","91611684897","1819","50363763","57943763","7580000","2024-09"
"037710","광주신세계","225382932600","29550","7627172","7957190","330018","2024-09"
"026910","광진실업","13899728850","2170","6405405","6405405","0","2024-09"
"421800","교보12호스팩","14112800000","2360","5980000","5980000","0","2024-06"
"440790","교보13호스팩","8849250000","2185","4050000","4050000","0","2024-09"
"456490","교보14호스팩","9135000000","2175","4200000","4200000","0","2024-09"
"465320","교보15호스팩","8267700000","2170","3810000","3810000","0","2024-09"
"482520","교보16호스팩","12505000000","2050","6100000","6100000","0","2024-09"
"030610","교보증권","641097981840","5680","112869363","113962961","1093598","2024-09"
"339770","교촌에프앤비","222844256800","8920","24982540","24982540","0","2024-09"
"053270","구영테크","62470260320","2395","26083616","27410405","1326789","2024-09"
"007690","국도화학","278573835600","33400","8340534","9010616","670082","2024-09"
"005320","국동","32908871898","497","66215034","67327897","1112863","2024-09"
"001140","국보","33448047050","2110","15852155","15856388","4233","2024-09"
"066620","국보디자인","109652666760","16590","6609564","7500000","890436","2024-09"
"043650","국순당","75554236800","4800","15740466","17858304","2117838","2024-09"
"006050","국영지앤엠","61621551774","1818","33895243","34895243","1000000","2024-09"
"060480","국일신동","21825120000","1968","11090000","11090000","0","2024-09"
"078130","국일제지","901924696800","800","1127405871","1127405871","0","2024-09"
"307750","국전약품","217867034880","4440","49069152","49069269","117","2024-09"
"002720","국제약품","116066261400","5700","20362502","21159832","797330","2024-09"
"035080","그래디언트","151722578340","11090","13681026","14527584","846558","2024-09"
"453450","그리드위즈","166400612500","20950","7942750","7942750","0","2024-09"
"204020","그리티","55259773320","2760","20021657","20147430","125773","2024-09"
"402490","그린리소스","145976571040","17660","8265944","8265944","0","2024-09"
"114450","그린생명과학","40560873750","2125","19087470","20000000","912530","2024-09"
"083420","그린케미칼","140424470480","6020","23326324","24000000","673676","2024-09"
"186230","그린플러스","101387374720","9440","10740188","10820188","80000","2024-09"
"014530","극동유화","127270407600","3780","33669420","34869420","1200000","2024-09"
"204620","글로벌텍스프리","232238151400","3800","61115303","61116035","732","2024-09"
"019660","글로본","19795934474","569","34790746","34790746","0","2024-09"
"014280","금강공업","113669054910","4230","26872117","29329357","2457240","2024-09"
"053260","금강철강","76781505360","4830","15896792","18720000","2823208","2024-09"
"008870","금비","45999700000","56200","818500","1000000","181500","2024-09"
"001570","금양","2881789197250","49750","57925411","58050037","124626","2024-09"
"282720","금양그린파워","125857767000","10430","12066900","12119500","52600","2024-09"
"002990","금호건설","109839813840","3060","35895364","36953595","1058231","2024-09"
"011780","금호석유","3186952516400","138800","22960753","27334587","4373834","2024-09"
"214330","금호에이치티","127749483741","627","203747183","213914131","10166948","2024-09"
"001210","금호전기","37618742511","903","41659737","42525621","865884","2024-09"
"073240","금호타이어","1203620602530","4190","287260287","287260287","0","2024-09"
"036190","금화피에스시","163295093500","27650","5905790","6000000","94210","2024-09"
"049080","기가레인","59161358606","697","84879998","84883347","3349","2024-09"
"420770","기가비스","503861380500","39750","12675758","12675758","0","2024-09"
"035460","기산텔레콤","26618222840","1826","14577340","14577340","0","2024-09"
"092440","기신정기","74460000000","2550","29200000","29200000","0","2024-09"
"000270","기아","37263532179900","95100","391835249","399858417","8023168","2024-09"
"024110","기업은행","11562675071500","14500","797425867","797425869","2","2024-09"
"013700","까뮤이앤씨","79767358050","1335","59750830","59750830","0","2024-09"
"308100","까스텔바작","21542542420","3340","6449863","6624733","174870","2024-09"
"004540","깨끗한나라","79319596110","2130","37239247","37240693","1446","2024-09"
"407400","꿈비","73008728750","6190","11794625","12259474","464849","2024-09"
"187790","나노","31435070025","1025","30668361","30840830","172469","2024-09"
"286750","나노브릭","43974057250","2125","20693674","20694559","885","2024-09"
"121600","나노신소재","1013399248400","84700","11964572","12196078","231506","2024-09"
"247660","나노씨엠에스","36091656900","8450","4271202","4343920","72718","2024-09"
"039860","나노엔텍","140160507930","4365","32110082","32110082","0","2024-09"
"091970","나노캠텍","24972505751","691","36139661","37417493","1277832","2024-09"
"417010","나노팀","212825499120","10790","19724328","19724328","0","2024-09"
"405920","나라셀라","48237684840","3880","12432393","12878076","445683","2024-09"
"051490","나라엠앤디","65904701450","4990","13207355","14200000","992645","2024-09"
"137080","나래나노텍","39537433650","3575","11059422","11059422","0","2024-09"
"190510","나무가","196777578600","12450","15805428","16264384","458956","2024-09"
"242040","나무기술","50534089700","1525","33137108","34606264","1469156","2024-09"
"089600","나스미디어","182707691040","16160","11306169","11568163","261994","2024-09"
"293580","나우IB","88951423050","939","94729950","94929950","200000","2024-09"
"138610","나이벡","228478470600","22200","10291823","10291823","0","2024-09"
"130580","나이스디앤비","78386000000","5090","15400000","15400000","0","2024-09"
"036800","나이스정보통신","165507826500","18870","8770950","10000000","1229050","2024-09"
"267320","나인테크","101561300100","2340","43402265","43664104","261839","2024-09"
"001260","남광토건","61594686780","6270","9823714","9832572","8858","2024-09"
"008350","남선알미늄","176838353300","1370","129079090","129079090","0","2024-09"
"004270","남성","45417606150","1450","31322487","36212160","4889673","2024-09"
"003920","남양유업","378499392000","576000","657117","679731","22614","2024-09"
"025860","남해화학","313104978350","6530","47948695","49678843","1730148","2024-09"
"111710","남화산업","100366500000","4875","20588000","20588000","0","2024-09"
"091590","남화토건","47312200000","4030","11740000","11740000","0","2024-09"
"168330","내츄럴엔도텍","51843425922","1642","31573341","31754900","181559","2024-09"
"094860","네오리진","30429537302","1423","21384074","21399569","15495","2024-09"
"253590","네오셈","446240151000","10500","42499062","43869164","1370102","2024-09"
"212560","네오오토","68981119320","8760","7874557","7874963","406","2024-09"
"095660","네오위즈","401166410450","20150","19909003","22033719","2124716","2024-09"
"042420","네오위즈홀딩스","125033248470","19230","6501989","8856866","2354877","2024-09"
"311390","네오크레마","75469924530","6930","10890321","10979147","88826","2024-09"
"085910","네오티스","47689981810","3565","13377274","13934818","557544","2024-09"
"092730","네오팜","197079825600","25200","7820628","8207361","386733","2024-09"
"290660","네오펙트","38632763421","917","42129513","42129513","0","2024-09"
"306620","네온테크","85452927120","2090","40886568","42608149","1721581","2024-09"
"153460","네이블","40334716800","6300","6402336","6530014","127678","2024-09"
"007390","네이처셀","592729406760","9210","64357156","64357156","0","2024-09"
"033640","네패스","175321437060","7710","22739486","23059202","319716","2024-09"
"330860","네패스아크","158027063650","12970","12184045","12184045","0","2024-09"
"005720","넥센","226000636650","4665","48446010","53543977","5097967","2024-09"
"002350","넥센타이어","676990519040","7040","96163426","97667877","1504451","2024-09"
"089140","넥스턴바이오","54745674265","4855","11276143","11282627","6484","2024-09"
"389650","넥스트바이오메디컬","312714977300","39050","8008066","8008066","0","2024-09"
"137940","넥스트아이","33993431208","444","76561782","78320992","1759210","2024-09"
"396270","넥스트칩","204043243200","11280","18088940","18088940","0","2024-09"
"348210","넥스틴","652241100600","63100","10336626","10437250","100624","2024-09"
"092790","넥스틸","207755980000","7990","26002000","26002000","0","2024-09"
"225570","넥슨게임즈","916679596110","14330","63969267","65860174","1890907","2024-09"
"217270","넵튠","238245102810","5310","44867251","46676150","1808899","2024-09"
"251270","넷마블","4588335976000","56000","81934571","85953502","4018931","2024-09"
"104620","노랑풍선","75804572910","4785","15842126","15842126","0","2024-09"
"090350","노루페인트","175400000000","8770","20000000","20000000","0","2024-09"
"000320","노루홀딩스","138664816290","13530","10248693","13291151","3042458","2024-09"
"194700","노바렉스","189590733360","10710","17702216","18754848","1052632","2024-09"
"285490","노바텍","119321494260","12020","9926913","10575831","648918","2024-09"
"145170","노브랜드","112446354240","13560","8292504","9079834","787330","2024-09"
"106520","노블엠앤비","15902299386","411","38691726","38695952","4226","2024-09"
"376930","노을","124881062800","3380","36947060","36947060","0","2024-09"
"006280","녹십자","1983610336400","173800","11413178","11686538","273360","2024-09"
"142280","녹십자엠에스","91169089200","4200","21706926","21741926","35000","2024-09"
"234690","녹십자웰빙","200520375800","11300","17745166","17752276","7110","2024-09"
"005250","녹십자홀딩스","740515451200","16480","44934190","47028210","2094020","2024-09"
"004370","농심","2151135756000","372000","5782623","6082642","300019","2024-09"
"072710","농심홀딩스","309340593000","66700","4637790","4637790","0","2024-09"
"054050","농우바이오","119748290670","7470","16030561","16030561","0","2024-09"
"069140","누리플랜","18397001973","1407","13075339","13102743","27404","2024-09"
"040160","누리플렉스","30165619950","2670","11297985","12055535","757550","2024-09"
"332290","누보","39947144674","1214","32905391","33384803","479412","2024-09"
"348340","뉴로메카","233136657000","22100","10549170","10549170","0","2024-09"
"060260","뉴보텍","15036835212","1127","13342356","13512009","169653","2024-09"
"123840","뉴온","64200562829","247","259921307","292370108","32448801","2024-09"
"012340","뉴인텍","27386133034","538","50903593","50907162","3569","2024-09"
"214870","뉴지랩파마","64715071880","6920","9351889","9359221","7332","2024-09"
"270870","뉴트리","78075263280","8680","8994846","9200224","205378","2024-09"
"144960","뉴파워프라즈마","198484665615","4905","40465783","43692624","3226841","2024-09"
"085670","뉴프렉스","144745681280","5920","24450284","24450761","477","2024-09"
"064260","다날","215741373850","3230","66792995","68949040","2156045","2024-09"
"340360","다보링크","112375469080","2590","43388212","43388212","0","2024-09"
"039560","다산네트웍스","134617772640","3480","38683268","39505981","822713","2024-09"
"154040","다산솔루에타","27050791658","1507","17950094","17950094","0","2024-09"
"058730","다스코","61270778800","3370","18181240","18796941","615701","2024-09"
"030210","다올투자증권","175053937005","2955","59239911","60911106","1671195","2024-09"
"023590","다우기술","786639977270","18230","43150849","44866617","1715768","2024-09"
"032190","다우데이타","426279000000","11130","38300000","38300000","0","2024-09"
"323350","다원넥스뷰","50560322400","6660","7591640","7596111","4471","2024-09"
"068240","다원시스","396899744800","10400","38163437","38163437","0","2024-09"
"145210","다이나믹디자인","48385663200","2800","17280594","17301093","20499","2024-09"
"019680","대교","145884363870","2165","67383078","84702850","17319772","2024-09"
"006370","대구백화점","62661730830","7530","8321611","10821611","2500000","2024-09"
"008060","대덕","209441127000","6180","33890150","33890150","0","2024-09"
"353200","대덕전자","845029417500","17100","49416925","49416925","0","2024-09"
"000490","대동","198448344540","8420","23568687","25640788","2072101","2024-09"
"020400","대동금속","20442554060","6410","3189166","3189166","0","2024-09"
"008830","대동기어","65608896000","7300","8987520","8987520","0","2024-09"
"048470","대동스틸","34703442630","3690","9404727","10000000","595273","2024-09"
"008110","대동전자","105136322880","15040","6990447","10490447","3500000","2024-09"
"004780","대륙제관","65680211870","4130","15903199","15903199","0","2024-09"
"005750","대림B&Co","58602923600","3515","16672240","16672240","0","2024-09"
"017650","대림제지","58345000000","7000","8335000","9000000","665000","2024-09"
"006570","대림통상","38640370680","2565","15064472","15225000","160528","2024-09"
"007720","대명소노시즌","100901250450","1001","100800450","100800450","0","2024-09"
"389260","대명에너지","223355000000","13100","17050000","17050000","0","2024-09"
"317850","대모","83660421000","10050","8324420","8324420","0","2024-09"
"290670","대보마그네틱","127015024000","17000","7471472","7857660","386188","2024-09"
"078140","대봉엘에스","215678929300","19700","10948169","11086579","138410","2024-09"
"065150","대산F&B","18113400725","145","124920005","125282405","362400","2024-09"
"001680","대상","687416816000","19840","34648025","34648025","0","2024-09"
"084690","대상홀딩스","304909569960","8420","36212538","36212538","0","2024-09"
"036480","대성미생물","39216000000","10320","3800000","3800000","0","2024-09"
"128820","대성산업","130362936720","3480","37460614","45235478","7774864","2024-09"
"117580","대성에너지","250189823200","9200","27194546","27500000","305454","2024-09"
"027830","대성창투","79974000000","1481","54000000","54000000","0","2024-09"
"104040","대성파인텍","45613018781","979","46591439","47224987","633548","2024-09"
"129920","대성하이텍","56780319420","4140","13715053","13715053","0","2024-09"
"016710","대성홀딩스","126936797460","7890","16088314","16089459","1145","2024-09"
"438220","대신밸런스제13호스팩","13959000000","2475","5640000","5640000","0","2024-09"
"442310","대신밸런스제14호스팩","15265250000","2275","6710000","6710000","0","2024-09"
"457390","대신밸런스제15호스팩","16778475000","2385","7035000","7035000","0","2024-09"
"457630","대신밸런스제16호스팩","15679950000","2145","7310000","7310000","0","2024-09"
"471050","대신밸런스제17호스팩","12877500000","2125","6060000","6060000","0","2024-09"
"478780","대신밸런스제18호스팩","16294600000","2060","7910000","7910000","0","2024-09"
"020180","대신정보통신","34662881330","902","38428915","38428915","0","2024-09"
"003540","대신증권","633578426960","16880","37534267","50773400","13239133","2024-09"
"045390","대아티아이","177592910040","2520","70473377","70473377","0","2024-09"
"009190","대양금속","72978221529","1723","42355323","42359986","4663","2024-09"
"108380","대양전기공업","110739669760","11980","9243712","9567333","323621","2024-09"
"014160","대영포장","100593602208","1056","95259093","108394549","13135456","2024-09"
"047040","대우건설","1553148021600","3780","410885720","415622638","4736918","2024-09"
"009320","대우부품","62709307440","1272","49299770","49299770","0","2024-09"
"003090","대웅","1085648350500","26550","40890710","58141980","17251270","2024-09"
"069620","대웅제약","1827195676000","158800","11506270","11586575","80305","2024-09"
"007680","대원","56945817390","4235","13446474","13446474","0","2024-09"
"000430","대원강업","241490000000","3895","62000000","62000000","0","2024-09"
"048910","대원미디어","99696415500","8250","12084414","12578946","494532","2024-09"
"005710","대원산업","117019584000","5840","20037600","20037600","0","2024-09"
"006340","대원전선","219688982750","2930","74979175","74979175","0","2024-09"
"003220","대원제약","330717963770","15430","21433439","22427583","994144","2024-09"
"024890","대원화성","47403405496","1163","40759592","41249152","489560","2024-09"
"290380","대유","56838037000","2300","24712190","24713612","1422","2024-09"
"002880","대유에이텍","48975295296","1048","46732152","46744020","11868","2024-09"
"000300","대유플러스","30475633069","241","126454909","126454909","0","2024-09"
"120240","대정화금","101141993100","14100","7173191","7190391","17200","2024-09"
"003310","대주산업","49903213500","1410","35392350","35392350","0","2024-09"
"078600","대주전자재료","1503451848000","100400","14974620","15480593","505973","2024-09"
"012800","대창","97079200272","1272","76320126","91140499","14820373","2024-09"
"015230","대창단조","128086815200","5080","25213940","28572230","3358290","2024-09"
"096350","대창솔루션","57455055719","361","159155279","163761009","4605730","2024-09"
"140520","대창스틸","47598170180","2255","21107836","21109243","1407","2024-09"
"131220","대한과학","36814841180","4940","7452397","7454490","2093","2024-09"
"010170","대한광통신","75703344656","1016","74511166","74511166","0","2024-09"
"054670","대한뉴팜","114387605350","8150","14035289","14354920","319631","2024-09"
"001070","대한방직","21384904800","5920","3612315","5300000","1687685","2024-09"
"023910","대한약품","150822000000","25650","5880000","6000000","120000","2024-09"
"006650","대한유화","627491760000","101600","6176100","6500000","323900","2024-09"
"001440","대한전선","2316390962180","12470","185757094","186447300","690206","2024-09"
"084010","대한제강","239889058750","13750","17446477","23414397","5967920","2024-09"
"001790","대한제당","262311118700","2965","88469180","89696580","1227400","2024-09"
"001130","대한제분","222924193500","135500","1645197","1690000","44803","2024-09"
"003490","대한항공","8524307190950","23150","368220613","368220661","48","2024-09"
"005880","대한해운","581222154660","1821","319177460","319177460","0","2024-09"
"003830","대한화섬","135601070000","121000","1120670","1328000","207330","2024-09"
"016090","대현","92992851000","2100","44282310","44282310","0","2024-09"
"069460","대호에이엘","71656814520","1062","67473460","67544896","71436","2024-09"
"021040","대호특수강","29673096120","1620","18316726","21704774","3388048","2024-09"
"067080","대화제약","350333000000","20000","17516650","18616650","1100000","2024-09"
"298540","더네이쳐홀딩스","147348174830","10090","14603387","14765856","162469","2024-09"
"032860","더라미","146652924600","3640","40289265","40395863","106598","2024-09"
"192080","더블유게임즈","1021016185500","51500","19825557","21495906","1670349","2024-09"
"393890","더블유씨피","574188666720","17040","33696518","33696518","0","2024-09"
"299170","더블유에스아이","46243039920","1540","30027948","30027963","15","2024-09"
"012510","더존비즈온","1338377730750","47750","28028853","30382784","2353931","2024-09"
"224060","더코디","21693550995","4595","4721121","4748398","27277","2024-09"
"043090","더테크놀로지","33113674195","445","74412751","74412751","0","2024-09"
"213420","덕산네오룩스","711096389250","28950","24562915","24831179","268264","2024-09"
"317330","덕산테코피아","802682092800","39200","20476584","20476584","0","2024-09"
"077360","덕산하이메탈","217643239580","4790","45437002","45437002","0","2024-09"
"004830","덕성","92452369000","6680","13840175","15680000","1839825","2024-09"
"090410","덕신이피씨","65254993560","1416","46084035","46084095","60","2024-09"
"024900","덕양산업","108956668800","3360","32427580","32564980","137400","2024-09"
"263600","덕우전자","94307435200","5920","15930310","15930310","0","2024-09"
"194480","데브시스터즈","378978350400","35100","10797104","12035480","1238376","2024-09"
"263800","데이타솔루션","73149403800","4510","16219380","16219380","0","2024-09"
"206560","덱스터","189669702820","7540","25155133","25411736","256603","2024-09"
"261200","덴티스","111986457250","7330","15277825","15809700","531875","2024-09"
"145720","덴티움","664039607000","77000","8623891","11068830","2444939","2024-09"
"067990","도이치모터스","140975525500","4750","29679058","30181550","502492","2024-09"
"002150","도화엔지니어링","222416111000","6680","33295825","33720000","424175","2024-09"
"006620","동구바이오제약","162158452040","5980","27116798","28464992","1348194","2024-09"
"100130","동국S&C","145743685645","2615","55733723","57143000","1409277","2024-09"
"005160","동국산업","356033680010","6910","51524411","54244482","2720071","2024-09"
"460850","동국씨엠","190731378240","6390","29848416","29898656","50240","2024-09"
"075970","동국알앤에스","47104000000","2560","18400000","18400000","0","2024-09"
"460860","동국제강","440499873380","8890","49550042","49608017","57975","2024-09"
"086450","동국제약","799344057600","18180","43968320","44460000","491680","2024-09"
"001230","동국홀딩스","249434374860","8020","31101543","31800483","698940","2024-09"
"023450","동남합성","113334930000","32700","3465900","3500000","34100","2024-09"
"004140","동방","117814196790","2465","47794806","47971766","176960","2024-09"
"099410","동방선기","38979223725","2795","13946055","14000000","53945","2024-09"
"007590","동방아그로","77163398020","6220","12405691","13617577","1211886","2024-09"
"005960","동부건설","95668365180","4170","22942054","22946345","4291","2024-09"
"026960","동서","1935954901260","19620","98672523","99700000","1027477","2024-09"
"002210","동성제약","104497565160","4570","22865988","26100970","3234982","2024-09"
"102260","동성케미컬","210167848470","4315","48706338","49689728","983390","2024-09"
"033500","동성화인텍","326042038670","11230","29033129","29989494","956365","2024-09"
"025950","동신건설","168840000000","20100","8400000","8400000","0","2024-09"
"000640","동아쏘시오홀딩스","776964868900","124300","6250723","6348913","98190","2024-09"
"170900","동아에스티","710146985800","79100","8977838","9167274","189436","2024-09"
"088130","동아엘텍","99485211540","9330","10662938","10662938","0","2024-09"
"028100","동아지질","166408444800","12560","13249080","14052646","803566","2024-09"
"041930","동아화성","104673197100","7050","14847262","15800000","952738","2024-09"
"001520","동양","148047169140","780","189804063","238684063","48880000","2024-09"
"084670","동양고속","22515670000","8630","2609000","2895569","286569","2024-09"
"082640","동양생명","849901683350","5450","155945263","161358585","5413322","2024-09"
"060380","동양에스텍","29104400000","1508","19300000","19700000","400000","2024-09"
"079960","동양이엔피","152405413860","19740","7720639","7860000","139361","2024-09"
"008970","동양철관","128613777201","819","157037579","157052160","14581","2024-09"
"228340","동양파일","40200000000","2010","20000000","20000000","0","2024-09"
"092780","동양피스톤","72444149680","5740","12620932","13168460","547528","2024-09"
"088910","동우팜투테이블","51700745640","2010","25721764","25831764","110000","2024-09"
"094170","동운아나텍","350554497600","18600","18847016","19067208","220192","2024-09"
"049770","동원F&B","627107650000","32500","19295620","19295620","0","2024-09"
"013120","동원개발","231106614500","2545","90808100","90808100","0","2024-09"
"018500","동원금속","60020329620","1284","46744805","46754933","10128","2024-09"
"006040","동원산업","1246357567000","34600","36021895","36021895","0","2024-09"
"030720","동원수산","26805916800","5760","4653805","4653805","0","2024-09"
"014820","동원시스템즈","1433618894900","49450","28991282","28991282","0","2024-09"
"111380","동인기연","121682854500","20500","5935749","6128000","192251","2024-09"
"163560","동일고무벨트","101470000000","7300","13900000","13900000","0","2024-09"
"109860","동일금속","74187403250","8770","8459225","9100000","640775","2024-09"
"032960","동일기연","41873668960","11080","3779212","3986323","207111","2024-09"
"004890","동일산업","88159089700","40700","2166071","2425215","259144","2024-09"
"002690","동일제강","29067187520","1532","18973360","20300360","1327000","2024-09"
"023790","동일철강","27071263700","1300","20824049","20841335","17286","2024-09"
"005290","동진쎄미켐","1367625540400","26600","51414494","51414494","0","2024-09"
"025900","동화기업","524192753880","11460","45741078","50557285","4816207","2024-09"
"000020","동화약품","219803184900","7930","27717930","27931470","213540","2024-09"
"000150","두산","2785731614000","206000","13522969","16523835","3000866","2024-09"
"454910","두산로보틱스","4226262696000","65200","64819980","64819980","0","2024-09"
"241560","두산밥캣","4303964987000","43000","100092209","100249166","156957","2024-09"
"034020","두산에너빌리티","13097512685600","20450","640465168","640561146","95978","2024-09"
"131970","두산테스나","481313145450","28450","16917861","17006566","88705","2024-09"
"336260","두산퓨얼셀","1167556166570","17830","65482679","65493726","11047","2024-09"
"016740","두올","112144456800","3600","31151238","32066680","915442","2024-09"
"073190","듀오백","29096841940","2630","11063438","11968040","904602","2024-09"
"030350","드래곤플라이","16722742493","241","69388973","69388973","0","2024-09"
"203650","드림시큐리티","160384864710","3290","48749199","50605754","1856555","2024-09"
"223250","드림씨아이에스","90080441340","3785","23799324","23799324","0","2024-09"
"060570","드림어스컴퍼니","130749699717","1729","75621573","75621573","0","2024-09"
"362990","드림인사이트","37057418880","2260","16397088","16800574","403486","2024-09"
"192650","드림텍","599554485360","8880","67517397","68883113","1365716","2024-09"
"217620","디딤이앤에프","21715711458","381","56996618","57747210","750592","2024-09"
"016670","디모아","20234984200","4100","4935362","4941846","6484","2024-09"
"187870","디바이스이엔지","91819596760","13660","6721786","7036609","314823","2024-09"
"024090","디씨엠","107972283360","12440","8679444","11400000","2720556","2024-09"
"003160","디아이","475326369630","18270","26016769","28300000","2283231","2024-09"
"092200","디아이씨","148590430625","3835","38745875","38888569","142694","2024-09"
"110990","디아이티","239855079090","13010","18436209","18900000","463791","2024-09"
"263690","디알젬","81874576440","7470","10960452","11325610","365158","2024-09"
"214680","디알텍","224130031360","3040","73726984","73727108","124","2024-09"
"347850","디앤디파마텍","542744543500","51500","10538729","10538729","0","2024-09"
"263720","디앤씨미디어","219578734790","17690","12412591","12524473","111882","2024-09"
"376300","디어유","586338628200","24700","23738406","23738406","0","2024-09"
"109740","디에스케이","130552731400","5180","25203230","25710390","507160","2024-09"
"196490","디에이테크놀로지","36209568780","203","178372260","178549360","177100","2024-09"
"066900","디에이피","41625165945","2365","17600493","22744503","5144010","2024-09"
"127120","디엔에이링크","83190219100","3700","22483843","22483843","0","2024-09"
"092070","디엔에프","119190137400","10300","11571858","11571858","0","2024-09"
"039840","디오","248429673720","17190","14451988","14981755","529767","2024-09"
"013570","디와이","115698505790","4690","24669191","26319633","1650442","2024-09"
"219550","디와이디","39799901037","507","78500791","78500791","0","2024-09"
"310870","디와이씨","22630797978","1094","20686287","20687271","984","2024-09"
"210540","디와이파워","138279213030","12530","11035851","11041708","5857","2024-09"
"104460","디와이피엔에프","113285777840","11720","9666022","10713625","1047603","2024-09"
"079810","디이엔티","165861681810","7590","21852659","22028094","175435","2024-09"
"113810","디젠스","28908453186","886","32628051","32628051","0","2024-09"
"043360","디지아이","19976250560","2240","8917969","9000000","82031","2024-09"
"197140","디지캡","35020740240","2760","12688674","13013154","324480","2024-09"
"068930","디지털대성","193644604000","7390","26203600","27675342","1471742","2024-09"
"033130","디지틀조선","59384427200","1600","37115267","37115267","0","2024-09"
"105740","디케이락","75653736720","7440","10168513","10168513","0","2024-09"
"263020","디케이앤디","49847433850","3350","14879831","15069831","190000","2024-09"
"290550","디케이티","173210651800","8660","20001230","20001230","0","2024-09"
"066670","디티씨","52116144880","3320","15697634","18691918","2994284","2024-09"
"187220","디티앤씨","35727292300","3100","11524933","11698021","173088","2024-09"
"383930","디티앤씨알오","93097032480","7290","12770512","12770512","0","2024-09"
"131180","딜리","27925795305","1005","27786861","29350000","1563139","2024-09"
"315640","딥노이드","142150839120","6340","22421268","22421268","0","2024-09"
"223310","딥마인드","53660153800","2350","22834108","22839375","5267","2024-09"
"317120","라닉스","34201729500","3550","9634290","9660000","25710","2024-09"
"462510","라메디텍","95417607050","11030","8650735","8650735","0","2024-09"
"042510","라온시큐어","106927792120","1978","54058540","56025871","1967331","2024-09"
"232680","라온테크","77573606880","6360","12197108","12534234","337126","2024-09"
"418420","라온텍","107213540280","3570","30031804","30108433","76629","2024-09"
"300120","라온피플","101379658320","4860","20860012","20860012","0","2024-09"
"171120","라이온켐텍","80474196000","2280","35295700","35901760","606060","2024-09"
"388790","라이콤","92277496185","3095","29815023","29913930","98907","2024-09"
"347700","라이프시맨틱스","73379510390","3670","19994417","19994417","0","2024-09"
"214260","라파스","168808543500","20100","8398435","8912435","514000","2024-09"
"115390","락앤락","374233582080","8640","43314072","43326411","12339","2024-09"
"200350","래몽래인","134946337500","13500","9996025","9996025","0","2024-09"
"171010","램테크놀러지","56194095360","3930","14298752","14298752","0","2024-09"
"084650","랩지노믹스","269862363650","3635","74239990","74239990","0","2024-09"
"217500","러셀","53722582648","1852","29007874","31812000","2804126","2024-09"
"038390","레드캡투어","131091244480","15680","8360411","8589480","229069","2024-09"
"294140","레몬","91325131050","4350","20994283","21000000","5717","2024-09"
"443250","레뷰코퍼레이션","85559534400","7940","10775760","11279386","503626","2024-09"
"228670","레이","142401384260","9190","15495254","15495254","0","2024-09"
"228850","레이언스","110784537600","7040","15736440","16591014","854574","2024-09"
"412350","레이저쎌","46689300200","5350","8726972","8726972","0","2024-09"
"199550","레이저옵텍","82986184560","7120","11655363","11656947","1584","2024-09"
"281740","레이크머티리얼즈","999761057100","15210","65730510","65730548","38","2024-09"
"277810","레인보우로보틱스","2560781256000","132000","19399858","19399858","0","2024-09"
"215100","로보로보","68438189300","3380","20247985","20348454","100469","2024-09"
"090360","로보스타","209137500000","21450","9750000","9750000","0","2024-09"
"108490","로보티즈","234704324400","18200","12895842","13051842","156000","2024-09"
"067730","로지시스","24861979540","2570","9673922","9673922","0","2024-09"
"071280","로체시스템즈","274306508910","18390","14916069","15296603","380534","2024-09"
"032350","롯데관광개발","738341013270","9690","76196183","76196183","0","2024-09"
"089860","롯데렌탈","1091538093150","30050","36324063","36634063","310000","2024-09"
"000400","롯데손해보험","704770868400","2280","309110030","310336320","1226290","2024-09"
"023530","롯데쇼핑","1814975088000","64200","28270640","28288755","18115","2024-09"
"020150","롯데에너지머티리얼즈","1724545229000","37400","46110835","46110835","0","2024-09"
"280360","롯데웰푸드","1180309144500","133500","8841267","9434574","593307","2024-09"
"286940","롯데이노베이트","349488377700","23100","15129367","15129367","0","2024-09"
"004000","롯데정밀화학","1199637000000","47100","25470000","25800000","330000","2024-09"
"004990","롯데지주","1699327200000","24000","70805300","104909237","34103937","2024-09"
"005300","롯데칠성","1122744964000","121000","9278884","9278884","0","2024-09"
"011170","롯데케미칼","3782393085900","89700","42167147","42775419","608272","2024-09"
"071840","롯데하이마트","186242481600","8050","23135712","23607712","472000","2024-09"
"328130","루닛","1118834640000","38750","28873152","28873152","0","2024-09"
"038060","루멘스","59166774870","1230","48103069","48103069","0","2024-09"
"141080","리가켐바이오","4513348417200","123900","36427348","36567348","140000","2024-09"
"058470","리노공업","2797511816000","184300","15179120","15242370","63250","2024-09"
"016100","리더스코스메틱","51340315600","2800","18335827","19100894","765067","2024-09"
"012700","리드코프","113513168620","4435","25594852","26446135","851283","2024-09"
"302550","리메드","102177996800","3335","30638080","30638080","0","2024-09"
"073570","리튬포어스","66146412156","1828","36185127","36189497","4370","2024-09"
"377450","리파인","205725544200","13530","15205140","17330000","2124860","2024-09"
"277070","린드먼아시아","54858718500","4330","12669450","13692000","1022550","2024-09"
"042500","링네트","73746317280","4580","16101816","19070134","2968318","2024-09"
"193250","링크드","29192076797","461","63323377","63323377","0","2024-09"
"219420","링크제니시스","51152870565","4545","11254757","11469507","214750","2024-09"
"439090","마녀공장","330021939000","20150","16378260","16378260","0","2024-09"
"027740","마니커","59945149792","944","63501218","63511228","10010","2024-09"
"195500","마니커에프앤지","47294880000","2960","15978000","15978000","0","2024-09"
"377480","마음AI","65200120700","10450","6239246","6239246","0","2024-09"
"305090","마이크로디지탈","245738185400","14860","16536890","16536890","0","2024-09"
"098120","마이크로컨텍솔","44888936400","5400","8312766","8312766","0","2024-09"
"424980","마이크로투나노","49777864900","8410","5918890","5918890","0","2024-09"
"038290","마크로젠","183614648800","18400","9979057","10841400","862343","2024-09"
"001080","만호제강","100509848000","34000","2956172","4150000","1193828","2024-09"
"267980","매일유업","270986784600","37550","7216692","7843638","626946","2024-09"
"005990","매일홀딩스","105205584500","8420","12494725","13718304","1223579","2024-09"
"093520","매커스","87642431260","8930","9814382","16163092","6348710","2024-09"
"377030","맥스트","58223373950","2975","19570882","19570882","0","2024-09"
"100590","머큐리","56671482340","3580","15830023","15830023","0","2024-09"
"067280","멀티캠퍼스","182544793200","30800","5926779","5926779","0","2024-09"
"072870","메가스터디","128100632460","11230","11407002","11920959","513957","2024-09"
"215200","메가스터디교육","474468680700","44100","10758927","11461955","703028","2024-09"
"133750","메가엠디","45474469100","2060","22074985","23407077","1332092","2024-09"
"446540","메가터치","88484460000","4260","20771000","20771000","0","2024-09"
"235980","메드팩토","210886764600","6280","33580695","33580695","0","2024-09"
"041920","메디아나","89458477000","4820","18559850","18598223","38373","2024-09"
"014100","메디앙스","25426604250","2250","11300713","11800000","499287","2024-09"
"054180","메디콕스","22076710500","375","58871228","58878283","7055","2024-09"
"086900","메디톡스","1168552985600","173600","6731296","7298497","567201","2024-09"
"078160","메디포스트","218232224000","6400","34098785","34217785","119000","2024-09"
"138040","메리츠금융지주","19611168226000","106000","185011021","190720114","5709093","2024-09"
"408920","메쎄이상","95545065960","2220","43038318","43232455","194137","2024-09"
"021880","메이슨캐피탈","47938088520","315","152184408","152184408","0","2024-09"
"140410","메지온","916742890800","30600","29958918","29958918","0","2024-09"
"241770","메카로","75823055000","7700","9847150","10192640","345490","2024-09"
"090370","메타랩스","40863573189","1641","24901629","24904689","3060","2024-09"
"059210","메타바이오메드","91827498620","4015","22871108","23862351","991243","2024-09"
"118000","메타케어","57836098710","351","164775210","164777364","2154","2024-09"
"058110","멕아이씨에스","39906139750","2575","15497530","16050530","553000","2024-09"
"017180","명문제약","80060852745","2395","33428331","33953454","525123","2024-09"
"009900","명신산업","636462713290","12130","52470133","52470133","0","2024-09"
"012690","모나리자","112424383125","3075","36560775","36571255","10480","2024-09"
"005360","모나미","43652779170","2310","18897307","18897307","0","2024-09"
"070960","모나용평","185197050945","3915","47304483","48133333","828850","2024-09"
"434480","모니터랩","44645518500","3795","11764300","12253300","489000","2024-09"
"080420","모다이노칩","153304679106","1923","79721622","79721622","0","2024-09"
"417970","모델솔루션","61664188000","9640","6396700","6396700","0","2024-09"
"080160","모두투어","172603521330","9970","17312289","18900000","1587711","2024-09"
"087260","모바일어플라이언스","71941822810","2210","32552861","32552861","0","2024-09"
"101330","모베이스","74301963090","3210","23147029","23147029","0","2024-09"
"012860","모베이스전자","130678898912","1798","72680144","73233457","553313","2024-09"
"363260","모비데이즈","50540378220","1593","31726540","32163769","437229","2024-09"
"348030","모비릭스","50612026000","5270","9603800","9603800","0","2024-09"
"250060","모비스","116310234810","3630","32041387","32171314","129927","2024-09"
"288980","모아데이타","54599367960","1580","34556562","34556562","0","2024-09"
"142760","모아라이프플러스","52262713235","1385","37734811","37734811","0","2024-09"
"033200","모아텍","30282900410","3290","9204529","14331185","5126656","2024-09"
"333050","모코엠시스","29880531200","1300","22985024","24444326","1459302","2024-09"
"009680","모토닉","189025433760","8740","21627624","33000000","11372376","2024-09"
"118990","모트렉스","253157174620","10210","24795022","24861990","66968","2024-09"
"006920","모헨즈","27900600000","2555","10920000","10920000","0","2024-09"
"009580","무림P&P","177424948410","2845","62363778","62368324","4546","2024-09"
"001810","무림SP","35929162500","1623","22137500","22137500","0","2024-09"
"009200","무림페이퍼","85507132050","2055","41609310","41609310","0","2024-09"
"033920","무학","148856198160","5620","26486868","28500000","2013132","2024-09"
"008420","문배철강","44617414650","2330","19149105","20503505","1354400","2024-09"
"279600","미디어젠","52938025300","11300","4684781","4684781","0","2024-09"
"095500","미래나노텍","297058850010","10470","28372383","31009999","2637616","2024-09"
"254490","미래반도체","248622360000","17220","14438000","14438000","0","2024-09"
"025560","미래산업","32765239580","1052","31145665","31166865","21200","2024-09"
"218150","미래생명자원","92896386285","4765","19495569","20415802","920233","2024-09"
"007120","미래아이앤지","27978868736","1024","27323114","28878608","1555494","2024-09"
"442900","미래에셋드림스팩1호","76800000000","10000","7680000","7680000","0","2024-09"
"100790","미래에셋벤처투자","266665301560","5020","53120578","53124634","4056","2024-09"
"412930","미래에셋비전스팩1호","16551680000","2680","6176000","6176000","0","2024-09"
"446190","미래에셋비전스팩2호","10964250000","2215","4950000","4950000","0","2024-09"
"448830","미래에셋비전스팩3호","10676400000","2170","4920000","4920000","0","2024-09"
"477380","미래에셋비전스팩4호","16443000000","2030","8100000","8100000","0","2024-09"
"477470","미래에셋비전스팩5호","11453200000","2090","5480000","5480000","0","2024-09"
"478440","미래에셋비전스팩6호","14137200000","2040","6930000","6930000","0","2024-09"
"482680","미래에셋비전스팩7호","16314990000","1986","8215000","8215000","0","2024-09"
"085620","미래에셋생명","686324800000","5260","130480000","177016189","46536189","2024-09"
"006800","미래에셋증권","4064828505050","9050","449152321","595316408","146164087","2024-09"
"049950","미래컴퍼니","149416956650","18850","7926629","8817884","891255","2024-09"
"207760","미스터블루","117561561305","1427","82383715","83079783","696068","2024-09"
"002840","미원상사","931161097500","200500","4644195","4750000","105805","2024-09"
"268280","미원에스씨","730024795500","149500","4883109","5000000","116891","2024-09"
"107590","미원홀딩스","184772910000","79800","2315450","2320000","4550","2024-09"
"134380","미원화학","159202089000","79500","2002542","2199268","196726","2024-09"
"003650","미창석유","146758963000","97000","1512979","1739672","226693","2024-09"
"059090","미코","327559408800","10400","31496097","33416778","1920681","2024-09"
"214610","미코바이오메드","82981005615","1905","43559583","43568945","9362","2024-09"
"201490","미투온","69621147050","2275","30602702","31257770","655068","2024-09"
"452200","민테크","160639596000","7320","21945300","21945300","0","2024-09"
"418470","밀리의서재","126214441650","14850","8499289","8499289","0","2024-09"
"206640","바디텍메드","305032376480","13880","21976396","23486560","1510164","2024-09"
"018700","바른손","40624530240","1180","34427568","35119757","692189","2024-09"
"035620","바른손이앤에이","37059348269","499","74267231","74439675","172444","2024-09"
"053030","바이넥스","734457730000","23750","30924536","31761048","836512","2024-09"
"301300","바이브컴퍼니","52211211500","4220","12372325","12394861","22536","2024-09"
"377740","바이오노트","464816802200","4570","101710460","102056048","345588","2024-09"
"064550","바이오니아","662033964150","25650","25810291","25810291","0","2024-09"
"314930","바이오다인","614590446000","20850","29476760","29764103","287343","2024-09"
"208710","바이오로그디바이스","29984802120","455","65900664","65900664","0","2024-09"
"086820","바이오솔루션","123162536300","15350","8023618","8143426","119808","2024-09"
"038460","바이오스마트","85260284000","3700","23043320","23933216","889896","2024-09"
"251120","바이오에프디엔씨","144992133000","17000","8528949","8695700","166751","2024-09"
"199730","바이오인프라","46406061180","9540","4864367","4864367","0","2024-09"
"086040","바이오톡스텍","69643095270","4430","15720789","15958247","237458","2024-09"
"099430","바이오플러스","327114486370","5810","56301977","57930864","1628887","2024-09"
"032980","바이온","33620024510","751","44767010","44777990","10980","2024-09"
"308080","바이젠셀","68482595700","3555","19263740","19263740","0","2024-09"
"043150","바텍","343876026400","23150","14854256","14854256","0","2024-09"
"323990","박셀바이오","311858521100","13580","22964545","22993200","28655","2024-09"
"003610","방림","113969352980","3220","35394209","42314090","6919881","2024-09"
"267790","배럴","38574765000","4890","7888500","7888500","0","2024-09"
"001340","백광산업","434868703950","9850","44149107","44918407","769300","2024-09"
"046310","백금T&A","38918544060","2420","16082043","16418641","336598","2024-09"
"035150","백산","297560000000","13840","21500000","21500000","0","2024-09"
"331520","밸로프","34635275584","706","49058464","50864390","1805926","2024-09"
"199480","뱅크웨어글로벌","92009089600","9200","10000988","10000988","0","2024-09"
"438700","버넥트","40010155100","3590","11144890","11144890","0","2024-09"
"066410","버킷스튜디오","96977294204","1153","84108668","84109926","1258","2024-09"
"002410","범양건영","27188797440","1095","24829952","24831982","2030","2024-09"
"382900","범한퓨얼셀","129595750000","15100","8582500","8761000","178500","2024-09"
"206400","베노티앤알","128056748500","3950","32419430","32420452","1022","2024-09"
"019010","베뉴지","88440000000","2200","40200000","48200000","8000000","2024-09"
"177350","베셀","23995650309","269","89203161","89372043","168882","2024-09"
"424760","벨로크","20615392548","1063","19393596","19665002","271406","2024-09"
"007210","벽산","111963770000","2000","55981885","67560000","11578115","2024-09"
"225530","보광산업","144082354715","3965","36338551","36338727","176","2024-09"
"250000","보라티알","65426567940","9990","6549206","6750733","201527","2024-09"
"002760","보락","81583800000","1362","59900000","59900000","0","2024-09"
"003850","보령","760748950500","11550","65865710","68690000","2824290","2024-09"
"310210","보로노이","2011401777300","113700","17690429","18093830","403401","2024-09"
"006910","보성파워텍","153884296480","3145","48929824","49129824","200000","2024-09"
"000890","보해양조","59385277784","427","139075592","139120129","44537","2024-09"
"226340","본느","71402950760","1702","41952380","41952420","40","2024-09"
"003000","부광약품","349118822100","5100","68454671","68454671","0","2024-09"
"001270","부국증권","170155845300","28650","5939122","10369886","4430764","2024-09"
"026940","부국철강","51400000000","2570","20000000","20000000","0","2024-09"
"014470","부방","91823348991","1711","53666481","60052260","6385779","2024-09"
"011390","부산산업","56496000000","53500","1056000","1056000","0","2024-09"
"005030","부산주공","38288532168","486","78782988","78782988","0","2024-09"
"008470","부스타","32852561715","4065","8081811","8404800","322989","2024-09"
"338220","뷰노","421507385950","30350","13888217","13888217","0","2024-09"
"100120","뷰웍스","238729686000","26000","9181911","10001865","819954","2024-09"
"406820","뷰티스킨","51985728400","14710","3534040","3534040","0","2024-09"
"337930","브랜드엑스코퍼레이션","273769848980","9340","29311547","29311547","0","2024-09"
"099390","브레인즈컴퍼니","48448461130","6130","7903501","8208283","304782","2024-09"
"064480","브리지텍","63167974300","5450","11590454","11952500","362046","2024-09"
"288330","브릿지바이오테라퓨틱스","265377644250","5730","46313725","46313725","0","2024-09"
"365900","브이씨","25695704500","3515","7310300","7310300","0","2024-09"
"089970","브이엠","186375356640","8460","22030184","24075595","2045411","2024-09"
"251630","브이원텍","66697758650","4370","15262645","15942886","680241","2024-09"
"018290","브이티","1118014600500","31500","35492527","35798007","305480","2024-09"
"439580","블루엠텍","279255525000","25000","11170221","11170221","0","2024-09"
"033560","블루콤","58875102150","3450","17065247","17100000","34753","2024-09"
"369370","블리츠웨이스튜디오","78416004578","1646","47640343","49871911","2231568","2024-09"
"126340","비나텍","221688262500","37500","5911687","6085118","173431","2024-09"
"121800","비덴트","256296018720","3320","77197596","77201611","4015","2024-09"
"082800","비보존 제약","212166726960","4465","47517744","48242965","725221","2024-09"
"318410","비비씨","47775089800","8600","5555243","5555243","0","2024-09"
"002070","비비안","25444067460","854","29793990","29793990","0","2024-09"
"100220","비상교육","62972787100","5140","12251515","12996741","745226","2024-09"
"419540","비스토스","45911938635","1997","22990455","22992511","2056","2024-09"
"146320","비씨엔씨","176975325760","13940","12695504","12792923","97419","2024-09"
"200780","비씨월드제약","42783524550","5070","8438565","8892384","453819","2024-09"
"413640","비아이매트릭스","54628605200","7580","7206940","7206940","0","2024-09"
"141000","비아트론","73030641780","6620","11031819","12114710","1082891","2024-09"
"090460","비에이치","533811409110","17010","31382211","34464379","3082168","2024-09"
"083650","비에이치아이","301685806500","9750","30942134","30944375","2241","2024-09"
"445360","비엔케이제1호스팩","9029450000","2095","4310000","4310000","0","2024-09"
"473370","비엔케이제2호스팩","8525250000","2025","4210000","4210000","0","2024-09"
"065170","비엘팜텍","33452250752","376","88968752","88970559","1807","2024-09"
"086670","비엠티","80849041640","8860","9125174","9125174","0","2024-09"
"335890","비올","535277053800","9270","57742940","58419125","676185","2024-09"
"230980","비유테크놀러지","21370405721","229","93320549","93320557","8","2024-09"
"138580","비즈니스온","356042480800","15850","22463248","22556163","92915","2024-09"
"082920","비츠로셀","434601981600","19400","22402164","22872213","470049","2024-09"
"054220","비츠로시스","22318911946","454","49160599","49160599","0","2024-09"
"042370","비츠로테크","183924175500","7020","26200025","26200025","0","2024-09"
"050090","비케이홀딩스","15899316285","807","19701755","19784735","82980","2024-09"
"148780","비큐AI","33898491550","1078","31445725","31445725","0","2024-09"
"307870","비투엔","49827666900","1100","45297879","45297879","0","2024-09"
"357880","비트나인","21880087820","2095","10443956","10443956","0","2024-09"
"032850","비트컴퓨터","80521677720","4995","16120456","16623293","502837","2024-09"
"238200","비피도","36482800000","4460","8180000","8180000","0","2024-09"
"093190","빅솔론","68328085060","4540","15050239","19238905","4188666","2024-09"
"065450","빅텍","143120736000","4995","28652800","28652800","0","2024-09"
"210120","빅텐츠","77042945000","24500","3144610","3144610","0","2024-09"
"044480","빌리언스","25984122192","639","40663728","40663728","0","2024-09"
"005180","빙그레","557033463000","63000","8841801","9851241","1009440","2024-09"
"069540","빛과전자","62442949720","1471","42449320","42449320","0","2024-09"
"072950","빛샘전자","31842230400","3975","8010624","8052610","41986","2024-09"
"451250","삐아","115535180460","12180","9485647","9682187","196540","2024-09"
"143240","사람인","175871444400","16200","10856262","11709263","853001","2024-09"
"003960","사조대림","372848083650","44650","8350461","9164467","814006","2024-09"
"008040","사조동아원","142214709746","1009","140946194","141144600","198406","2024-09"
"007160","사조산업","305571600000","61200","4993000","5000000","7000","2024-09"
"014710","사조씨푸드","117430463260","6820","17218543","17218543","0","2024-09"
"006090","사조오양","82920076800","8800","9422736","9422739","3","2024-09"
"452430","사피엔반도체","100625374520","12430","8095364","8096454","1090","2024-09"
"419120","산돌","49678226990","6790","7316381","7774326","457945","2024-09"
"062040","산일전기","1356665558550","44650","30384447","30445200","60753","2024-09"
"122350","삼기","57056236704","1503","37961568","38339428","377860","2024-09"
"419050","삼기이브이","114964442400","2010","57196240","57196240","0","2024-09"
"014970","삼륭물산","59994287600","4030","14886920","15125000","238080","2024-09"
"018310","삼목에스폼","347102248800","24400","14225502","14700000","474498","2024-09"
"053700","삼보모터스","95584510800","4300","22228956","22877190","648234","2024-09"
"009620","삼보산업","21397515730","290","73784537","73785902","1365","2024-09"
"023600","삼보판지","145310976540","9270","15675402","16170000","494598","2024-09"
"001470","삼부토건","109122570112","488","223611824","223611824","0","2024-09"
"028050","삼성E&A","4047400000000","20650","196000000","196000000","0","2024-09"
"006400","삼성SDI","21592935870000","330000","65433139","68764530","3331391","2024-09"
"006660","삼성공조","85210703440","10840","7860766","8126314","265548","2024-09"
"028260","삼성물산","22168308322700","136700","162167581","177784107","15616526","2024-09"
"207940","삼성바이오로직스","75444440000000","1060000","71174000","71174000","0","2024-09"
"032830","삼성생명","18137052679000","101000","179574779","200000000","20425221","2024-09"
"425290","삼성스팩6호","11619600000","2105","5520000","5520000","0","2024-09"
"439250","삼성스팩7호","36350760000","10380","3502000","3502000","0","2024-09"
"448740","삼성스팩8호","46826560000","10040","4664000","4664000","0","2024-09"
"468510","삼성스팩9호","22376250000","2025","11050000","11050000","0","2024-09"
"018260","삼성에스디에스","11362742323400","146900","77350186","77377800","27614","2024-09"
"009150","삼성전기","8941324608000","123000","72693696","74693696","2000000","2024-09"
"005930","삼성전자","353411126960000","59200","5969782550","5969782550","0","2024-09"
"001360","삼성제약","177981479736","1891","94120296","94162079","41783","2024-09"
"010140","삼성중공업","8583057488550","10050","854035571","880000000","25964429","2024-09"
"016360","삼성증권","4228355000000","47350","89300000","89300000","0","2024-09"
"068290","삼성출판사","148700000000","14870","10000000","10000000","0","2024-09"
"029780","삼성카드","4369802960250","40950","106710695","115858891","9148196","2024-09"
"000810","삼성화재","14039474340000","352500","39828296","47374837","7546541","2024-09"
"006110","삼아알미늄","741480566400","50400","14711916","14711916","0","2024-09"
"009300","삼아제약","136714860800","22400","6103342","6370000","266658","2024-09"
"145990","삼양사","494917120000","51200","9666350","10313449","647099","2024-09"
"003230","삼양식품","4079596016000","547000","7458128","7533015","74887","2024-09"
"002170","삼양통상","125473000000","46300","2710000","3000000","290000","2024-09"
"272550","삼양패키징","253570040850","16350","15508871","15788671","279800","2024-09"
"000070","삼양홀딩스","548743221000","73800","7435545","8564271","1128726","2024-09"
"003720","삼영","159352755725","4805","33163945","34000000","836055","2024-09"
"002810","삼영무역","224229482880","12720","17628104","18466948","838844","2024-09"
"361670","삼영에스앤씨","40664771820","7290","5578158","5667658","89500","2024-09"
"054540","삼영엠텍","50278850000","4145","12130000","13000000","870000","2024-09"
"065570","삼영이엔씨","21917543410","1610","13613381","13613381","0","2024-09"
"005680","삼영전자","193378676480","9680","19977136","20000000","22864","2024-09"
"023000","삼원강재","103323885600","2600","39739956","40000000","260044","2024-09"
"004380","삼익THK","189198000000","9140","20700000","21000000","300000","2024-09"
"002450","삼익악기","82341480945","1083","76030915","90530915","14500000","2024-09"
"032280","삼일","23870998080","1539","15510720","16213590","702870","2024-09"
"002290","삼일기업공사","35774000000","2885","12400000","12400000","0","2024-09"
"004440","삼일씨엔에스","55320309715","4345","12731947","12731947","0","2024-09"
"000520","삼일제약","373032147460","17630","21158942","21621100","462158","2024-09"
"009770","삼정펄프","66874224250","26750","2499971","2499971","0","2024-09"
"037460","삼지전자","133101077040","8670","15351912","16318522","966610","2024-09"
"032750","삼진","38446747080","4260","9025058","9031122","6064","2024-09"
"054090","삼진엘앤디","24142511702","974","24786973","24959232","172259","2024-09"
"005500","삼진제약","238646589000","19050","12527380","13900000","1372620","2024-09"
"000250","삼천당제약","3158364697600","135800","23257472","23457472","200000","2024-09"
"004690","삼천리","303711017500","88700","3424025","4055025","631000","2024-09"
"024950","삼천리자전거","49257858760","4070","12102668","13273577","1170909","2024-09"
"038500","삼표시멘트","323670959280","3015","107353552","107916306","562754","2024-09"
"437730","삼현","89309647050","8450","10569189","10569189","0","2024-09"
"017480","삼현철강","73662585300","4770","15442890","15702890","260000","2024-09"
"010960","삼호개발","70434000000","3150","22360000","25000000","2640000","2024-09"
"046390","삼화네트웍스","55029246540","1390","39589386","43172933","3583547","2024-09"
"004450","삼화왕관","56926264450","31550","1804319","2154379","350060","2024-09"
"009470","삼화전기","260915199000","39450","6613820","6613820","0","2024-09"
"011230","삼화전자","50364705840","2980","16900908","16902700","1792","2024-09"
"001820","삼화콘덴서","357595850000","34850","10261000","10395000","134000","2024-09"
"000390","삼화페인트","171268264200","7260","23590670","27203469","3612799","2024-09"
"027580","상보","71767277582","1274","56332243","59181279","2849036","2024-09"
"038540","상상인","86409631804","1579","54724276","55328313","604037","2024-09"
"415580","상상인제3호스팩","11151000000","2100","5310000","5310000","0","2024-09"
"452670","상상인제4호스팩","10466100000","2005","5220000","5220000","0","2024-09"
"001290","상상인증권","50900379839","479","106263841","108337120","2073279","2024-09"
"041650","상신브레이크","66793069500","3450","19360310","21471450","2111140","2024-09"
"091580","상신이디피","141145839210","10590","13328219","13428219","100000","2024-09"
"263810","상신전자","47778846885","3355","14241087","14244718","3631","2024-09"
"089980","상아프론테크","339873837400","21800","15590543","15989037","398494","2024-09"
"042940","상지건설","22680562200","5700","3979046","3981814","2768","2024-09"
"042600","새로닉스","165248497190","13510","12231569","12423574","192005","2024-09"
"075180","새론오토모티브","74784000000","3895","19200000","19200000","0","2024-09"
"107600","새빗켐","115021498500","23300","4936545","4936545","0","2024-09"
"411080","샌즈랩","114788753820","7890","14548638","15248638","700000","2024-09"
"252990","샘씨엔에스","324408943060","5690","57013874","58388063","1374189","2024-09"
"007540","샘표","90393739800","44850","2015468","2875800","860332","2024-09"
"248170","샘표식품","131289635000","28750","4566596","4568286","1690","2024-09"
"378800","샤페론","116804245125","3875","30143031","30143031","0","2024-09"
"294630","서남","92560711740","3860","23979459","23979459","0","2024-09"
"038070","서린바이오","63838106640","7560","8444194","8900676","456482","2024-09"
"006730","서부T&D","392128092160","6080","64494752","66426923","1932171","2024-09"
"079650","서산","24920000000","1246","20000000","20000000","0","2024-09"
"100660","서암기계공업","48447000000","3845","12600000","12600000","0","2024-09"
"007860","서연","154121730600","7100","21707286","23479844","1772558","2024-09"
"200880","서연이화","378858969020","14020","27022751","27028437","5686","2024-09"
"019770","서연탑메탈","44328250000","3805","11650000","11650000","0","2024-09"
"017390","서울가스","205399696800","52900","3882792","5000000","1117208","2024-09"
"043710","서울리거","32779517979","653","50198343","50198880","537","2024-09"
"092190","서울바이오시스","186339166360","4120","45227953","45868383","640430","2024-09"
"046890","서울반도체","518708328000","9200","56381340","58305400","1924060","2024-09"
"004410","서울식품","59960865440","160","374755409","374755559","150","2024-09"
"063170","서울옥션","122741861220","7290","16837018","17774267","937249","2024-09"
"027040","서울전자통신","19136746200","275","69588168","69588847","679","2024-09"
"018680","서울제약","47453428330","4070","11659319","11659319","0","2024-09"
"021050","서원","60767475200","1280","47474590","47474590","0","2024-09"
"093920","서원인텍","106950000000","5750","18600000","18600000","0","2024-09"
"189860","서전기전","45584266000","4700","9698780","9698780","0","2024-09"
"178320","서진시스템","1527131951100","27150","56247954","56247954","0","2024-09"
"122690","서진오토모티브","51043090400","2350","21720464","21844410","123946","2024-09"
"140070","서플러스글로벌","119889389520","3480","34450974","36988000","2537026","2024-09"
"011370","서한","79537840650","810","98194865","100894865","2700000","2024-09"
"065710","서호전기","105021396600","21300","4930582","5150000","219418","2024-09"
"008490","서흥","185355613710","16670","11119113","11569113","450000","2024-09"
"035890","서희건설","285130067000","1475","193308520","229808457","36499937","2024-09"
"357550","석경에이티","248562300000","45700","5439000","5455000","16000","2024-09"
"003100","선광","98690100000","15690","6290000","6600000","310000","2024-09"
"007610","선도전기","50907057000","3000","16969019","18000000","1030981","2024-09"
"067370","선바이오","84783744370","6890","12305333","12313555","8222","2024-09"
"171090","선익시스템","415006007400","47400","8755401","9494405","739004","2024-09"
"136490","선진","166930040160","7020","23779208","23779604","396","2024-09"
"086710","선진뷰티사이언스","123945883200","10320","12010260","12203280","193020","2024-09"
"014620","성광벤드","368932064020","13780","26773009","28600000","1826991","2024-09"
"037350","성도이엔지","69949775000","4925","14203000","15470000","1267000","2024-09"
"014910","성문전자","25448397082","1226","20757257","22460985","1703728","2024-09"
"003080","성보화학","51222674915","2615","19588021","20020000","431979","2024-09"
"004980","성신양회","197261493460","8180","24115097","24516073","400976","2024-09"
"011300","성안머티리얼스","42172260260","515","81887884","81887884","0","2024-09"
"081580","성우전자","71766179280","4720","15204699","15508143","303444","2024-09"
"045300","성우테크론","27018026400","2760","9789140","10151583","362443","2024-09"
"015750","성우하이텍","506346783690","6330","79991593","80000000","8407","2024-09"
"365340","성일하이텍","656630472700","54100","12137347","12137347","0","2024-09"
"000180","성창기업지주","105324916000","1510","69751600","69751600","0","2024-09"
"080470","성창오토텍","30295000000","4150","7300000","7300000","0","2024-09"
"043260","성호전자","94553392950","1550","61002189","61002189","0","2024-09"
"148150","세경하이테크","245672037260","6940","35399429","35860429","461000","2024-09"
"002420","세기상사","32130141440","5780","5558848","5558848","0","2024-09"
"188260","세니젠","25624866610","3610","7098301","7228470","130169","2024-09"
"053060","세동","18928177504","1072","17656882","17657419","537","2024-09"
"340440","세림B&G","36863488341","1299","28378359","28378364","5","2024-09"
"017510","세명전기","80041500000","5250","15246000","15246000","0","2024-09"
"004360","세방","221346578160","12340","17937324","19308690","1371366","2024-09"
"004490","세방전지","965538685200","73400","13154478","14000000","845522","2024-09"
"011560","세보엠이씨","93523175460","9430","9917622","10530000","612378","2024-09"
"396300","세아메카닉스","82889767500","3165","26189500","26489500","300000","2024-09"
"001430","세아베스틸지주","717242380000","20000","35862119","35862119","0","2024-09"
"306200","세아제강","318651380000","113800","2800100","2836300","36200","2024-09"
"003030","세아제강지주","678797448000","168000","4040461","4141657","101196","2024-09"
"019440","세아특수강","114241256610","13690","8344869","8570000","225131","2024-09"
"058650","세아홀딩스","378263633900","97100","3895609","4000000","104391","2024-09"
"013000","세우글로벌","37256469338","1298","28702981","28705031","2050","2024-09"
"100700","세운메디칼","120998624500","2795","43291100","43800000","508900","2024-09"
"024830","세원물산","52688500000","6310","8350000","8350000","0","2024-09"
"091090","세원이앤씨","54828158060","1270","43171778","43180255","8477","2024-09"
"021820","세원정공","72200000000","7220","10000000","10000000","0","2024-09"
"067830","세이브존I&C","80523132655","2135","37715753","41040895","3325142","2024-09"
"258830","세종메디칼","22974088612","412","55762351","55786351","24000","2024-09"
"036630","세종텔레콤","97442176932","513","189945764","200000000","10054236","2024-09"
"039310","세중","30915563902","1706","18121667","18121667","0","2024-09"
"075580","세진중공업","424665436320","7470","56849456","56849456","0","2024-09"
"067770","세진티에스","20241481160","2440","8295689","8396593","100904","2024-09"
"053450","세코닉스","79139086770","5410","14628297","14792803","164506","2024-09"
"222810","세토피아","81189010800","1080","75175010","75659350","484340","2024-09"
"252500","세화피앤씨","40075852740","966","41486390","41486390","0","2024-09"
"321370","센서뷰","60722332225","2305","26343745","26343745","0","2024-09"
"347000","센코","79274057235","2435","32556081","33004976","448895","2024-09"
"331920","셀레믹스","36085534160","4420","8164148","8164148","0","2024-09"
"049180","셀루메드","190410707310","3730","51048447","51057455","9008","2024-09"
"299660","셀리드","118809760510","5630","21102977","21102977","0","2024-09"
"268600","셀리버리","248384003120","6680","37183234","37183234","0","2024-09"
"108860","셀바스AI","279370184880","10380","26914276","26914790","514","2024-09"
"208370","셀바스헬스케어","114314638655","4445","25717579","25740564","22985","2024-09"
"318160","셀바이오휴먼텍","26811642325","3055","8776315","9260901","484586","2024-09"
"308430","셀비온","331214234000","26000","12739009","12739009","0","2024-09"
"068270","셀트리온","38828279725200","188400","206094903","217021190","10926287","2024-09"
"068760","셀트리온제약","2673834116600","64600","41390621","41600387","209766","2024-09"
"068940","셀피글로벌","29334496224","778","37705008","38260597","555589","2024-09"
"060230","소니드","41737411872","912","45764706","46066730","302024","2024-09"
"290690","소룩스","440561409360","9670","45559608","45564340","4732","2024-09"
"032680","소프트센","46717174784","448","104279408","105590764","1311356","2024-09"
"258790","소프트캠프","20885405892","871","23978652","24991284","1012632","2024-09"
"066910","손오공","56488502343","1677","33684259","33784259","100000","2024-09"
"336370","솔루스첨단소재","881866462880","12560","70212298","70217344","5046","2024-09"
"248070","솔루엠","997755828000","20500","48671016","50005551","1334535","2024-09"
"035610","솔본","100486089675","3915","25666945","27345997","1679052","2024-09"
"357780","솔브레인","1571857826000","203000","7743142","7778566","35424","2024-09"
"036830","솔브레인홀딩스","1064072039500","51500","20661593","20964056","302463","2024-09"
"304100","솔트룩스","230359486320","18990","12130568","12130568","0","2024-09"
"328380","솔트웨어","41520925068","1212","34258189","34262778","4589","2024-09"
"004430","송원산업","297600000000","12400","24000000","24000000","0","2024-09"
"086980","쇼박스","251312950000","4025","62438000","62638000","200000","2024-09"
"050960","수산아이앤티","67510000000","10000","6751000","6751000","0","2024-09"
"126720","수산인더스트리","313150393750","22250","14074175","14286000","211825","2024-09"
"017550","수산중공업","107700898380","1726","62399130","62399130","0","2024-09"
"084180","수성웹툰","70482283800","600","117470473","117470473","0","2024-09"
"253840","수젠텍","98159668560","6420","15289668","16743200","1453532","2024-09"
"298830","슈어소프트테크","255486673420","4895","52193396","52619061","425665","2024-09"
"236200","슈프리마","177660734500","25750","6899446","7193273","293827","2024-09"
"094840","슈프리마에이치큐","54647099460","5970","9153618","10471840","1318222","2024-09"
"192440","슈피겐코리아","133560778800","22150","6029832","6216363","186531","2024-09"
"424960","스마트레이더시스템","176944462200","11330","15617340","15617340","0","2024-09"
"099440","스맥","126024962960","3380","37285492","40243394","2957902","2024-09"
"053210","스카이라이프","236232191340","4995","47293732","47522955","229223","2024-09"
"276040","스코넥","41492536570","3305","12554474","12554474","0","2024-09"
"159910","스킨앤스킨","27748150170","767","36177510","36410098","232588","2024-09"
"060240","스타코링크","27317202790","899","30386210","31136323","750113","2024-09"
"115570","스타플렉스","24340705530","3085","7890018","7984508","94490","2024-09"
"330730","스톤브릿지벤처스","66079013840","3790","17435096","18150830","715734","2024-09"
"352090","스톰테크","94055493000","3500","26872998","26872998","0","2024-09"
"253450","스튜디오드래곤","1089620552500","36250","30058498","30058498","0","2024-09"
"408900","스튜디오미르","129515961960","3960","32706051","32706134","83","2024-09"
"204630","스튜디오산타클로스","23613109200","4650","5078088","5089941","11853","2024-09"
"415380","스튜디오삼익","34464355000","8500","4054630","4225498","170868","2024-09"
"026890","스틱인베스트먼트","287637403300","7870","36548590","41678175","5129585","2024-09"
"013810","스페코","61846083400","4220","14655470","14655470","0","2024-09"
"203690","스피어파워","68221848380","5180","13170241","13337850","167609","2024-09"
"049830","승일","41825284080","7080","5907526","6132112","224586","2024-09"
"020710","시공테크","69039549900","3660","18863265","20047970","1184705","2024-09"
"033170","시그네틱스","83670839344","976","85728319","85728319","0","2024-09"
"048870","시너지이노베이션","251846907480","3045","82708344","82708344","0","2024-09"
"025320","시노펙스","580969727520","6960","83472662","83817936","345274","2024-09"
"134790","시디즈","49949000500","29750","1678958","2000000","321042","2024-09"
"269620","시스웍","131663951937","889","148103433","148582691","479258","2024-09"
"429270","시지트로닉스","31769062500","7050","4506250","4506250","0","2024-09"
"418250","시큐레터","52279100100","6550","7981542","7981542","0","2024-09"
"131090","시큐브","33784248900","870","38832470","44000000","5167530","2024-09"
"232830","시큐센","24234467040","2070","11707472","11707472","0","2024-09"
"462870","시프트업","3430081536000","58800","58334720","58334720","0","2024-09"
"016590","신대양제지","175751895090","5730","30672233","40297820","9625587","2024-09"
"290520","신도기연","34383518340","2185","15736164","15929362","193198","2024-09"
"029530","신도리코","349222549500","40500","8622779","10080029","1457250","2024-09"
"004970","신라교역","148852550000","9430","15785000","16000000","215000","2024-09"
"001000","신라섬유","24714535720","1018","24277540","24277540","0","2024-09"
"025870","신라에스지","24920000000","6230","4000000","4000000","0","2024-09"
"215600","신라젠","337738627500","2460","137292125","137367125","75000","2024-09"
"065350","신성델타테크","1378226163600","50700","27183948","27483948","300000","2024-09"
"416180","신성에스티","235909916300","26350","8952938","9039778","86840","2024-09"
"011930","신성이엔지","311863110468","1532","203565999","205848151","2282152","2024-09"
"005390","신성통상","319032625800","2220","143708390","143708390","0","2024-09"
"004170","신세계","1388573049500","150500","9226399","9845181","618782","2024-09"
"035510","신세계 I&C","131458100000","10000","13145810","17200000","4054190","2024-09"
"034300","신세계건설","138046129180","18190","7589122","7760554","171432","2024-09"
"031430","신세계인터내셔날","455717640000","13160","34629000","35700000","1071000","2024-09"
"031440","신세계푸드","137659945050","35550","3872291","3872480","189","2024-09"
"006880","신송홀딩스","70780438560","6560","10789701","11828858","1039157","2024-09"
"162300","신스틸","103984564320","2535","41019552","41471382","451830","2024-09"
"290560","신시웨이","24531497220","6330","3875434","3877972","2538","2024-09"
"002800","신신제약","94967330000","6260","15170500","15170500","0","2024-09"
"472220","신영스팩10호","10106950000","2155","4690000","4690000","0","2024-09"
"430220","신영스팩8호","14736800000","2180","6760000","6760000","0","2024-09"
"445970","신영스팩9호","11792000000","2200","5360000","5360000","0","2024-09"
"005800","신영와코루","82170000000","9130","9000000","9000000","0","2024-09"
"001720","신영증권","639329744000","83000","7702768","16440000","8737232","2024-09"
"009270","신원","90813350760","1210","75052356","102586356","27534000","2024-09"
"017000","신원종합개발","37840837320","3380","11195514","11668027","472513","2024-09"
"002700","신일전자","105226866516","1497","70291828","71047521","755693","2024-09"
"012790","신일제약","87043494330","7530","11559561","11986415","426854","2024-09"
"138070","신진에스엠","40806280100","2425","16827332","17503204","675872","2024-09"
"226330","신테카바이오","90940511000","5960","15258475","15258475","0","2024-09"
"002870","신풍","27872618280","1006","27706380","34958700","7252320","2024-09"
"019170","신풍제약","589281506840","11960","49271029","52984990","3713961","2024-09"
"418210","신한제10호스팩","7978800000","2180","3660000","3660000","0","2024-09"
"452980","신한제11호스팩","36997085000","1957","18905000","18905000","0","2024-09"
"474660","신한제12호스팩","11702400000","2120","5520000","5520000","0","2024-09"
"474930","신한제13호스팩","7801100000","2155","3620000","3620000","0","2024-09"
"055550","신한지주","28444660806000","56500","503445324","509393214","5947890","2024-09"
"056700","신화인터텍","50421276158","1738","29011091","29135091","124000","2024-09"
"187270","신화콘텍","30999258410","3370","9198593","10143845","945252","2024-09"
"004080","신흥","135034971500","14300","9443005","9500000","56995","2024-09"
"243840","신흥에스이씨","302827369750","7850","38576735","38919035","342300","2024-09"
"257720","실리콘투","2434929360000","40000","60873234","60873234","0","2024-09"
"222800","심텍","543927579160","17080","31845877","31854143","8266","2024-09"
"036710","심텍홀딩스","75389794630","1627","46336690","48350145","2013455","2024-09"
"160980","싸이맥스","117534922000","11500","10220428","10924243","703815","2024-09"
"356890","싸이버원","35983058400","3020","11914920","11916325","1405","2024-09"
"217330","싸이토젠","170714647800","7400","23069547","23129547","60000","2024-09"
"102280","쌍방울","70634046631","269","262580099","262592129","12030","2024-09"
"010280","쌍용정보통신","39920873462","613","65123774","65123786","12","2024-09"
"004770","써니전자","57520772897","1583","36336559","36702884","366325","2024-09"
"208640","썸에이지","36620186802","263","139240254","139240254","0","2024-09"
"222420","쎄노텍","37322847188","821","45460228","45460231","3","2024-09"
"037760","쎄니트","47519765523","1563","30402921","33832921","3430000","2024-09"
"099320","쎄트렉아이","405197286000","37000","10951278","10951278","0","2024-09"
"049960","쎌바이오텍","95130210000","13900","6843900","9400000","2556100","2024-09"
"088280","쏘닉스","42573965400","2460","17306490","17306490","0","2024-09"
"403550","쏘카","585000552660","17830","32809902","32809902","0","2024-09"
"050890","쏠리드","260279310710","4295","60600538","61095231","494693","2024-09"
"109670","씨싸이트","59636755780","10220","5835299","5836602","1303","2024-09"
"066790","씨씨에스","99740030489","1649","60485161","65152039","4666878","2024-09"
"222080","씨아이에스","572400029460","7980","71729327","71729327","0","2024-09"
"004920","씨아이테크","62131649113","1241","50065793","50065793","0","2024-09"
"352480","씨앤씨인터내셔널","755781062400","75600","9997104","10013941","16837","2024-09"
"264660","씨앤지하이테크","121725414900","13050","9327618","9627896","300278","2024-09"
"352700","씨앤투스","77531355180","3030","25587906","27276899","1688993","2024-09"
"458870","씨어스테크놀로지","176602137600","14070","12551680","12551680","0","2024-09"
"297090","씨에스베어링","151075800000","5540","27270000","27270000","0","2024-09"
"112610","씨에스윈드","2440196430900","58900","41429481","42171403","741922","2024-09"
"359090","씨엔알리서치","73385546000","1300","56450420","56450891","471","2024-09"
"115530","씨엔플러스","33301870000","490","67963000","67963000","0","2024-09"
"115480","씨유메디칼","36863411428","766","48124558","48224558","100000","2024-09"
"340810","씨유박스","32800385985","3095","10597863","10597863","0","2024-09"
"376290","씨유테크","56150850000","3180","17657500","17657500","0","2024-09"
"189330","씨이랩","42950602200","7050","6092284","6092284","0","2024-09"
"096530","씨젠","1096943815000","23750","46187108","52225994","6038886","2024-09"
"101240","씨큐브","50451665280","4880","10338456","10340947","2491","2024-09"
"060590","씨티씨바이오","192704726500","8060","23908775","24181020","272245","2024-09"
"308170","씨티알모빌리티","48560400000","5640","8610000","8610000","0","2024-09"
"260930","씨티케이","104959904730","5570","18843789","19341591","497802","2024-09"
"052300","씨티프라퍼티","62733856428","372","168639399","168651433","12034","2024-09"
"413630","씨피시스템","101427481460","2740","37017329","38703425","1686096","2024-09"
"013990","아가방컴퍼니","133596417465","4445","30055437","32887536","2832099","2024-09"
"123860","아나패스","224283177500","18500","12123415","12123415","0","2024-09"
"025980","아난티","404593567070","4565","88629478","88629478","0","2024-09"
"008700","아남전자","101414548950","1315","77121330","77124820","3490","2024-09"
"125210","아모그린텍","110363525100","6690","16496790","16496790","0","2024-09"
"002790","아모레G","1796207366250","23550","76272075","82458180","6186105","2024-09"
"090430","아모레퍼시픽","7308590949000","125100","58421990","58492759","70769","2024-09"
"357580","아모센스","79888279680","7120","11220264","11220264","0","2024-09"
"052710","아모텍","52751291060","3610","14612546","14615109","2563","2024-09"
"074430","아미노로직스","108817459716","1239","87826844","87826844","0","2024-09"
"092040","아미코젠","238998710480","4360","54816218","55018347","202129","2024-09"
"083930","아바코","194672849310","13410","14516991","14912798","395807","2024-09"
"149950","아바텍","157984451300","11420","13834015","15607500","1773485","2024-09"
"036010","아비코전자","70053762180","5270","13292934","13292934","0","2024-09"
"002030","아세아","421820058000","251000","1680558","2115648","435090","2024-09"
"183190","아세아시멘트","414649538400","11040","37558835","38501886","943051","2024-09"
"002310","아세아제지","338840024000","8480","39957550","42782510","2824960","2024-09"
"050860","아세아텍","43752532460","2210","19797526","22500000","2702474","2024-09"
"012170","아센디오","52716817474","509","103569386","103569488","102","2024-09"
"136410","아셈스","90132062880","8480","10628781","11019106","390325","2024-09"
"246720","아스타","65462222500","4825","13567300","13567300","0","2024-09"
"067390","아스트","194055815580","564","344070595","344203992","133397","2024-09"
"159010","아스플로","86337597200","6680","12924790","13334739","409949","2024-09"
"127710","아시아경제","48028016832","1376","34904082","34904082","0","2024-09"
"267850","아시아나IDT","196248000000","17680","11100000","11100000","0","2024-09"
"020560","아시아나항공","732955875400","9850","74411764","74411764","0","2024-09"
"154030","아시아종묘","26602152840","2295","11591352","11591352","0","2024-09"
"227610","아우딘퓨쳐스","49769535348","1404","35448387","35583547","135160","2024-09"
"143160","아이디스","151510741650","15030","10080555","10716390","635835","2024-09"
"054800","아이디스홀딩스","81074170620","9180","8831609","10347756","1516147","2024-09"
"332370","아이디피","48120327010","3815","12613454","13273726","660272","2024-09"
"122900","아이마켓코리아","264300456000","8400","31464340","33428840","1964500","2024-09"
"339950","아이비김영","78748606320","1816","43363770","44946655","1582885","2024-09"
"469750","아이비젼웍스","57073002330","1685","33871218","33936481","65263","2024-09"
"460470","아이빔테크놀로지","81606441700","5410","15084370","15084370","0","2024-09"
"099190","아이센스","565115013700","20450","27633986","27637273","3287","2024-09"
"461300","아이스크림미디어","186685075670","14590","12795413","13063433","268020","2024-09"
"289010","아이스크림에듀","32074739200","2560","12529195","12864037","334842","2024-09"
"214430","아이쓰리시스템","231852178800","33400","6941682","7106760","165078","2024-09"
"040910","아이씨디","91017338580","5580","16311351","18574275","2262924","2024-09"
"368600","아이씨에이치","64365550935","3745","17187063","17538346","351283","2024-09"
"456010","아이씨티케이","101279723360","7660","13221896","13221896","0","2024-09"
"052860","아이앤씨","26680819596","1644","16229209","17862854","1633645","2024-09"
"464500","아이언디바이스","86288622160","6320","13653263","13653263","0","2024-09"
"010780","아이에스동서","650529332800","21550","30186976","30186976","0","2024-09"
"038880","아이에이","65808851976","216","304670611","315334702","10664091","2024-09"
"307180","아이엘사이언스","87752883295","3245","27042491","27042828","337","2024-09"
"101390","아이엠","32014000305","3045","10513629","10548085","34456","2024-09"
"461030","아이엠비디엑스","231433052500","16510","14017750","14017750","0","2024-09"
"451220","아이엠티","73942597290","9390","7874611","7874611","0","2024-09"
"090150","아이윈","37174022496","936","39715836","41875293","2159457","2024-09"
"123010","아이윈플러스","23830175145","735","32422007","32658542","236535","2024-09"
"031310","아이즈비전","45464187197","1861","24429977","25334636","904659","2024-09"
"185490","아이진","81089352000","3000","27029784","27029784","0","2024-09"
"059100","아이컴포넌트","30553147750","4625","6606086","7070860","464774","2024-09"
"262840","아이퀘스트","42343083000","2250","18819148","19290000","470852","2024-09"
"175250","아이큐어","78102641650","2090","37369685","37558368","188683","2024-09"
"052460","아이크래프트","28459887680","2380","11957936","14607936","2650000","2024-09"
"119830","아이텍","124554116700","5850","21291302","21434297","142995","2024-09"
"052770","아이톡시","70776021970","1445","48979946","48979946","0","2024-09"
"124500","아이티센","154774195090","6670","23204527","23204527","0","2024-09"
"372800","아이티아이즈","36381598200","6180","5886990","6026990","140000","2024-09"
"084850","아이티엠반도체","377362271040","18240","20688721","22682934","1994213","2024-09"
"114840","아이패밀리에스씨","359938629600","20900","17221944","17221944","0","2024-09"
"027360","아주IB투자","236110154152","1994","118410308","120945406","2535098","2024-09"
"139990","아주스틸","137361136920","5180","26517594","26517744","150","2024-09"
"032080","아즈텍WB","24243483495","1155","20990029","21491029","501000","2024-09"
"013310","아진산업","110009175570","2835","38803942","38806582","2640","2024-09"
"059120","아진엑스텍","71958559380","7860","9155033","9748596","593563","2024-09"
"158430","아톤","89227782700","4175","21371924","22602474","1230550","2024-09"
"321820","아티스트유나이티드","229775463900","17190","13366810","13366810","0","2024-09"
"001540","안국약품","84671969250","7450","11365365","13042420","1677055","2024-09"
"053800","안랩","517357315200","52800","9798434","11126506","1328072","2024-09"
"065660","안트로젠","152295987450","15650","9731373","9731373","0","2024-09"
"297570","알로이스","37010082042","1069","34621218","34621218","0","2024-09"
"001780","알루코","232876467460","2405","96830132","96830132","0","2024-09"
"260660","알리코제약","60353831820","4020","15013391","15327021","313630","2024-09"
"354320","알멕","206122037250","32250","6391381","6391381","0","2024-09"
"361570","알비더블유","65002110570","2270","28635291","28635291","0","2024-09"
"131370","알서포트","150533678420","2890","52087778","53267083","1179305","2024-09"
"140670","알에스오토메이션","100791860440","10910","9238484","9303140","64656","2024-09"
"096610","알에프세미","51550708615","2965","17386411","17386411","0","2024-09"
"061040","알에프텍","96161751840","3080","31221348","32089259","867911","2024-09"
"148250","알엔투테크놀로지","29594090625","4125","7174325","7391186","216861","2024-09"
"347860","알체라","52406809840","2380","22019668","22019668","0","2024-09"
"196170","알테오젠","20532742930000","386500","53124820","53148528","23708","2024-09"
"123750","알톤","20662895031","1623","12731297","12746297","15000","2024-09"
"085810","알티캐스트","36253786426","1222","29667583","30447327","779744","2024-09"
"043100","알파녹스","22270828320","2795","7968096","7975920","7824","2024-09"
"117670","알파홀딩스","37743429465","945","39940137","39940137","0","2024-09"
"314140","알피바이오","57694446140","6670","8649842","8666361","16519","2024-09"
"291650","압타머사이언스","46271186700","2725","16980252","16980252","0","2024-09"
"293780","압타바이오","224550216000","9080","24730200","24730200","0","2024-09"
"018250","애경산업","433069735800","16850","25701468","26409935","708467","2024-09"
"161000","애경케미칼","521874651060","10810","48277026","48648709","371683","2024-09"
"196300","애니젠","85548264750","14250","6003387","6003387","0","2024-09"
"310200","애니플러스","127226545160","2860","44484806","45520979","1036173","2024-09"
"299910","애닉","32483121920","6880","4721384","4721384","0","2024-09"
"179530","애드바이오텍","32905598400","3600","9140444","9140444","0","2024-09"
"205500","액션스퀘어","56600086650","1090","51926685","51928120","1435","2024-09"
"052790","액토즈소프트","71009555500","6500","10924547","11330638","406091","2024-09"
"290740","액트로","53007617360","5680","9332327","10065011","732684","2024-09"
"238090","앤디포스","97073728690","4265","22760546","23541303","780757","2024-09"
"092600","앤씨앤","28064854692","1146","24489402","25083517","594115","2024-09"
"129890","앱코","57953588880","1210","47895528","50643410","2747882","2024-09"
"174900","앱클론","295007129230","16930","17425111","17425111","0","2024-09"
"255440","야스","103909518090","8610","12068469","13058000","989531","2024-09"
"030960","양지사","129531140100","9430","13736070","15980000","2243930","2024-09"
"102120","어보브반도체","164492577380","9970","16498754","17780753","1281999","2024-09"
"263540","어스앤에어로스페이스","85022108500","5950","14289430","14294091","4661","2023-12"
"238120","얼라인드","42777215600","2975","14378896","14378896","0","2024-09"
"019990","에너토크","59617467910","6230","9569417","9756088","186671","2024-09"
"011090","에넥스","33624552087","567","59302561","59991641","689080","2024-09"
"270660","에브리봇","198514680660","16230","12231342","12231342","0","2024-09"
"038680","에스넷","68986500495","3795","18178261","19549677","1371416","2024-09"
"137310","에스디바이오센서","1143948807100","9350","122347466","124477353","2129887","2024-09"
"217480","에스디생명공학","54756837359","499","109733141","109733141","0","2024-09"
"121890","에스디시스템","19445385498","1463","13291446","13291446","0","2024-09"
"304360","에스바이오메딕스","377040051600","32100","11745796","11745796","0","2024-09"
"389500","에스비비테크","94796022600","15900","5962014","6174904","212890","2024-09"
"042110","에스씨디","72349357308","1497","48329564","48329564","0","2024-09"
"298060","에스씨엠생명과학","41228129150","2015","20460610","20467248","6638","2024-09"
"065420","에스아이리소스","19253603446","269","71574734","71577299","2565","2024-09"
"103230","에스앤더블류","25956000000","3605","7200000","7200000","0","2024-09"
"260970","에스앤디","99800013000","34500","2892754","2892754","0","2024-09"
"101490","에스앤에스텍","479759580000","22900","20950200","21451447","501247","2024-09"
"095910","에스에너지","29252793732","1569","18644228","19504503","860275","2024-09"
"275630","에스에스알","18099152760","3345","5410808","6017989","607181","2024-09"
"031330","에스에이엠티","310193313060","3180","97545067","99995067","2450000","2024-09"
"060540","에스에이티","39486863274","1511","26132934","26133306","372","2024-09"
"351320","에스에이티이엔지","34740736728","1578","22015676","22015886","210","2024-09"
"056190","에스에프에이","650286649800","20700","31414814","35908760","4493946","2024-09"
"080000","에스엔유","59193724980","1730","34216026","34322870","106844","2024-09"
"005850","에스엘","1547463523200","33600","46055462","46448520","393058","2024-09"
"214310","에스엘에너지","22487615640","6120","3674447","3679130","4683","2024-09"
"246250","에스엘에스바이오","48039884780","3130","15348206","15348206","0","2024-09"
"041510","에스엠","1545391575000","67500","22894690","23353627","458937","2024-09"
"010580","에스엠벡셀","136660709640","1230","111106268","111251760","145492","2024-09"
"007820","에스엠코어","96496828470","4935","19553562","20033946","480384","2024-09"
"464080","에스오에스랩","99916098000","5700","17529140","17529140","0","2024-09"
"109610","에스와이","193419940500","4050","47758010","48907400","1149390","2024-09"
"365330","에스와이스틸텍","169885500000","5550","30610000","30610000","0","2024-09"
"012750","에스원","2018471268300","59700","33810239","37999178","4188939","2024-09"
"031860","에스유홀딩스","17770507846","1183","15021562","15026356","4794","2024-09"
"306040","에스제이그룹","56208123120","5970","9415096","9865828","450732","2024-09"
"457940","에스케이증권제10호스팩","7050300000","2130","3310000","3310000","0","2024-09"
"472230","에스케이증권제11호스팩","8683950000","2090","4155000","4155000","0","2024-09"
"473000","에스케이증권제12호스팩","6967550000","2105","3310000","3310000","0","2024-09"
"473950","에스케이증권제13호스팩","9105200000","2060","4420000","4420000","0","2024-09"
"435870","에스케이증권제8호스팩","7830600000","2105","3720000","3720000","0","2024-09"
"455910","에스케이증권제9호스팩","10742800000","2140","5020000","5020000","0","2024-09"
"096630","에스코넥","58033640520","744","78002205","79052205","1050000","2024-09"
"069510","에스텍","90407500000","10750","8410000","10910000","2500000","2024-09"
"234300","에스트래픽","122464956750","4450","27520215","27809848","289633","2024-09"
"039440","에스티아이","299898906450","20350","14737047","15830000","1092953","2024-09"
"098660","에스티오","41934191840","3455","12137248","12500976","363728","2024-09"
"052020","에스티큐브","288727901310","6190","46644249","46694249","50000","2024-09"
"237690","에스티팜","2211845900000","110000","20107690","20107690","0","2024-09"
"050760","에스폴리텍","25063614087","1623","15442769","16334678","891909","2024-09"
"288620","에스퓨얼셀","77470407600","11100","6979316","6979316","0","2024-09"
"443670","에스피소프트","169639181980","7010","24199598","24201392","1794","2024-09"
"317830","에스피시스템스","55023584380","5410","10170718","10773818","603100","2024-09"
"058610","에스피지","494555128000","22300","22177360","22177360","0","2024-09"
"043340","에쎈테크","46645000000","491","95000000","95000000","0","2024-09"
"023960","에쓰씨엔지니어링","64626738012","1902","33978306","33978308","2","2024-09"
"298690","에어부산","279213851680","2395","116581984","116640000","58016","2024-09"
"054630","에이디칩스","12594094838","158","79709461","79709461","0","2024-09"
"200710","에이디테크놀로지","208181080870","16070","12954641","13440822","486181","2024-09"
"096690","에이루트","43948830536","1313","33472072","33477189","5117","2024-09"
"078520","에이블씨엔씨","182099106000","7000","26014158","26014161","3","2024-09"
"298380","에이비엘바이오","1881070939350","39150","48047789","48047789","0","2024-09"
"203400","에이비온","220212259560","8730","25224772","25224772","0","2024-09"
"195990","에이비프로바이오","144906144154","509","284687906","284689721","1815","2024-09"
"003800","에이스침대","291899529250","27650","10556945","11090000","533055","2024-09"
"088800","에이스테크","113689089033","897","126743689","127068928","325239","2024-09"
"241840","에이스토리","64957795000","7000","9279685","9539994","260309","2024-09"
"453860","에이에스텍","139753332000","24800","5635215","5657215","22000","2024-09"
"312610","에이에프더블류","34051828728","1681","20256888","20256888","0","2024-09"
"015260","에이엔피","32436346222","719","45113138","45116894","3756","2024-09"
"172670","에이엘티","82299413250","9290","8858925","8960259","101334","2024-09"
"445090","에이직랜드","350079795000","32500","10771686","10771686","0","2024-09"
"295310","에이치브이엠","176981713970","14870","11901931","11901931","0","2024-09"
"072990","에이치시티","76246839660","10770","7079558","7287341","207783","2024-09"
"239610","에이치엘사이언스","89992444170","17670","5092951","5392115","299164","2024-09"
"462020","에이치엠씨제6호스팩","8863800000","2040","4345000","4345000","0","2024-09"
"477340","에이치엠씨제7호스팩","14997470000","1997","7510000","7510000","0","2024-09"
"148930","에이치와이티씨","44721476000","4600","9722060","10175213","453153","2024-09"
"044780","에이치케이","23957689815","1305","18358383","18505787","147404","2024-09"
"357230","에이치피오","121950518505","2955","41269211","42089487","820276","2024-09"
"355690","에이텀","40591399800","7510","5404980","5404980","0","2024-09"
"071670","에이테크솔루션","65200000000","6520","10000000","10000000","0","2024-09"
"045660","에이텍","112021776900","14850","7543554","8260000","716446","2024-09"
"224110","에이텍모빌리티","66478860950","13550","4906189","5340000","433811","2024-09"
"021080","에이티넘인베스트","114526491750","2490","45994575","48000000","2005425","2024-09"
"200470","에이팩트","119458101780","2820","42361029","42362093","1064","2024-09"
"262260","에이프로","105159792300","7300","14405451","14468152","62701","2024-09"
"007460","에이프로젠","311595008390","1171","266093090","286851768","20758678","2024-09"
"003060","에이프로젠바이오로직스","174654360504","884","197572806","198407845","835039","2024-09"
"397030","에이프릴바이오","516145726800","23550","21917016","21917016","0","2024-09"
"244920","에이플러스에셋","94613195205","4185","22607693","22607693","0","2024-09"
"278470","에이피알","1984308631500","266500","7445811","7622678","176867","2024-09"
"230240","에치에프알","130975264520","9980","13123774","13309000","185226","2024-09"
"230360","에코마케팅","316568371740","10060","31468029","31468029","0","2024-09"
"038870","에코바이오","56051052000","4000","14012763","14014949","2186","2024-09"
"097780","에코볼트","60618652510","895","67730338","67730338","0","2024-09"
"448280","에코아이","201985529350","20450","9877043","9877043","0","2024-09"
"101360","에코앤드림","680848664800","38800","17547646","17786114","238468","2024-09"
"128540","에코캡","35166383142","1353","25991414","26690460","699046","2024-09"
"086520","에코프로","10552702009500","80100","131744095","133138340","1394245","2024-09"
"450080","에코프로머티","8046724667000","116500","69070598","69070598","0","2024-09"
"247540","에코프로비엠","15928359211100","163100","97660081","97801344","141263","2024-09"
"383310","에코프로에이치엔","690647242800","45300","15246076","15304932","58856","2024-09"
"038110","에코플라스틱","117522808650","2925","40178738","41169370","990632","2024-09"
"073540","에프알텍","14820000000","1300","11400000","11400000","0","2024-09"
"064850","에프앤가이드","135897054120","11910","11410332","11410332","0","2024-09"
"036810","에프에스티","374174850000","18750","19955992","21756789","1800797","2024-09"
"173940","에프엔씨엔터","54934638880","3680","14927891","15392808","464917","2024-09"
"083500","에프엔에스테크","79134660000","9900","7993400","8575722","582322","2024-09"
"054940","엑사이엔씨","24714293260","745","33173548","33173548","0","2024-09"
"373110","엑셀세라퓨틱스","71297556860","6530","10918462","10918462","0","2024-09"
"205100","엑셈","129667263632","1802","71957416","71963431","6015","2024-09"
"356680","엑스게이트","139100237250","4875","28533382","28543492","10110","2024-09"
"070300","엑스큐어","44347091580","5310","8351618","8351618","0","2024-09"
"317770","엑스페릭스","79139225700","3450","22938906","22938906","0","2024-09"
"373200","엑스플러스","46104269484","609","75704876","75705657","781","2024-09"
"069920","엑시온그룹","51247050624","1464","35004816","35194116","189300","2024-09"
"092870","엑시콘","142027366240","11360","12502409","13050797","548388","2024-09"
"317870","엔바이오니아","159926900000","18800","8506750","8506750","0","2024-09"
"067570","엔브이에이치코리아","106785052255","2555","41794541","42170000","375459","2024-09"
"236810","엔비티","60156507500","3730","16127750","16975426","847676","2024-09"
"333620","엔시스","104355310900","10100","10332209","10556344","224135","2024-09"
"101400","엔시트론","27288786994","439","62161246","62162413","1167","2024-09"
"036570","엔씨소프트","3858278963000","193100","19980730","21954022","1973292","2024-09"
"078860","엔에스이엔엠","94913040200","9020","10522510","10531054","8544","2024-09"
"422040","엔에이치스팩23호","15143400000","2115","7160000","7160000","0","2024-09"
"437780","엔에이치스팩24호","10663600000","2120","5030000","5030000","0","2024-09"
"438580","엔에이치스팩25호","6598700000","2185","3020000","3020000","0","2024-09"
"439410","엔에이치스팩26호","18304000000","2080","8800000","8800000","0","2024-09"
"440820","엔에이치스팩27호","16302000000","2090","7800000","7800000","0","2024-09"
"451700","엔에이치스팩29호","28771750000","2005","14350000","14350000","0","2024-09"
"466910","엔에이치스팩30호","18200000000","2000","9100000","9100000","0","2024-09"
"481890","엔에이치스팩31호","12785175000","2015","6345000","6345000","0","2024-09"
"265740","엔에프씨","55019888000","6160","8931800","8931800","0","2024-09"
"354200","엔젠바이오","40185065700","2925","13738484","13738484","0","2024-09"
"455900","엔젤로보틱스","363920027350","24350","14945381","14945381","0","2024-09"
"419080","엔젯","92697960060","9180","10097817","10517817","420000","2024-09"
"208860","엔지스테크널러지","41831348265","2205","18971133","18971133","0","2024-09"
"183490","엔지켐생명과학","120474399687","1509","79837243","85065562","5228319","2024-09"
"085310","엔케이","61447770838","779","78880322","79983352","1103030","2024-09"
"182400","엔케이맥스","172744574320","2020","85517116","85518831","1715","2024-09"
"348370","엔켐","3741646140000","180000","20786923","20786923","0","2024-09"
"069410","엔텔스","34904017280","3520","9915914","10244824","328910","2024-09"
"227950","엔투텍","46194686380","446","103575530","103575530","0","2024-09"
"291230","엔피","95687805710","2170","44095763","44095775","12","2024-09"
"198080","엔피디","54268666200","2520","21535185","21535185","0","2024-09"
"048830","엔피케이","21911005284","1172","18695397","18723923","28526","2024-09"
"096870","엘디티","15527280000","2325","6678400","6678400","0","2024-09"
"290650","엘앤씨바이오","424207461700","18700","22684891","22684891","0","2024-09"
"066970","엘앤에프","3312147654900","98700","33557727","36296338","2738611","2024-09"
"156100","엘앤케이바이오","131582437800","6600","19936733","19936743","10","2024-09"
"073110","엘엠에스","36963772920","6390","5784628","8895755","3111127","2024-09"
"083310","엘오티베큠","158564186200","9800","16180019","17810033","1630014","2024-09"
"037950","엘컴텍","104326319052","1236","84406407","84447519","41112","2024-09"
"170920","엘티씨","91936715060","9910","9277166","9805620","528454","2024-09"
"058630","엠게임","122404936920","6580","18602574","19543877","941303","2024-09"
"058970","엠로","548234457500","46250","11853718","11853718","0","2024-09"
"019590","엠벤처투자","104963185182","921","113966542","113966542","0","2024-09"
"169330","엠브레인","38710081240","2180","17756918","18256918","500000","2024-09"
"097520","엠씨넥스","300803891440","17420","17267732","17977732","710000","2024-09"
"373170","엠아이큐브솔루션","40152302100","7970","5037930","5037930","0","2024-09"
"179290","엠아이텍","275108263000","8500","32365678","32365678","0","2024-09"
"009780","엠에스씨","91520000000","5200","17600000","17600000","0","2024-09"
"123040","엠에스오토텍","177945823695","3235","55006437","69172213","14165776","2024-09"
"323230","엠에프엠코리아","6967193212","161","43274492","43274492","0","2024-06"
"032790","엠젠솔루션","61715915744","1442","42798832","42798832","0","2024-09"
"033160","엠케이전자","158447241400","7580","20903330","22066331","1163001","2024-09"
"347890","엠투아이","92262718320","5640","16358638","16913204","554566","2024-09"
"033310","엠투엔","81935683920","2070","39582456","40342231","759775","2024-09"
"259630","엠플러스","120721010000","10000","12072101","12282402","210301","2024-09"
"105550","엣지파운드리","130336781400","2280","57165255","57165255","0","2024-09"
"060850","영림원소프트랩","56429140000","6940","8131000","8131000","0","2024-09"
"014440","영보화학","65812500000","3375","19500000","20000000","500000","2024-09"
"143540","영우디에스피","34862066400","798","43686800","44599895","913095","2024-09"
"111770","영원무역","1821916672200","42600","42767997","44311468","1543471","2024-09"
"009970","영원무역홀딩스","1059527187400","91300","11604898","13635592","2030694","2024-09"
"003520","영진약품","469119144510","2565","182892454","182892731","277","2024-09"
"000670","영풍","639029781000","371500","1720134","1842040","121906","2024-09"
"036560","영풍정밀","356737500000","22650","15750000","15750000","0","2024-09"
"006740","영풍제지","58256991855","1319","44167545","46482148","2314603","2024-09"
"012280","영화금속","39035348355","771","50629505","51664505","1035000","2024-09"
"265560","영화테크","96119170800","9060","10609180","10690180","81000","2024-09"
"012160","영흥","32517234531","477","68170303","101310372","33140069","2024-09"
"036000","예림당","48141638930","2090","23034277","23034277","0","2024-09"
"250930","예선테크","18693169924","572","32680367","33000440","320073","2024-09"
"053280","예스24","173150568360","6930","24985652","25000000","14348","2024-09"
"015360","예스코홀딩스","205273950000","47950","4281000","6000000","1719000","2024-09"
"122640","예스티","396879023750","19690","20156375","20930108","773733","2024-09"
"045060","오공","45573910060","2690","16941974","16941974","0","2024-09"
"080520","오디텍","35602238720","3440","10349488","11746609","1397121","2024-09"
"007310","오뚜기","1384329117500","402500","3439327","4007830","568503","2024-09"
"039830","오로라","58707930600","5940","9883490","10762890","879400","2024-09"
"322310","오로스테크놀로지","155664919800","16900","9210942","9366542","155600","2024-09"
"046120","오르비텍","62241648480","2295","27120544","27449486","328942","2024-09"
"014940","오리엔탈정공","167841759965","3685","45547289","45573661","26372","2024-09"
"002630","오리엔트바이오","54304201708","458","118568126","118583005","14879","2024-09"
"065500","오리엔트정공","38008411692","1198","31726554","31742912","16358","2024-09"
"271560","오리온","3948925921200","99900","39528788","39536132","7344","2024-09"
"001800","오리온홀딩스","973334645540","16180","60156653","62645422","2488769","2024-09"
"010470","오리콤","74154256650","6390","11604735","11975050","370315","2024-09"
"417860","오브젠","43685854040","9860","4430614","4430614","0","2024-09"
"352910","오비고","84799651420","6710","12637802","12637802","0","2024-09"
"053980","오상자이엘","72942977770","3865","18872698","18982783","110085","2024-09"
"036220","오상헬스케어","181404692910","13230","13711617","14489416","777799","2024-09"
"052420","오성첨단소재","151502864562","1818","83334909","86315192","2980283","2024-09"
"039200","오스코텍","1533591457600","40100","38244176","38244176","0","2024-09"
"226400","오스테오닉","124356051320","6280","19801919","20661601","859682","2024-09"
"031510","오스템","35466571742","1354","26193923","28000000","1806077","2024-09"
"368970","오에스피","31496559200","3370","9346160","9346160","0","2024-09"
"138080","오이솔루션","104483170000","10250","10193480","10624095","430615","2024-09"
"080580","오킨스전자","99088041600","5760","17202785","17679298","476513","2024-09"
"067170","오텍","51211508845","3605","14205689","15391605","1185916","2024-09"
"353590","오토앤","65150384200","5060","12875570","12875570","0","2024-09"
"173130","오파스넷","96518821600","7400","13043084","13046473","3389","2024-09"
"440320","오픈놀","46377650000","4730","9805000","9805000","0","2024-09"
"049480","오픈베이스","66894505280","2230","29997536","31422383","1424847","2024-09"
"394280","오픈엣지테크놀로지","269857713450","12350","21850827","21850827","0","2024-09"
"309930","오하임앤컴퍼니","41275404270","2010","20535027","21290990","755963","2024-09"
"244460","올리패스","18290883206","454","40288289","40290730","2441","2024-09"
"226950","올릭스","503356111600","29200","17238223","17238223","0","2024-09"
"057540","옴니시스템","48306092516","814","59344094","61449355","2105261","2024-09"
"131030","옵투스제약","102490304730","6710","15274263","16153162","878899","2024-09"
"082210","옵트론텍","60401982335","2165","27899299","28566538","667239","2024-09"
"109080","옵티시스","33532669350","7050","4756407","5636000","879593","2024-09"
"380540","옵티코어","35426291468","1234","28708502","29779596","1071094","2024-09"
"153710","옵티팜","79804571520","5440","14669958","14669958","0","2024-09"
"432430","와이랩","86052956800","5240","16422320","16422320","0","2024-09"
"338840","와이바이오로직스","180631180680","12230","14769516","14769516","0","2024-09"
"122990","와이솔","171010073940","6180","27671533","28186941","515408","2024-09"
"232140","와이씨","963493770940","12010","80224294","82045350","1821056","2024-09"
"112290","와이씨켐","178451119250","17650","10110545","10110545","0","2024-09"
"065530","와이어블","69557555586","1454","47838759","52860000","5021241","2024-09"
"067900","와이엔텍","117104793730","6470","18099659","18199659","100000","2024-09"
"007530","와이엠","52125527100","2740","19023915","19174452","150537","2024-09"
"155650","와이엠씨","76339563680","4220","18089944","19474358","1384414","2024-09"
"273640","와이엠텍","122571922000","11600","10566545","10966000","399455","2024-09"
"251370","와이엠티","137694076160","8440","16314464","16314464","0","2024-09"
"066430","와이오엠","22038703686","563","39145122","39153476","8354","2024-09"
"209640","와이제이링크","310030291400","21800","14221573","14221573",,"자료 없음"
"273060","와이즈버즈","46271430275","917","50459575","50459582","7","2024-09"
"019210","와이지-원","172905167850","5150","33573819","33573819","0","2024-09"
"122870","와이지엔터테인먼트","697362612800","37600","18546878","18691049","144171","2024-09"
"011690","와이투솔루션","98187125970","2685","36568762","36574394","5632","2024-09"
"332570","와이팜","107681521680","2610","41257288","42233850","976562","2024-09"
"079000","와토스코리아","35818065360","5040","7106759","7200000","93241","2024-09"
"403490","우듬지팜","85584016005","1893","45210785","45212464","1679","2024-09"
"316140","우리금융지주","12185041293960","16410","742537556","742591501","53945","2024-09"
"032820","우리기술","362195008800","2280","158857460","158859048","1588","2024-09"
"041190","우리기술투자","623747959560","8010","77871156","84000000","6128844","2024-09"
"115440","우리넷","79191579230","7570","10461239","10754239","293000","2024-09"
"046970","우리로","48563656683","1119","43399157","43824999","425842","2024-09"
"082850","우리바이오","183636700420","3890","47207378","48456578","1249200","2024-09"
"215360","우리산업","110773137190","12130","9132163","9132163","0","2024-09"
"072470","우리산업홀딩스","57973048030","3070","18883729","18887341","3612","2024-09"
"073560","우리손에프앤지","96932700200","1400","69237643","69237643","0","2024-09"
"037400","우리엔터프라이즈","32544621912","1342","24250836","26223346","1972510","2024-09"
"153490","우리이앤엘","43143972300","853","50579100","51480000","900900","2024-09"
"101170","우림피티에스","68595721380","5190","13216902","13500000","283098","2024-09"
"006980","우성","43147168360","16810","2566756","3090000","523244","2024-09"
"066590","우수AMS","116033811000","3000","38677937","39073104","395167","2024-09"
"017370","우신시스템","128118832480","8240","15548402","18314054","2765652","2024-09"
"103840","우양","65383879860","3995","16366428","16366428","0","2024-09"
"046940","우원개발","43378440000","2400","18074350","18074350","0","2024-09"
"215380","우정바이오","36628848880","2330","15720536","15879576","159040","2024-09"
"065680","우주일렉트로","120014372030","14930","8038471","9530000","1491529","2024-09"
"105840","우진","161315719840","8140","19817656","20323614","505958","2024-09"
"018620","우진비앤지","30187093695","1045","28887171","28889293","2122","2024-09"
"010400","우진아이엔에스","23051070180","3420","6740079","7622000","881921","2024-09"
"457550","우진엔텍","166235108270","17930","9271339","9271339","0","2024-09"
"049800","우진플라임","46000000000","2300","20000000","20000000","0","2024-09"
"016880","웅진","71342779428","918","77715446","79927080","2211634","2024-09"
"095720","웅진씽크빅","194603694703","1727","112683089","115505985","2822896","2024-09"
"396470","워트","149916000000","9300","16120000","16120000","0","2024-09"
"005820","원림","32477345700","15790","2056830","2297970","241140","2024-09"
"307280","원바이오젠","47604602276","1342","35472878","36959013","1486135","2024-09"
"032940","원익","71135337710","3910","18193181","18193230","49","2024-09"
"240810","원익IPS","1425611717000","29300","48655690","49083901","428211","2024-09"
"074600","원익QnC","607252800000","23100","26288000","26288000","0","2024-09"
"104830","원익머트리얼즈","273593600000","21700","12608000","12608000","0","2024-09"
"014190","원익큐브","56030397393","1583","35395071","35399906","4835","2024-09"
"217820","원익피앤이","132504664210","2995","44241958","47454559","3212601","2024-09"
"030530","원익홀딩스","178354316675","2335","76383005","77237981","854976","2024-09"
"012620","원일특강","32824000000","7460","4400000","4400000","0","2024-09"
"382840","원준","223282430700","14700","15189281","15271581","82300","2024-09"
"336570","원텍","538701060780","6030","89336826","89340619","3793","2024-09"
"376980","원티드랩","41212591485","4615","8930139","9754994","824855","2024-09"
"008370","원풍","53189706570","4870","10921911","12000000","1078089","2024-09"
"008290","원풍물산","22215200732","556","39955397","40693679","738282","2024-09"
"101160","월덱스","318662164900","19300","16510993","16510993","0","2024-09"
"336060","웨이버스","69680574400","1447","48155200","48155200","0","2024-09"
"095270","웨이브일렉트로","59338454700","4650","12760958","14971256","2210298","2024-09"
"010600","웰바이오텍","49552926545","545","90922801","90923407","606","2024-09"
"065950","웰크론","63211928720","2320","27246521","28231302","984781","2024-09"
"076080","웰크론한텍","33881872335","1535","22072881","22594156","521275","2024-09"
"043590","웰킵스하이텍","20561870560","770","26703728","27136762","433034","2024-09"
"196700","웹스","19118675664","1331","14364144","14364144","0","2024-09"
"069080","웹젠","483845102300","16420","29466815","34950884","5484069","2024-09"
"053580","웹케시","92962631390","7270","12787157","13636248","849091","2024-09"
"071460","위니아","21802751835","613","35567295","35967295","400000","2024-09"
"377460","위니아에이드","26030247855","1691","15393405","15393405","0","2024-09"
"044340","위닉스","100854427520","6380","15807904","17873425","2065521","2024-09"
"330350","위더스제약","96489660800","7310","13199680","13202139","2459","2024-09"
"348350","위드텍","78286536000","8010","9773600","10183600","410000","2024-09"
"112040","위메이드","1121064285350","33350","33615121","33948483","333362","2024-09"
"101730","위메이드맥스","334757488260","10140","33013559","33295292","281733","2024-09"
"123420","위메이드플레이","79463953240","7640","10401041","11469842","1068801","2024-09"
"065370","위세아이텍","31287648470","4505","6945094","7383954","438860","2024-09"
"038620","위즈코프","37831215702","602","62842551","66546465","3703914","2024-09"
"299900","위지윅스튜디오","221278040504","1306","169431884","171048884","1617000","2024-09"
"036090","위지트","82915640805","703","117945435","118392284","446849","2024-09"
"136540","윈스","153171920160","12390","12362544","13644162","1281618","2024-09"
"097800","윈팩","174558893271","1499","116450229","116450229","0","2024-09"
"192390","윈하이텍","40859466340","3740","10924991","10924991","0","2024-09"
"008600","윌비스","28030540140","426","65799390","67236039","1436649","2024-09"
"335870","윙스풋","19367130942","1161","16681422","16681422","0","2024-09"
"033270","유나이티드제약","325119044900","22100","14711269","16333822","1622553","2024-09"
"014830","유니드","464061137100","69900","6638929","6767600","128671","2024-09"
"446070","유니드비티플러스","45451080675","4445","10225215","10611215","386000","2024-09"
"036200","유니셈","198264197220","6740","29416053","30664223","1248170","2024-09"
"018000","유니슨","120568359824","716","168391564","168391564","0","2024-09"
"000910","유니온","66505496940","4260","15611619","15611619","0","2024-09"
"047400","유니온머티리얼","98700000000","2350","42000000","42000000","0","2024-09"
"203450","유니온커뮤니티","35649675585","2895","12314223","14079007","1764784","2024-09"
"011330","유니켐","142588780761","1587","89848003","96997167","7149164","2024-09"
"077500","유니퀘스트","99576470220","4610","21600102","21794015","193913","2024-09"
"011320","유니크","78635228650","4070","19320695","19320695","0","2024-09"
"086390","유니테스트","186045275550","9150","20332817","21134126","801309","2024-09"
"241690","유니테크노","92866329270","3795","24470706","24470706","0","2024-09"
"142210","유니트론텍","94360850645","4985","18928957","19246092","317135","2024-09"
"088340","유라클","55294968360","12770","4330068","4330068","0","2024-09"
"048430","유라테크","76162130800","6650","11452952","11520000","67048","2024-09"
"206650","유바이오로직스","446814574610","12230","36534307","36534307","0","2024-09"
"089850","유비벨록스","101683040700","6990","14546930","14730199","183269","2024-09"
"084440","유비온","18254052800","926","19712800","19712800","0","2024-09"
"032620","유비케어","193583179230","3815","50742642","52197139","1454497","2024-09"
"264450","유비쿼스","132972524930","13370","9945589","10245706","300117","2024-09"
"078070","유비쿼스홀딩스","162321944620","9830","16512914","18150700","1637786","2024-09"
"002920","유성기업","53603275000","2090","25647500","25947500","300000","2024-09"
"024800","유성티엔에스","66964850640","2005","33398928","37051812","3652884","2024-09"
"000700","유수홀딩스","128129330680","5230","24498916","26041812","1542896","2024-09"
"054930","유신","68550000000","22850","3000000","3000000","0","2024-09"
"069330","유아이디","17718757496","1256","14107291","14191091","83800","2024-09"
"049520","유아이엘","107566228080","5030","21384936","21784936","400000","2024-09"
"435380","유안타제10호스팩","12004350000","2095","5730000","5730000","0","2024-09"
"444920","유안타제11호스팩","10873000000","2075","5240000","5240000","0","2024-09"
"446150","유안타제12호스팩","9802350000","2055","4770000","4770000","0","2024-09"
"449020","유안타제13호스팩","19654600000","2020","9730000","9730000","0","2024-09"
"450940","유안타제14호스팩","9579400000","2110","4540000","4540000","0","2024-09"
"473050","유안타제15호스팩","14230300000","2030","7010000","7010000","0","2024-09"
"474490","유안타제16호스팩","11185300000","2030","5510000","5510000","0","2024-09"
"430700","유안타제9호스팩","11030200000","2105","5240000","5240000","0","2024-09"
"003470","유안타증권","566479502820","2940","192680103","199596576","6916473","2024-09"
"263770","유에스티","49259020605","2095","23512659","23700172","187513","2024-09"
"072130","유엔젤","58334953920","4880","11953884","13195454","1241570","2024-09"
"000220","유유제약","75168516085","4645","16182673","17032351","849678","2024-09"
"388720","유일로보틱스","383690039000","33500","11453434","11453434","0","2024-09"
"340930","유일에너테크","80657024250","2365","34104450","34204450","100000","2024-09"
"023410","유진기업","239885859500","3500","68538817","77310863","8772046","2024-09"
"056080","유진로봇","212318780320","5660","37512152","37512152","0","2024-09"
"468760","유진스팩10호","9094800000","2145","4240000","4240000","0","2024-09"
"442130","유진스팩9호","7698500000","2225","3460000","3460000","0","2024-09"
"084370","유진테크","769614374000","34600","22243190","22916042","672852","2024-09"
"240600","유진테크놀로지","46554243050","6790","6856295","6928151","71856","2024-09"
"001200","유진투자증권","386183604725","4205","91839145","96866418","5027273","2024-09"
"221800","유투바이오","40069545800","3550","11287196","11287196","0","2024-09"
"179900","유티아이","352821523900","22300","15821593","16286895","465302","2024-09"
"263050","유틸렉스","91435276800","2485","36794880","36798858","3978","2024-09"
"000100","유한양행","11460198105500","155300","73793935","80209064","6415129","2024-09"
"003460","유화증권","103179791275","2255","45756005","56702415","10946410","2024-09"
"191410","육일씨엔에쓰","19237705835","1717","11204255","11204255","0","2024-09"
"372170","윤성에프앤씨","424485353600","53200","7979048","7979048","0","2024-09"
"146060","율촌","29777284360","1240","24013939","24015595","1656","2024-09"
"008730","율촌화학","675800000000","27250","24800000","24800000","0","2024-09"
"072770","율호","160845578760","2290","70238244","70238244","0","2024-09"
"008250","이건산업","51326307280","5020","10224364","10952635","728271","2024-09"
"039020","이건홀딩스","71800317615","3315","21659221","22584709","925488","2024-09"
"025820","이구산업","153827629400","4600","33440789","33442000","1211","2024-09"
"067920","이글루","53086798830","5070","10470769","10996119","525350","2024-09"
"044960","이글벳","63829464400","5200","12274897","12641883","366986","2024-09"
"303530","이노뎁","54120721900","7610","7111790","7339299","227509","2024-09"
"296640","이노룰스","29471536160","5830","5055152","5178252","123100","2024-09"
"302430","이노메트리","94737341000","9640","9827525","9833208","5683","2024-09"
"214320","이노션","800000000000","20000","40000000","40000000","0","2024-09"
"462350","이노스페이스","190795372900","20350","9375694","9375694","0","2024-09"
"274400","이노시뮬레이션","42383456920","5420","7819826","7819826","0","2024-09"
"056090","이노시스","123156905025","1309","94084725","94084725","0","2024-09"
"073490","이노와이어리스","124094766720","16320","7603846","7603846","0","2024-09"
"215790","이노인스트루먼트","19174435728","476","40282428","40283149","721","2024-09"
"344860","이노진","22648452000","1894","11958000","12030000","72000","2024-09"
"088390","이녹스","109438824440","11660","9385834","9385844","10","2024-09"
"272290","이녹스첨단소재","452924688500","23500","19273391","20227658","954267","2024-09"
"053350","이니텍","69348618415","4135","16771129","19790916","3019787","2024-09"
"452400","이닉스","109310707400","12050","9071428","9071428","0","2024-09"
"264850","이랜시스","179041156920","5910","30294612","30294612","0","2024-09"
"054210","이랜텍","144095040990","5790","24886881","25291210","404329","2024-09"
"009730","이렘","46504923790","1010","46044479","46056774","12295","2024-09"
"164060","이루다","148702994160","7090","20973624","21200934","227310","2024-06"
"065440","이루온","34102540620","1290","26436078","27275020","838942","2024-09"
"139480","이마트","1679629733100","62700","26788353","27875819","1087466","2024-09"
"115610","이미지스","55392867425","3515","15758995","15758995","0","2024-09"
"478110","이베스트스팩6호","10140400000","2020","5020000","5020000","0","2024-09"
"131400","이브이첨단소재","136749121830","2295","59585674","59589882","4208","2024-09"
"351330","이삭엔지니어링","66805471200","8060","8288520","8288520","0","2024-09"
"080010","이상네트웍스","49707336920","5240","9486133","9835071","348938","2024-09"
"457190","이수스페셜티케미컬","1350224771500","45100","29938465","30208280","269815","2024-09"
"086890","이수앱지스","239108205780","6660","35902133","35902133","0","2024-09"
"007660","이수페타시스","2744894584600","43400","63246419","63246419","0","2024-09"
"005950","이수화학","179943083900","8150","22078906","22722739","643833","2024-09"
"015020","이스타코","27184780341","699","38890959","42851600","3960641","2024-09"
"047560","이스트소프트","129804938670","12630","10277509","11603992","1326483","2024-09"
"239340","이스트에이드","47079335690","1745","26979562","26979634","72","2024-09"
"067010","이씨에스","32344902000","2840","11389050","12294000","904950","2024-09"
"093230","이아이디","354065768064","1392","254357592","254384360","26768","2024-09"
"418620","이에이트","144757155000","15000","9650477","9650477","0","2024-09"
"456070","이엔셀","261004747500","24500","10653255","10653255","0","2024-09"
"102710","이엔에프테크놀로지","261753155520","18320","14287836","14287836","0","2024-09"
"074610","이엔플러스","117913189503","1607","73374729","73374729","0","2024-09"
"041520","이엘씨","67498158170","5770","11698121","12188730","490609","2024-09"
"063760","이엘피","21631687000","2450","8829260","9325130","495870","2024-09"
"123570","이엠넷","53809885080","2520","21353129","22276078","922949","2024-09"
"083470","이엠앤아이","28786205778","1349","21338922","21340329","1407","2024-09"
"095190","이엠코리아","97664108660","2155","45319772","45319772","0","2024-09"
"091120","이엠텍","438049194700","26650","16437118","17132936","695818","2024-09"
"102460","이연제약","307761828980","16780","18340991","18586811","245820","2024-09"
"039030","이오테크닉스","2039212780500","168500","12102153","12319550","217397","2024-09"
"294090","이오플로우","164352558600","5400","30435659","30435659","0","2024-09"
"088290","이원컴포텍","38537428890","1230","31331243","31331669","426","2024-09"
"084680","이월드","247442706610","1745","141800978","141806193","5215","2024-09"
"353810","이지바이오","116563213200","3485","33447120","34191720","744600","2024-09"
"099750","이지케어텍","112239263800","16700","6720914","6834776","113862","2024-09"
"377330","이지트로닉스","48720179200","6160","7909120","8139954","230834","2024-09"
"035810","이지홀딩스","169029873780","2620","64515219","65145845","630626","2024-09"
"160600","이큐셀","106346383500","3100","34305285","34482552","177267","2024-09"
"092130","이크레더블","154158080000","12800","12043600","12043600","0","2024-09"
"096040","이트론","245561522409","271","906131079","906131295","216","2024-09"
"134060","이퓨쳐","15790243740","4105","3846588","4769250","922662","2024-09"
"001840","이화공영","48717264360","2460","19803766","19805760","1994","2024-09"
"000760","이화산업","34384000000","12280","2800000","2800000","0","2024-09"
"024810","이화전기","196810080587","899","218921113","218948640","27527","2024-09"
"014990","인디에프","54830292700","730","75109990","75112995","3005","2024-09"
"041830","인바디","308084931550","23650","13026847","13683782","656935","2024-09"
"352940","인바이오","25321810900","2330","10867730","10867730","0","2024-09"
"101140","인바이오젠","93257770480","9340","9984772","10044216","59444","2024-09"
"079950","인베니아","17432000000","800","21790000","23200000","1410000","2024-09"
"389470","인벤티지랩","211676761400","21100","10032074","10032074","0","2024-09"
"277410","인산가","52958920710","1405","37693182","38356789","663607","2024-09"
"060150","인선이엔티","258180428160","5760","44822991","46563612","1740621","2024-09"
"033230","인성정보","103220628060","2060","50107101","50515380","408279","2024-09"
"450520","인스웨이브시스템즈","50877839880","3460","14704578","14704578","0","2024-09"
"006490","인스코비","250553713995","2115","118465113","119368998","903885","2024-09"
"465480","인스피언","160379553040","15820","10137772","10137772",,"자료 없음"
"037330","인지디스플레","63676920388","1579","40327372","43885224","3557852","2024-09"
"100030","인지소프트","46426159000","16900","2747110","3283714","536604","2024-09"
"023800","인지컨트롤스","99354965350","6550","15168697","15809197","640500","2024-09"
"034590","인천도시가스","105110974500","25500","4121999","4374754","252755","2024-09"
"211050","인카금융서비스","250068843520","5120","48841571","51379800","2538229","2024-09"
"083640","인콘","27066022776","351","77111176","77720351","609175","2024-09"
"064090","인크레더블버즈","208413432440","4190","49740676","49742745","2069","2024-09"
"216050","인크로스","80387465400","6660","12070190","12843222","773032","2024-09"
"049070","인탑스","325292076350","20450","15906703","17200000","1293297","2024-09"
"119610","인터로조","312050211300","24900","12532137","13216478","684341","2024-09"
"017250","인터엠","20913567411","1033","20245467","21045467","800000","2024-09"
"129260","인터지스","62494302380","2215","28214132","29747874","1533742","2024-09"
"051370","인터플렉스","235374192480","10090","23327472","23327472","0","2024-09"
"064290","인텍플러스","172747602560","13940","12392224","12863962","471738","2024-09"
"189300","인텔리안테크","521407800000","50000","10428156","10733334","305178","2024-09"
"150840","인트로메딕","251537720850","5850","42997901","42997901","0","2024-09"
"048530","인트론바이오","197302655250","6030","32720175","34150762","1430587","2024-09"
"023810","인팩","72800000000","7280","10000000","10000000","0","2024-09"
"115310","인포바인","42851020000","20000","2142551","3192883","1050332","2024-09"
"039290","인포뱅크","51130397430","6130","8341011","8693978","352967","2024-09"
"071200","인피니트헬스케어","112131683800","4600","24376453","24396458","20005","2024-09"
"101930","인화정공","236170871300","24850","9503858","9615733","111875","2024-09"
"249420","일동제약","414516311440","14840","27932366","28062501","130135","2024-09"
"000230","일동홀딩스","92933900700","8230","11292090","11540400","248310","2024-09"
"013360","일성건설","67152925840","1243","54024880","54024880","0","2024-09"
"003120","일성아이에스","109187081460","16020","6815673","13300000","6484327","2024-09"
"333430","일승","91428423420","2980","30680679","30726747","46068","2024-09"
"068330","일신바이오","52262654532","1254","41676758","44216140","2539382","2024-09"
"003200","일신방직","172962577200","8120","21300810","23280000","1979190","2024-09"
"007110","일신석재","105690598650","1365","77429010","77456610","27600","2024-09"
"007570","일양약품","237960189760","13240","17972824","19085664","1112840","2024-09"
"178780","일월지엠엘","124101377000","8650","14346980","14349195","2215","2024-09"
"008500","일정실업","14994719730","12690","1181617","1200000","18383","2024-09"
"019540","일지테크","54372013490","4115","13213126","13513500","300374","2024-09"
"081000","일진다이아","178896438000","12600","14198130","14202975","4845","2024-09"
"020760","일진디스플","48312401673","939","51450907","51513741","62834","2024-09"
"103590","일진전기","1227689676750","25750","47677269","47685390","8121","2024-09"
"094820","일진파워","139628845340","9260","15078709","15078709","0","2024-09"
"271940","일진하이솔루스","748051714000","20600","36313190","36313190","0","2024-09"
"015860","일진홀딩스","177274245135","3855","45985537","49347483","3361946","2024-09"
"226320","잇츠한불","215099723850","12210","17616685","21929315","4312630","2024-09"
"049550","잉크테크","78425108000","4000","19606277","19606277","0","2024-09"
"389020","자람테크놀로지","198702655200","32400","6132798","6197730","64932","2024-09"
"254120","자비스","59458761120","1936","30712170","30754270","42100","2024-09"
"043910","자연과환경","71095187658","627","113389454","113391457","2003","2024-09"
"234920","자이글","50748469380","3780","13425521","13530910","105389","2024-09"
"289220","자이언트스텝","171001088850","7730","22121745","22121745","0","2024-09"
"317400","자이에스앤디","152640642600","4005","38112520","38782520","670000","2024-09"
"033240","자화전자","335064802800","15890","21086520","22155870","1069350","2024-09"
"174880","장원테크","11454988050","2650","4322637","4381265","58628","2024-09"
"049630","재영솔루텍","53120425255","635","83654213","83654213","0","2024-09"
"417840","저스템","57163583360","8060","7092256","7249175","156919","2024-09"
"000950","전방","22128507400","19420","1139470","1680000","540530","2024-09"
"079900","전진건설로봇","250223019600","17230","14522520","15360574","838054","2024-09"
"110020","전진바이오팜","22420435950","2475","9058762","9058762","0","2024-09"
"208140","정다운","83998486520","2570","32684236","32684246","10","2024-09"
"040420","정상제이엘에스","96354885900","6450","14938742","15677552","738810","2024-09"
"045510","정원엔시스","27702362160","880","31479957","32209292","729335","2024-09"
"217190","제너셈","67259564580","7670","8769174","8769174","0","2024-09"
"095700","제넥신","425234989300","9350","45479678","45540494","60816","2024-09"
"072520","제넨바이오","28838655818","389","74135362","74163194","27832","2024-09"
"122310","제노레이","81293939460","6030","13481582","14553844","1072262","2024-09"
"361390","제노코","111461724540","14860","7500789","7500789","0","2024-09"
"187420","제노포커스","74459010345","3145","23675361","23675361","0","2024-09"
"225220","제놀루션","54800035875","3035","18056025","19190021","1133996","2024-09"
"123330","제닉","153520339320","19620","7824686","7968680","143994","2024-09"
"381620","제닉스","130086040000","29750","4372640","4372640","0","2024-09"
"159580","제로투세븐","85940008440","4290","20032636","20032636","0","2024-09"
"147830","제룡산업","119508348960","6240","19151979","20000000","848021","2024-09"
"033100","제룡전기","946075890100","58900","16062409","16062409","0","2024-09"
"079370","제우스","374332124200","12200","30682961","31016990","334029","2024-09"
"054950","제이브이엠","243605023200","21150","11517968","12089892","571924","2024-09"
"023440","제이스코홀딩스","101177267240","1724","58687510","58687510","0","2024-09"
"090470","제이스텍","90741551230","5230","17350201","17476594","126393","2024-09"
"287410","제이시스메디칼","960860460300","12900","74485307","75692193","1206886","2024-06"
"137950","제이씨케미칼","101336556045","4695","21583931","22267814","683883","2024-09"
"033320","제이씨현시스템","70372517475","3725","18891951","19114432","222481","2024-09"
"417500","제이아이테크","111874421760","3540","31602944","32784744","1181800","2024-09"
"204270","제이앤티씨","1343966024550","23550","57068621","57848466","779845","2024-09"
"194370","제이에스코퍼레이션","208702305300","15670","13318590","13335601","17011","2024-09"
"026040","제이에스티나","25067908250","1750","14324519","16503790","2179271","2024-09"
"452160","제이엔비","58565684730","6090","9616697","9617527","830","2024-09"
"126880","제이엔케이글로벌","88038867400","3800","23168123","23204903","36780","2024-09"
"322510","제이엘케이","189888632640","11970","15863712","16195712","332000","2024-09"
"033050","제이엠아이","30183682944","948","31839328","32579342","740014","2024-09"
"094970","제이엠티","54815799520","3280","16712134","16748240","36106","2024-09"
"418550","제이오","529395596700","17900","29575173","31772273","2197100","2024-09"
"025620","제이준코스메틱","23579866660","5270","4474358","4484846","10488","2024-09"
"420570","제이투케이바이오","98106907520","17170","5713856","5732807","18951","2024-09"
"089790","제이티","44233340800","4840","9139120","10315513","1176393","2024-09"
"030000","제일기획","1843272795000","18200","101278725","115041225","13762500","2024-09"
"052670","제일바이오","56184286080","2080","27011676","29129064","2117388","2024-09"
"271980","제일약품","217844179150","14950","14571517","14704872","133355","2024-09"
"412540","제일엠앤에스","232787514500","11300","20600665","20600665","0","2024-09"
"001560","제일연마","56285620000","8270","6806000","9900000","3094000","2024-09"
"199820","제일일렉트릭","215978400000","9720","22220000","22220000","0","2024-09"
"038010","제일테크노스","55051920000","6620","8316000","9000000","684000","2024-09"
"002620","제일파마홀딩스","136778523750","8910","15351125","15973355","622230","2024-09"
"276730","제주맥주","30273051750","2550","11871785","11886605","14820","2024-09"
"080220","제주반도체","426428096640","12660","33683104","34442833","759729","2024-09"
"006220","제주은행","268917838380","8370","32128774","32128774","0","2024-09"
"089590","제주항공","709025776800","8800","80571111","80640985","69874","2024-09"
"216080","제테마","356818004820","19980","17858759","17858759","0","2024-09"
"229000","젠큐릭스","38414892600","2520","15244005","15244005","0","2024-09"
"082270","젬백스","910654072200","22950","39679916","39994174","314258","2024-09"
"044060","조광ILI","70075958688","732","95732184","95732184","0","2024-09"
"004910","조광페인트","63658950760","6220","10234558","12800000","2565442","2024-09"
"004700","조광피혁","187594334400","52800","3552923","6649138","3096215","2024-09"
"001550","조비","56590925200","10900","5191828","5192239","411","2024-09"
"462520","조선내화","200250364600","16900","11849134","11855168","6034","2024-09"
"120030","조선선재","91143848500","94100","968585","1257651","289066","2024-09"
"034940","조아제약","43712535897","1411","30979827","30979827","0","2024-09"
"067000","조이시티","115550396238","1653","69903446","69903446","0","2024-09"
"018470","조일알미늄","211854869233","1673","126631721","126631721","0","2024-09"
"002600","조흥","103320000000","172200","600000","600000","0","2024-09"
"185750","종근당","1421843824100","112700","12616183","13174420","558237","2024-09"
"063160","종근당바이오","171710516700","31300","5485959","5485962","3","2024-09"
"001630","종근당홀딩스","283253201000","59500","4760558","5009861","249303","2024-09"
"033340","좋은사람들","60303247076","622","96950558","96950558","0","2024-09"
"036930","주성엔지니어링","1304605659600","27600","47268321","47268321","0","2024-09"
"109070","주성코퍼레이션","216476814300","4100","52799223","52810230","11007","2024-09"
"044380","주연테크","20561599709","359","57274651","59199244","1924593","2024-09"
"072020","중앙백신","102849367680","10730","9585216","9658687","73471","2024-09"
"000440","중앙에너비스","100426362750","22650","4433835","6227130","1793295","2024-09"
"051980","중앙첨단소재","1246684375000","12500","99734750","99961003","226253","2024-09"
"228760","지노믹트리","407831904000","17000","23990112","24362333","372221","2024-09"
"314130","지놈앤컴퍼니","132288786600","4280","30908595","30908595","0","2024-09"
"013890","지누스","430689380900","21100","20411819","20735204","323385","2024-09"
"389030","지니너스","49794304585","1493","33351845","33351845","0","2024-09"
"043610","지니뮤직","132212621450","2275","58115438","58115438","0","2024-09"
"263860","지니언스","83680629300","9700","8626869","9444600","817731","2024-09"
"303030","지니틱스","44562981544","1247","35736152","35745668","9516","2024-09"
"036180","지더블유바이텍","53929030348","577","93464524","93464524","0","2024-09"
"208350","지란지교시큐리티","24061346100","3075","7824828","8838549","1013721","2024-09"
"144510","지씨셀","545485218300","36300","15027141","15800344","773203","2024-09"
"358570","지아이이노베이션","647790931150","14650","44217811","44217811","0","2024-09"
"382480","지아이텍","93177010665","2385","39067929","39357140","289211","2024-09"
"382800","지앤비에스 에코","106596608170","3370","31631041","31631041","0","2024-09"
"051160","지어소프트","139749066600","9620","14526930","15474430","947500","2024-09"
"053050","지에스이","109604667035","3655","29987597","29987597","0","2024-09"
"119850","지엔씨에너지","78601770690","5270","14914947","16448909","1533962","2024-09"
"065060","지엔코","35055012850","325","107861578","108008044","146466","2024-09"
"204840","지엘팜텍","85704682390","1115","76865186","76865206","20","2024-09"
"013870","지엠비코리아","75049421800","3935","19072280","19072280","0","2024-09"
"071320","지역난방공사","551727151600","47650","11578744","11578744","0","2024-09"
"270520","지오릿에너지","161172647790","1015","158790786","158790786","0","2024-09"
"311320","지오엘리먼트","85905153600","6810","12614560","12614560","0","2024-09"
"388050","지투파워","97007461200","5200","18655281","18709437","54156","2024-09"
"088790","진도","22841610240","1835","12447744","12447744","0","2024-09"
"018120","진로발효","117862376840","17810","6617764","6621120","3356","2024-09"
"109820","진매트릭스","76263102660","3820","19964163","20393640","429477","2024-09"
"086060","진바이오텍","30309266240","3520","8610587","8610587","0","2024-09"
"036890","진성티이씨","175672474680","8790","19985492","22482268","2496776","2024-09"
"363250","진시스템","67027658880","9880","6784176","7006491","222315","2024-09"
"003780","진양산업","84110000000","6470","13000000","13000000","0","2024-09"
"007370","진양제약","63449160840","5590","11350476","12574867","1224391","2024-09"
"010640","진양폴리","66400000000","6640","10000000","10000000","0","2024-09"
"100250","진양홀딩스","177188075640","3170","55895292","55895292","0","2024-09"
"051630","진양화학","43055000000","2725","15800000","15800000","0","2024-09"
"272450","진에어","519974367060","10090","51533634","52200000","666366","2024-09"
"285800","진영","44304833820","2535","17477252","17477270","18","2024-09"
"011000","진원생명과학","198376483935","2485","79829571","80039035","209464","2024-09"
"002780","진흥기업","117057959270","805","145413614","145471745","58131","2024-09"
"085660","차바이오텍","1008028529700","17900","56314443","56314443","0","2024-09"
"261780","차백신연구소","110517961760","4120","26824748","26824748","0","2024-09"
"351870","차이커뮤니케이션","128548497000","11550","11129740","11131089","1349","2024-09"
"009310","참엔지니어링","33336579580","395","84396404","84867419","471015","2024-09"
"094850","참좋은여행","63513803665","4745","13385417","14000000","614583","2024-09"
"004650","창해에탄올","72990316620","9620","7587351","9190885","1603534","2024-09"
"278280","천보","554094000000","55800","9930000","10000000","70000","2024-09"
"000650","천일고속","57938392400","40600","1427054","1429220","2166","2024-09"
"362320","청담글로벌","135431397280","6730","20123536","20551290","427754","2024-09"
"012600","청호ICT","116119947330","2490","46634517","46634517","0","2024-09"
"066360","체리부로","37354619685","779","47952015","47952015","0","2024-09"
"033250","체시스","43712000000","1366","32000000","32000000","0","2024-09"
"047820","초록뱀미디어","131865872400","5400","24419606","24453930","34324","2024-09"
"094360","칩스앤미디어","268620536000","13280","20227450","20823124","595674","2024-09"
"016920","카스","29071419377","1183","24574319","26493538","1919219","2024-09"
"284620","카이노스메드","131240581760","4720","27805208","28180793","375585","2024-09"
"035720","카카오","16896783673000","38500","438877498","443530908","4653410","2024-09"
"293490","카카오게임즈","1343374665140","16420","81813317","82667326","854009","2024-09"
"323410","카카오뱅크","10791169012950","22650","476431303","476963637","532334","2024-09"
"377300","카카오페이","3351938051400","24900","134615986","134615986","0","2024-09"
"140430","카티스","50938940780","3185","15993388","17922947","1929559","2024-09"
"042000","카페24","612916584150","25350","24178169","24253054","74885","2024-09"
"006380","카프로","618528628380","3660","168996893","168999996","3103","2024-09"
"313760","캐리","51299151960","7010","7317996","7417913","99917","2024-09"
"317530","캐리소프트","26815346030","3905","6866926","6971196","104270","2024-09"
"071850","캐스텍코리아","53252758910","2195","24260938","24529188","268250","2024-09"
"050110","캠시스","81368419011","1111","73238901","73824118","585217","2024-09"
"452300","캡스톤파트너스","38976490700","2765","14096380","14096380","0","2024-09"
"451760","컨텍","138699579540","9410","14739594","14940476","200882","2024-09"
"078340","컴투스","426032058300","37300","11421771","12737755","1315984","2024-09"
"063080","컴투스홀딩스","136515465000","20700","6594950","6595192","242","2024-09"
"307930","컴퍼니케이","80703700000","5170","15610000","15610000","0","2024-09"
"079190","케스피온","22976146540","610","37665814","38355514","689700","2024-09"
"263700","케어랩스","58975936160","3040","19399979","19414200","14221","2024-09"
"214370","케어젠","840250547150","17150","48994201","53715000","4720799","2024-09"
"221980","케이디켐","47185500600","12600","3744881","4034800","289919","2024-09"
"038530","케이바이오","30953153388","268","115496841","115714347","217506","2024-09"
"001620","케이비아이동국실업","64104785856","576","111293031","111293031","0","2024-09"
"424140","케이비제21호스팩","16692150000","2165","7710000","7710000","0","2024-09"
"192250","케이사인","65517422949","957","68461257","70671257","2210000","2024-09"
"431190","케이쓰리아이","45517567360","6080","7486442","7486442","0","2024-09"
"029460","케이씨","228407855020","19660","11617897","13554044","1936147","2024-09"
"115500","케이씨에스","82560000000","6880","12000000","12000000","0","2024-09"
"281820","케이씨텍","725072823200","36200","20029636","20861556","831920","2024-09"
"089150","케이씨티","38501750000","2245","17150000","17150000","0","2024-09"
"025880","케이씨피드","44119455120","2795","15785136","16715858","930722","2024-09"
"093320","케이아이엔엑스","352605417300","72900","4836837","4880000","43163","2024-09"
"093640","케이알엠","157545187200","4835","32584320","32584320","0","2024-09"
"073010","케이에스피","160277576000","4000","40069394","40191250","121856","2024-09"
"105330","케이엔더블유","65386060360","4120","15870403","16060028","189625","2024-09"
"053080","케이엔솔","206817596160","15960","12958496","12999807","41311","2024-09"
"199430","케이엔알시스템","86941704000","8000","10867713","10867713","0","2024-09"
"432470","케이엔에스","142522955080","16430","8674556","8674556","0","2024-09"
"272110","케이엔제이","135931607100","16980","8005395","8005395","0","2024-09"
"039420","케이엘넷","56636769900","2650","21372366","24154730","2782364","2024-09"
"083550","케이엠","39213002400","3400","11533236","12374226","840990","2024-09"
"032500","케이엠더블유","277153345680","6960","39820883","39820883","0","2024-09"
"225430","케이엠제약","20385405041","731","27887011","27887050","39","2024-09"
"102370","케이옥션","130476981600","5040","25888290","27229210","1340920","2024-09"
"068100","케이웨더","34507405770","3545","9734106","9939614","205508","2024-09"
"381970","케이카","631666977030","13110","48182073","48182073","0","2024-09"
"036030","케이티알파","209556827775","4275","49019141","49019283","142","2024-09"
"064820","케이프","144530951040","5180","27901728","30901728","3000000","2024-09"
"256940","케이피에스","108179756660","5770","18748658","18748658","0","2024-09"
"024880","케이피에프","80691109620","4170","19350386","20682798","1332412","2024-09"
"042040","케이피엠테크","56171686704","322","174446232","174460917","14685","2024-09"
"054410","케이피티유","22562189360","3940","5726444","5726444","0","2024-09"
"258610","케일럼","41914999980","1580","26528481","26787133","258652","2024-09"
"274090","켄코아에어로스페이스","129132260000","10000","12913226","12913226","0","2024-09"
"089010","켐트로닉스","302580249300","20300","14905431","15334346","428915","2024-09"
"220260","켐트로스","133322625840","5020","26558292","26558307","15","2024-09"
"052400","코나아이","200961827840","13760","14604784","14899999","295215","2024-09"
"402030","코난테크놀로지","171678791120","14990","11452888","11452888","0","2024-09"
"391710","코닉오토메이션","89433508540","2155","41500468","41503222","2754","2024-09"
"046070","코다코","144219271360","10280","14029112","14064588","35476","2024-09"
"047770","코데즈컴바인","54925171845","1455","37749259","37842602","93343","2024-09"
"080530","코디","69778265172","1617","43152916","43300427","147511","2024-09"
"104540","코렌텍","85153028400","6660","12785740","12785740","0","2024-09"
"027050","코리아나","79407000000","2595","30600000","40000000","9400000","2024-09"
"007810","코리아써키트","244238565340","10340","23620751","23620751","0","2024-09"
"190650","코리아에셋투자증권","35645040000","5580","6388000","6388000","0","2024-09"
"123410","코리아에프티","147836023290","5310","27841059","27841064","5","2024-09"
"003690","코리안리","1254719321520","8520","147267526","165367526","18100000","2024-09"
"036690","코맥스","45885746130","2885","15904938","15904938","0","2024-09"
"049430","코메론","98828070000","11000","8984370","9048000","63630","2024-09"
"183300","코미코","540979950000","52500","10304380","10460684","156304","2024-09"
"041960","코미팜","297224327400","4290","69283060","70622233","1339173","2024-09"
"089890","코세스","150057218400","9150","16399696","16584962","185266","2024-09"
"360350","코셈","43901047800","7740","5671970","5671970","0","2024-09"
"082660","코스나인","47827116000","480","99639825","99640869","1044","2024-09"
"192820","코스맥스","1586123547600","139800","11345662","11349509","3847","2024-09"
"044820","코스맥스비티아이","82267163790","8610","9554839","9603921","49082","2024-09"
"222040","코스맥스엔비티","61870056360","3010","20554836","20628000","73164","2024-09"
"241710","코스메카코리아","804204000000","75300","10680000","10680000","0","2024-09"
"005070","코스모신소재","3506641668400","107900","32498996","32510756","11760","2024-09"
"005420","코스모화학","824833718500","21500","38364359","38408228","43869","2024-09"
"355150","코스텍시스","60269676180","7980","7552591","7797350","244759","2024-09"
"071950","코아스","31821262400","9670","3290720","3290720","0","2024-09"
"166480","코아스템켐온","351273060180","14420","24360129","32870376","8510247","2024-09"
"045970","코아시아","112726512585","4545","24802313","26314876","1512563","2024-09"
"196450","코아시아씨엠","43360015347","957","45308271","45319582","11311","2024-09"
"384470","코어라인소프트","99702347850","7770","12831705","12832064","359","2024-09"
"029960","코엔텍","357068292000","7350","48580720","50000000","1419280","2024-09"
"002020","코오롱","185482197940","14690","12626426","12626426","0","2024-09"
"138490","코오롱ENP","223060000000","5870","38000000","38000000","0","2024-09"
"003070","코오롱글로벌","170855500380","9060","18858223","18932713","74490","2024-09"
"450140","코오롱모빌리티그룹","142595230650","2325","61331282","62777250","1445968","2024-09"
"102940","코오롱생명과학","234056611080","18840","12423387","12423387","0","2024-09"
"120110","코오롱인더","902397896800","32800","27512131","27519091","6960","2024-09"
"021240","코웨이","4774766431200","66400","71909133","73799619","1890486","2024-09"
"033290","코웰패션","127705475840","2410","52989824","56156301","3166477","2024-09"
"056360","코위버","45178395840","4880","9257868","9796800","538932","2024-09"
"282880","코윈테크","153465606950","14050","10922819","11141807","218988","2024-09"
"121850","코이즈","29486760936","971","30367416","30614175","246759","2024-09"
"448710","코츠테크놀로지","92982783050","20950","4438319","5166069","727750","2024-09"
"126730","코칩","107930848660","13180","8188987","8503460","314473","2024-09"
"015710","코콤","66889686110","4030","16597937","17530500","932563","2024-09"
"052330","코텍","99572909040","7920","12572337","15574552","3002215","2024-09"
"322780","코퍼스코리아","35382065250","959","36894750","37932613","1037863","2024-09"
"036420","콘텐트리중앙","195821709250","10250","19104557","19262308","157751","2024-09"
"200130","콜마비앤에이치","424524285360","14580","29116892","29415558","298666","2024-09"
"024720","콜마홀딩스","243160476310","7090","34296259","34296259","0","2024-09"
"031820","콤텍시스템","68273026824","564","121051466","121051466","0","2024-09"
"294570","쿠콘","140219516250","13750","10197783","10254685","56902","2024-09"
"192400","쿠쿠홀딩스","722572451250","23250","31078385","35562185","4483800","2024-09"
"284740","쿠쿠홈시스","522441454000","23300","22422380","22437330","14950","2024-09"
"317690","퀀타매트릭스","131472417450","7950","16537411","16537411","0","2024-09"
"078940","퀀타피아","151577916950","2855","53092090","53094278","2188","2024-09"
"227100","퀀텀온","18565846976","1184","15680614","15680614","0","2024-09"
"432720","퀄리타스반도체","140317646720","10160","13810792","13810792","0","2024-09"
"365270","큐라클","83382547680","6010","13873968","13873968","0","2024-09"
"348080","큐라티스","35323384380","838","42152010","42152010","0","2024-09"
"060280","큐렉소","281877331400","6860","41089990","41089990","0","2024-09"
"372320","큐로셀","460042581250","32650","14090125","14090125","0","2024-09"
"051780","큐로홀딩스","19278533156","142","135764318","136422450","658132","2024-09"
"115180","큐리언트","170476848960","5280","32287282","32292671","5389","2024-09"
"445680","큐리옥스바이오시스템즈","408857145200","25400","16096738","16096738","0","2024-09"
"182360","큐브엔터","194722349960","14020","13888898","14571557","682659","2024-09"
"405100","큐알티","161546632500","13700","11791725","12289301","497576","2024-09"
"066310","큐에스아이","62848164850","7030","8939995","9271621","331626","2024-09"
"016600","큐캐피탈","50610806380","290","174520022","178247112","3727090","2024-09"
"355390","크라우드웍스","50151550680","11880","4221511","4224606","3095","2024-09"
"264900","크라운제과","101296304670","8430","12016169","12523850","507681","2024-09"
"005740","크라운해태홀딩스","84282827100","5860","14382735","14847347","464612","2024-09"
"259960","크래프톤","15476552074500","340500","45452429","47897003","2444574","2024-09"
"096240","크레버스","134800999860","15980","8435607","11138180","2702573","2024-09"
"040350","크레오에스지","108297829962","714","151677633","152074086","396453","2024-09"
"110790","크리스에프앤씨","133671892200","6600","20253317","23430960","3177643","2024-09"
"045520","크린앤사이언스","32236590000","5270","6117000","6500000","383000","2024-09"
"036170","클라우드에어","53281073872","884","60272708","61365626","1092918","2024-09"
"214150","클래시스","3935970418500","61500","63999519","63999519","0","2024-09"
"352770","클리노믹스","25105979808","653","38447136","38886113","438977","2024-09"
"237880","클리오","440744268450","25150","17524623","18071353","546730","2024-09"
"139670","키네마스터","41156331150","2915","14118810","14118810","0","2024-09"
"020120","키다리스튜디오","132315595440","3570","37063192","37063766","574","2024-09"
"413600","키움제6호스팩","9346750000","2725","3430000","3430000","0","2024-09"
"433530","키움제7호스팩","9441500000","2300","4105000","4105000","0","2024-09"
"446840","키움제8호스팩","13171200000","2240","5880000","5880000","0","2024-09"
"039490","키움증권","3325301545800","137800","24131361","25526706","1395345","2024-09"
"054780","키이스트","86461247625","4425","19539265","19547793","8528","2024-09"
"219130","타이거일렉","132915804500","21050","6314290","6314290","0","2024-09"
"360070","탑머티리얼","285840760800","35700","8006744","8076743","69999","2024-09"
"065130","탑엔지니어링","65163823200","4200","15515196","17189982","1674786","2024-09"
"134580","탑코미디어","51300664500","2370","21645850","22025767","379917","2024-09"
"014580","태경비케이","123158541500","4465","27583100","27583100","0","2024-09"
"015890","태경산업","152281787500","5210","29228750","29228750","0","2024-09"
"006890","태경케미컬","128299736680","11320","11333899","11600000","266101","2024-09"
"023160","태광","358261301700","13850","25867242","26500000","632758","2024-09"
"003240","태광산업","549585043000","653000","841631","1113400","271769","2024-09"
"011280","태림포장","149725088175","2175","68839121","70805940","1966819","2024-09"
"323280","태성","1101254134500","42650","25820730","25820730","0","2024-09"
"053620","태양","50552546850","6350","7961031","8600000","638969","2024-09"
"004100","태양금속","111639130900","3065","36423860","36700000","276140","2024-09"
"009410","태영건설","1330097939940","4620","287899987","287905337","5350","2024-09"
"044490","태웅","293908426890","14690","20007381","20007381","0","2024-09"
"124560","태웅로직스","104334824840","2885","36164584","38416584","2252000","2024-09"
"001420","태원물산","27939137670","3810","7333107","7600000","266893","2024-09"
"191420","테고사이언스","119457964720","14920","8006566","8108834","102268","2024-09"
"073640","테라사이언스","59577565530","654","91097195","95587404","4490209","2024-09"
"066700","테라젠이텍스","118899982985","3715","32005379","32474435","469056","2024-09"
"095610","테스","286097396060","16310","17541226","19768226","2227000","2024-09"
"055490","테이팩스","82085676500","17210","4769650","4769650","0","2024-09"
"064520","테크엘","52511976700","2350","22345522","22351062","5540","2024-09"
"089030","테크윙","1279508969200","35800","35740474","37353645","1613171","2024-09"
"054450","텔레칩스","189830266560","12860","14761296","15144233","382937","2024-09"
"078000","텔코웨어","50607229400","9800","5164003","9240077","4076074","2024-09"
"200230","텔콘RF제약","70707138180","588","120250235","120250235","0","2024-09"
"214420","토니모리","196001738200","8200","23902651","24054799","152148","2024-09"
"393210","토마토시스템","102587634850","6670","15380455","15614544","234089","2024-09"
"215480","토박스코리아","23745250800","2650","8960472","9400000","439528","2024-09"
"051360","토비스","301951282620","19770","15273206","16167058","893852","2024-09"
"045340","토탈소프트","43474843200","5080","8558040","8558040","0","2024-09"
"108230","톱텍","198938310480","5460","36435588","38023245","1587657","2024-09"
"079970","투비소프트","9068790612","1084","8366043","9290500","924457","2024-09"
"199800","툴젠","456798860000","57500","7944328","7946828","2500","2024-09"
"417790","트루엔","91912472980","8780","10468391","10999650","531259","2024-09"
"290090","트윔","57552009420","8220","7001461","7432268","430807","2024-09"
"026150","특수건설","96680283810","5510","17546331","17546331","0","2024-09"
"464280","티디에스팜","88212180000","16680","5288500","5530000","241500","2024-09"
"322180","티라유텍","98125681500","5940","16519475","16519475","0","2024-09"
"117730","티로보틱스","135740026600","7610","17837060","17837060","0","2024-09"
"033830","티비씨","78842732100","834","94535650","100000000","5464350","2024-09"
"057680","티사이언티픽","67899821453","953","71248501","71248501","0","2024-09"
"204610","티쓰리","79124935050","1350","58611063","63851720","5240657","2024-09"
"064760","티씨케이","1023897500000","87700","11675000","11675000","0","2024-09"
"246710","티앤알바이오팹","157938249240","7330","21546828","21546828","0","2024-09"
"340570","티앤엘","606208026100","75100","8072011","8128000","55989","2024-09"
"043220","티에스넥스젠","71670643282","511","140255662","140255662","0","2024-09"
"277880","티에스아이","129835758080","6440","20160832","20160832","0","2024-09"
"131290","티에스이","539276000000","50000","10785520","11061429","275909","2024-09"
"019180","티에이치엔","58230000000","3235","18000000","18000000","0","2024-09"
"425420","티에프이","197490060000","17460","11311000","11381000","70000","2024-09"
"131100","티엔엔터테인먼트","42598096247","1519","28043513","28048252","4739","2024-09"
"356860","티엘비","121962422400","12480","9772630","9832630","60000","2024-09"
"062860","티엘아이","42843237000","5800","7386765","9872720","2485955","2024-09"
"363280","티와이홀딩스","124270619850","3510","35404735","50429268","15024533","2024-09"
"321550","티움바이오","164481115760","6320","26025493","26025493","0","2024-09"
"091810","티웨이항공","611092981400","2840","215173585","215378976","205391","2024-09"
"004870","티웨이홀딩스","67636377504","606","111611184","111611693","509","2024-09"
"425040","티이엠씨","195243048390","9230","21153093","21316062","162969","2024-09"
"241790","티이엠씨씨엔에스","57892084520","5960","9713437","10002634","289197","2024-09"
"104480","티케이케미칼","133616287980","1470","90895434","90895434","0","2024-09"
"081150","티플랙스","75232046200","3100","24268402","24268402","0","2024-09"
"130740","티피씨글로벌","21831650544","1936","11276679","11276679","0","2024-09"
"084730","팅크웨어","106888309200","10200","10479246","11109424","630178","2024-09"
"440110","파두","961446590720","19520","49254436","49334436","80000","2024-09"
"034230","파라다이스","914555841750","10590","86360325","91771623","5411298","2024-09"
"033540","파라텍","54710950842","1462","37421991","37751063","329072","2024-09"
"388870","파로스아이바이오","131895812400","10200","12930962","12930962","0","2024-09"
"043200","파루","22986002600","550","41792732","41804315","11583","2024-09"
"214450","파마리서치","2348133400000","227000","10344200","10464152","119952","2024-09"
"208340","파멥신","233760977175","2915","80192445","80201108","8663","2024-09"
"005690","파미셀","319221354480","5320","60004014","60016964","12950","2024-09"
"177830","파버나인","37005507470","3110","11898877","14288753","2389876","2024-09"
"037070","파세코","119633388150","5990","19972185","20000000","27815","2024-09"
"150900","파수","56475805000","5000","11295161","11676422","381261","2024-09"
"037030","파워넷","53808418860","2460","21873341","21878974","5633","2024-09"
"047310","파워로직스","191474248650","5230","36610755","36610755","0","2024-09"
"368770","파이버프로","133228966875","4075","32694225","32854225","160000","2024-09"
"170790","파이오링크","54042081810","8090","6680109","6856330","176221","2024-09"
"049120","파인디앤씨","56497427252","1211","46653532","46653532","0","2024-09"
"038950","파인디지털","31491659520","3840","8200953","10210765","2009812","2024-09"
"441270","파인엠텍","261767091240","7080","36972753","36987901","15148","2024-09"
"106240","파인테크닉스","17062251650","1075","15871862","15923057","51195","2024-09"
"131760","파인텍","33616045242","774","43431583","43431583","0","2024-09"
"065690","파커스","14277176487","1071","13330697","14049331","718634","2024-09"
"140860","파크시스템스","1463922642000","211000","6938022","6983609","45587","2024-09"
"091700","파트론","355704055000","7000","50814865","58918214","8103349","2024-09"
"032800","판타지오","37249153971","163","228522417","229785294","1262877","2024-09"
"318010","팜스빌","54946918980","7110","7728118","7929338","201220","2024-09"
"036580","팜스코","76341062480","2180","35018836","36727943","1709107","2024-09"
"027710","팜스토리","146105586781","1321","110602261","111416600","814339","2024-09"
"004720","팜젠사이언스","89050779650","4910","18136615","18178525","41910","2024-09"
"225590","패션플랫폼","23020586918","899","25606882","26636713","1029831","2024-09"
"054300","팬스타엔터프라이즈","32611359886","487","66963778","66985895","22117","2024-09"
"068050","팬엔터테인먼트","58140362350","2150","27042029","27694076","652047","2024-09"
"028670","팬오션","1919104548080","3590","534569512","534569512","0","2024-09"
"222110","팬젠","55931946700","4900","11414683","11414683","0","2024-09"
"271830","팸텍","63707564220","2220","28697101","29490202","793101","2024-09"
"010820","퍼스텍","141653949855","2915","48594837","48771938","177101","2024-09"
"016800","퍼시스","395096230800","44150","8948952","11500000","2551048","2024-09"
"263750","펄어비스","2235666524000","36400","61419410","64247855","2828445","2024-09"
"251970","펌텍코리아","466179313600","37600","12398386","12400000","1614","2024-09"
"001020","페이퍼코리아","133085268536","748","177921482","177983313","61831","2024-09"
"168360","펨트론","131135829440","6160","21288284","21288284","0","2024-09"
"087010","펩트론","1978063682900","96100","20583389","20657350","73961","2024-09"
"090080","평화산업","55066965777","1003","54902259","54902259","0","2024-09"
"010770","평화홀딩스","40576870020","2820","14388961","14625466","236505","2024-09"
"064800","포니링크","191468674040","1519","126049160","127807298","1758138","2024-09"
"119500","포메탈","32461415680","2740","11847232","11847232","0","2024-09"
"389140","포바이포","61800468800","5600","11035798","11112735","76937","2024-09"
"105760","포스뱅크","64990096950","6870","9459985","9459985","0","2024-09"
"022100","포스코DX","4152345894650","27350","151822519","152034729","212210","2024-09"
"058430","포스코스틸리온","227642420000","38000","5990590","6000000","9410","2024-09"
"009520","포스코엠텍","676226438160","16240","41639559","41642703","3144","2024-09"
"047050","포스코인터내셔널","8743802183100","51300","170444487","175922788","5478301","2024-09"
"003670","포스코퓨처엠","17848828352000","230500","77435264","77463220","27956","2024-09"
"189690","포시에스","62821246785","2305","27254337","27321969","67632","2024-09"
"318020","포인트모바일","54402618780","4365","12463372","12662272","198900","2024-09"
"256630","포인트엔지니어링","78090222784","1372","56917072","57997072","1080000","2024-09"
"331380","포커스에이치엔에스","83331059680","3740","22281032","22725452","444420","2024-09"
"472850","폰드그룹","214710887280","6640","32335977","32343933","7956","2024-09"
"039980","폴라리스AI","170096928795","2385","71319467","72152777","833310","2024-09"
"041910","폴라리스AI파마","88857642720","7120","12480006","12698263","218257","2024-09"
"234100","폴라리스세원","72151920438","1326","54413213","54413213","0","2024-09"
"041020","폴라리스오피스","243450585700","4900","49683793","49725498","41705","2024-09"
"114630","폴라리스우노","41112099931","541","75992791","77757548","1764757","2024-09"
"290720","푸드나무","39654483175","3175","12489601","13403058","913457","2024-09"
"005670","푸드웰","49121218970","5210","9428257","10000000","571743","2024-09"
"094940","푸른기술","50670171830","6410","7904863","8361386","456523","2024-09"
"057880","푸른소나무","215672327790","8790","24536101","24580368","44267","2024-09"
"007330","푸른저축은행","103470999600","8830","11718120","15082800","3364680","2024-09"
"017810","풀무원","386327960400","10480","36863355","38120542","1257187","2024-09"
"093380","풍강","28764666000","3000","9588222","9879313","291091","2024-08"
"023900","풍국주정","129150000000","10250","12600000","12600000","0","2024-09"
"103140","풍산","1805473775800","66100","27314278","28024278","710000","2024-09"
"005810","풍산홀딩스","369700742400","26400","14003816","14417292","413476","2024-09"
"371950","풍원정밀","247856948640","11780","21040488","21040488","0","2024-09"
"370090","퓨런티어","122400176800","14960","8181830","8181830","0","2024-09"
"445180","퓨릿","111179716440","6630","16769188","16769188","0","2024-09"
"151910","퓨처코어","121645902080","640","190071722","190071722","0","2024-09"
"220100","퓨쳐켐","630867294400","28550","22096928","22102155","5227","2024-09"
"035200","프럼파스트","23869912560","2820","8464508","9730590","1266082","2024-09"
"334970","프레스티지바이오로직스","450190753080","7320","61501469","61501469","0","2024-09"
"321260","프로이천","62022516600","2200","28192053","28192084","31","2024-09"
"053610","프로텍","289350000000","32150","9000000","11000000","2000000","2024-09"
"303360","프로티아","38438486775","2985","12877215","12877215","0","2024-09"
"377220","프롬바이오","57893950000","2045","28310000","28310000","0","2024-09"
"335810","프리시젼바이오","42334947270","3645","11614526","11614526","0","2024-09"
"053160","프리엠스","66084903720","12330","5359684","6000000","640316","2024-09"
"405000","플라즈맵","52153688000","2000","26076844","26076844","0","2024-09"
"041590","플래스크","103917099150","789","131707350","131707350","0","2024-09"
"367000","플래티어","39542635120","4880","8102999","8388207","285208","2024-09"
"075130","플랜티넷","32073668520","2060","15569742","16622320","1052578","2024-09"
"009810","플레이그램","53005381865","349","151877885","151887500","9615","2024-09"
"237820","플레이디","71062355600","5540","12827140","12827140","0","2024-09"
"023770","플레이위드","40546542500","4625","8766820","8766820","0","2024-09"
"019570","플루토스","20880980848","398","52464776","52470040","5264","2024-09"
"300080","플리토","92237394700","16780","5496865","5501817","4952","2024-09"
"033790","피노","191838660000","8450","22702800","22822800","120000","2024-09"
"032580","피델릭스","52618776833","1589","33114397","33132064","17667","2024-09"
"051380","피씨디렉트","38806406625","2625","14783393","15340072","556679","2024-09"
"241820","피씨엘","66035915172","1116","59171967","59171967","0","2024-09"
"237750","피앤씨테크","30956299000","4765","6496600","6496600","0","2024-09"
"460940","피앤에스미캐닉스","81479206600","12590","6471740","6471740","0","2024-09"
"319660","피에스케이","614094336800","21200","28966714","28966714","0","2024-09"
"031980","피에스케이홀딩스","1080275989500","50100","21562395","21562395","0","2024-09"
"002230","피에스텍","60246218475","3645","16528455","19370673","2842218","2024-09"
"043370","피에이치에이","197480783430","10110","19533213","21000000","1466787","2024-09"
"239890","피엔에이치테크","70941290700","7140","9935755","9935755","0","2024-09"
"347740","피엔케이피부임상연구센타","73359749140","2540","28881791","30010576","1128785","2024-09"
"137400","피엔티","1218160406400","52400","23247336","23743086","495750","2024-09"
"257370","피엔티엠에스","69042537380","5620","12285149","12504861","219712","2024-09"
"147760","피엠티","37274438370","3445","10819866","10819866","0","2024-09"
"128660","피제이메탈","84083420910","3390","24803369","24803369","0","2024-09"
"006140","피제이전자","77743950000","5230","14865000","15000000","135000","2024-09"
"376180","피코그램","51693822180","2810","18396378","18491378","95000","2024-09"
"304840","피플바이오","80656255030","3835","21031618","21089464","57846","2024-09"
"087600","픽셀플러스","46526981580","7180","6480081","8166558","1686477","2024-09"
"291810","핀텔","23226521040","2045","11357712","11357712","0","2024-09"
"378340","필에너지","354622794120","16660","21285882","21285882","0","2024-09"
"161580","필옵틱스","494554847000","21650","22843180","22843180","0","2024-09"
"347770","핌스","52799767020","2310","22857042","22857042","0","2024-09"
"163730","핑거","109780694550","11950","9186669","9360608","173939","2024-09"
"417180","핑거스토리","46030806250","2750","16738475","16739405","930","2024-09"
"446750","하나26호스팩","12964500000","2150","6030000","6030000","0","2024-09"
"448370","하나27호스팩","11998700000","2135","5620000","5620000","0","2024-09"
"454750","하나28호스팩","15052180000","2090","7202000","7202000","0","2024-09"
"454640","하나29호스팩","11558140000","2140","5401000","5401000","0","2024-09"
"469880","하나30호스팩","15157875000","2075","7305000","7305000","0","2024-09"
"469900","하나31호스팩","11686425000","2085","5605000","5605000","0","2024-09"
"475240","하나32호스팩","6960000000","2175","3200000","3200000","0","2024-09"
"475250","하나33호스팩","7881000000","2130","3700000","3700000","0","2024-09"
"406760","하나금융21호스팩","15449850000","2085","7410000","7410000","0","2024-09"
"418170","하나금융22호스팩","13642700000","2270","6010000","6010000","0","2024-09"
"435620","하나금융25호스팩","44654760000","10380","4302000","4302000","0","2024-09"
"086790","하나금융지주","18222706627200","65600","277785162","287240880","9455718","2024-09"
"299030","하나기술","225456462000","28200","7994910","7994910","0","2024-09"
"067310","하나마이크론","716619366400","10900","65744896","65744896","0","2024-09"
"166090","하나머티리얼즈","572945847600","29400","19487954","19777674","289720","2024-09"
"293480","하나제약","190294346000","11000","17299486","17772946","473460","2024-09"
"039130","하나투어","772947606800","49900","15489932","16039185","549253","2024-09"
"136480","하림","300509725060","2830","106187182","106209702","22520","2024-09"
"003380","하림지주","518402094730","5330","97261181","112005621","14744440","2024-09"
"450330","하스","67703117760","8640","7836009","7836009","0","2024-09"
"101670","하이드로리튬","89594775280","1816","49336330","51086330","1750000","2024-09"
"365590","하이딥","129862197900","900","144291331","144447309","155978","2024-09"
"149980","하이로닉","122315187000","7320","16709725","18594363","1884638","2024-09"
"013030","하이록코리아","299544671250","24750","12102815","12856050","753235","2024-09"
"352820","하이브","7835595913600","188800","41502097","41652097","150000","2024-09"
"126700","하이비젼시스템","211938366150","16650","12729031","14942112","2213081","2024-09"
"106080","하이소닉","104633487350","6650","15734359","15735465","1106","2024-09"
"071090","하이스틸","64789198710","3210","20183551","20191471","7920","2024-09"
"450050","하이제8호스팩","10479260000","2090","5014000","5014000","0","2024-09"
"160190","하이젠알앤엠","229239360000","8220","27888000","30888000","3000000","2024-09"
"221840","하이즈항공","34820444582","1862","18700561","18700561","0","2024-09"
"106190","하이텍팜","151727173460","14270","10632598","10633173","575","2024-09"
"019490","하이트론","120570309475","4015","30029965","30044269","14304","2024-09"
"000080","하이트진로","1372988540000","20000","68649427","70133611","1484184","2024-09"
"000140","하이트진로홀딩스","195289106220","9140","21366423","23206765","1840342","2024-09"
"065650","하이퍼코퍼레이션","147092450550","1381","106511550","106681728","170178","2024-09"
"066130","하츠","64465835070","5370","12004811","12800000","795189","2024-09"
"004590","한국가구","55425000000","3695","15000000","15000000","0","2024-09"
"036460","한국가스공사","3552110163800","40700","87275434","92313000","5037566","2024-09"
"039340","한국경제TV","115470893940","5430","21265358","23000000","1734642","2024-09"
"005430","한국공항","163308467400","53400","3058211","3166355","108144","2024-09"
"071050","한국금융지주","4087234757500","77500","52738513","55725992","2987479","2024-09"
"034950","한국기업평가","379174035000","85000","4460871","4540514","79643","2024-09"
"010040","한국내화","78670366440","2220","35437102","41067062","5629960","2024-09"
"025540","한국단자","728239000000","70600","10315000","10415000","100000","2024-09"
"222980","한국맥널티","44532625600","4100","10861616","11031483","169867","2024-09"
"010100","한국무브넥스","110535024600","3630","30450420","30450420","0","2024-09"
"256840","한국비엔씨","372751692720","5610","66444152","67912443","1468291","2024-09"
"219750","한국비티비","63245329550","967","65403650","65426885","23235","2024-09"
"004090","한국석유","218022748300","17300","12602471","12694120","91649","2024-09"
"025550","한국선재","61833404880","2795","22122864","23300000","1177136","2024-09"
"002200","한국수출포장","98122772880","2640","37167717","40000000","2832283","2024-09"
"002960","한국쉘석유","416000000000","320000","1300000","1300000","0","2024-09"
"017890","한국알콜","190164679320","9240","20580593","21605760","1025167","2024-09"
"000240","한국앤컴퍼니","1565690920320","16530","94718144","94935240","217096","2024-09"
"080720","한국유니온제약","15410411825","2725","5655197","7912828","2257631","2024-09"
"123890","한국자산신탁","360370976975","2945","122367055","123977752","1610697","2024-09"
"015760","한국전력","13513343820850","21050","641964077","641964077","0","2024-09"
"063570","한국전자금융","154381573120","5090","30330368","34147728","3817360","2024-09"
"041460","한국전자인증","66529723125","3515","18927375","19000000","72625","2024-09"
"006200","한국전자홀딩스","32628779928","744","43855887","46803136","2947249","2024-09"
"101680","한국정밀기계","20838867120","2480","8402769","8404000","1231","2024-09"
"039740","한국정보공학","21288844035","2655","8018397","8018397","0","2024-09"
"053300","한국정보인증","164699694430","4010","41072243","42441361","1369118","2024-09"
"025770","한국정보통신","289235537100","8100","35708091","37444271","1736180","2024-09"
"458610","한국제12호스팩","9200250000","2175","4230000","4230000","0","2024-09"
"464440","한국제13호스팩","9288000000","2150","4320000","4320000","0","2024-09"
"477530","한국제14호스팩","10942750000","2275","4810000","4810000","0","2024-09"
"479880","한국제15호스팩","14117850000","2055","6870000","6870000","0","2024-09"
"027970","한국제지","192432528640","1012","190150720","190178237","27517","2024-09"
"023350","한국종합기술","45985304300","4420","10403915","10950000","546085","2024-09"
"025890","한국주강","22077484296","1981","11144616","11309259","164643","2024-09"
"000970","한국주철관","139606195300","6490","21510970","22800500","1289530","2024-09"
"104700","한국철강","269184295050","7850","34290993","42450000","8159007","2024-09"
"062970","한국첨단소재","19736818000","2000","9868409","9868409","0","2024-09"
"017960","한국카본","531551656800","10800","49217746","51908452","2690706","2024-09"
"023760","한국캐피탈","178887608900","572","312740575","315609576","2869001","2024-09"
"054040","한국컴퓨터","66960808200","4950","13527436","16071290","2543854","2024-09"
"161890","한국콜마","1701926051700","72100","23605077","23605077","0","2024-09"
"021650","한국큐빅","39325215380","2420","16250089","16350563","100474","2024-09"
"161390","한국타이어앤테크놀로지","4562379362200","37400","121988753","123875069","1886316","2024-09"
"034830","한국토지신탁","227727714711","1057","215447223","252489230","37042007","2024-09"
"007280","한국특강","92740299275","1525","60813311","60813311","0","2024-09"
"032300","한국파마","229586056050","21050","10906701","10906701","0","2024-09"
"037230","한국팩키지","59392051711","1993","29800327","29800327","0","2024-09"
"047810","한국항공우주","5224665735200","53600","97475107","97475107","0","2024-09"
"123690","한국화장품","112148155580","6980","16067071","16068000","929","2024-09"
"003350","한국화장품제조","305588090100","84300","3625007","4532000","906993","2024-09"
"030520","한글과컴퓨터","414713263650","17230","24069255","24179744","110489","2024-09"
"052600","한네트","50186458000","4340","11563700","11563700","0","2024-09"
"011500","한농화성","286151114200","18710","15294020","15637042","343022","2024-09"
"002390","한독","218564904040","15880","13763533","13763533","0","2024-09"
"256150","한독크린텍","55817725830","7170","7784899","8395000","610101","2024-09"
"092460","한라IMS","104926425600","6420","16343680","17109680","766000","2024-09"
"053690","한미글로벌","150030362500","14750","10171550","10957550","786000","2024-09"
"042700","한미반도체","9969481088400","104200","95676402","96993634","1317232","2024-09"
"008930","한미사이언스","2461393213100","36350","67713706","68391550","677844","2024-09"
"128940","한미약품","4444415007000","350500","12680214","12810991","130777","2024-09"
"452190","한빛레이저","119973405020","5180","23160889","23162757","1868","2024-09"
"047080","한빛소프트","35098819868","1414","24822362","24822362","0","2024-09"
"009240","한샘","844956389800","50900","16600322","23533928","6933606","2024-09"
"452280","한선엔지니어링","163394025000","9610","17002500","17002500","0","2024-09"
"020000","한섬","352437471540","16410","21476994","23398500","1921506","2024-09"
"003680","한성기업","29031002700","5140","5648055","6209515","561460","2024-09"
"066980","한성크린텍","119444175000","2300","51932250","51935125","2875","2024-09"
"105630","한세실업","622642684590","15810","39382839","40000000","617161","2024-09"
"069640","한세엠케이","43679807480","1592","27437065","30106502","2669437","2024-09"
"016450","한세예스24홀딩스","204256660400","5200","39280127","40000000","719873","2024-09"
"010420","한솔PNS","21927522840","1070","20493012","20493012","0","2024-09"
"009180","한솔로지스틱스","63814509850","2275","28050334","28057025","6691","2024-09"
"114810","한솔아이원스","198133793910","7170","27633723","29113174","1479451","2024-09"
"070590","한솔인티큐브","15739172352","1152","13662476","13879521","217045","2024-09"
"213500","한솔제지","224215865240","9430","23776868","23800576","23708","2024-09"
"014680","한솔케미칼","1435035687000","126600","11335195","11335195","0","2024-09"
"004710","한솔테크닉스","138237074800","4400","31417517","32109878","692361","2024-09"
"004150","한솔홀딩스","94771489890","2310","41026619","42008577","981958","2024-09"
"025750","한솔홈데코","57765211833","717","80565149","80565149","0","2024-09"
"226440","한송네오텍","100580954580","1530","65739186","65739186","0","2024-09"
"042520","한스바이오메드","121947732810","9390","12986979","13526367","539388","2024-09"
"004960","한신공영","78912187640","6820","11570702","11570702","0","2024-09"
"011700","한신기계","108036144340","3340","32346151","32446151","100000","2024-09"
"430690","한싹","56655580800","5200","10895304","10895327","23","2024-09"
"078350","한양디지텍","181760685750","12250","14837607","15244382","406775","2024-09"
"045100","한양이엔지","284556294900","16950","16787982","18000000","1212018","2024-09"
"001750","한양증권","159361245680","12520","12728534","12728534","0","2024-09"
"018880","한온시스템","1995919928200","3740","533668430","533800000","131570","2024-09"
"009420","한올바이오파마","2243929890000","44250","50710280","52240638","1530358","2024-09"
"320000","한울반도체","81939275390","2930","27965623","27965627","4","2024-09"
"091440","한울소재과학","73491907700","5230","14051990","14606671","554681","2024-09"
"014130","한익스프레스","41418000000","3510","11800000","12000000","200000","2024-09"
"024740","한일단조","64339469120","2060","31232752","31532546","299794","2024-09"
"005860","한일사료","165101440150","4190","39403685","39403685","0","2024-09"
"300720","한일시멘트","977972944800","14120","69261540","69261540","0","2024-09"
"002220","한일철강","49194554800","2020","24353740","26697460","2343720","2024-09"
"006390","한일현대시멘트","264982383120","13710","19327672","19327672","0","2024-09"
"003300","한일홀딩스","410058205200","13300","30831444","30832884","1440","2024-09"
"007770","한일화학","43453800000","12380","3510000","3510000","0","2024-09"
"051600","한전KPS","2040750000000","45350","45000000","45000000","0","2024-09"
"052690","한전기술","2602175742000","68400","38043505","38220000","176495","2024-09"
"130660","한전산업","434884000000","13340","32600000","32600000","0","2024-09"
"198940","한주라이트메탈","39658408012","1019","38918948","38922978","4030","2024-09"
"058450","한주에이알티","35664660980","2470","14439134","14452469","13335","2024-09"
"107640","한중엔시에스","382567441500","42750","8948946","8948946","0","2024-09"
"002320","한진","285911925520","19760","14469227","14947628","478401","2024-09"
"003480","한진중공업홀딩스","89878341280","3445","26089504","29529812","3440308","2024-09"
"180640","한진칼","6081749316300","91700","66322239","66762279","440040","2024-09"
"005110","한창","22551214950","1254","17983425","18606407","622982","2024-09"
"079170","한창산업","40066314250","7750","5169847","5200000","30153","2024-09"
"009460","한창제지","45406956846","761","59667486","59667486","0","2024-09"
"372910","한컴라이프케어","113465064600","4100","27674406","27674406","0","2024-09"
"054920","한컴위드","63689249280","2560","24878613","28217081","3338468","2024-09"
"002680","한탑","22518196074","726","31016799","32316799","1300000","2024-09"
"000880","한화","1907840880000","27500","69376032","74958735","5582703","2024-09"
"452260","한화갤러리아","266637467104","1376","193777229","193859610","82381","2024-09"
"088350","한화생명","2197816481250","2925","751390250","868530000","117139750","2024-09"
"000370","한화손해보험","568274393790","4915","115620426","116738915","1118489","2024-09"
"009830","한화솔루션","3556313859000","21000","169348279","171892536","2544257","2024-09"
"272210","한화시스템","3491164182870","18670","186993261","188919389","1926128","2024-09"
"012450","한화에어로스페이스","17618287350000","387500","45466548","45581161","114613","2024-09"
"082740","한화엔진","1324797495800","15880","83425535","83447142","21607","2024-09"
"042660","한화오션","9452353218950","30850","306397187","306413394","16207","2024-09"
"489790","한화인더스트리얼솔루션즈","1999988417400","39700","50377542","50488390","110848","2024-09"
"003530","한화투자증권","759239877400","3550","213870388","214547775","677387","2024-09"
"430460","한화플러스제3호스팩","12580000000","2125","5920000","5920000","0","2024-09"
"455310","한화플러스제4호스팩","10626000000","2100","5060000","5060000","0","2024-09"
"195870","해성디에스","476000000000","28000","17000000","17000000","0","2024-09"
"034810","해성산업","207438840000","7000","29634120","32556857","2922737","2024-09"
"059270","해성에어로보틱스","73529273400","6600","11140799","11140799","0","2024-09"
"076610","해성옵틱스","29641045742","1166","25421137","25453198","32061","2024-09"
"101530","해태제과식품","149559613680","5640","26517662","29116822","2599160","2024-09"
"220180","핸디소프트","58903280000","3035","19408000","19408000","0","2024-09"
"143210","핸즈코퍼레이션","42729485540","1988","21493705","21875747","382042","2024-09"
"214180","헥토이노베이션","153719085960","12420","12376738","13257185","880447","2024-09"
"234340","헥토파이낸셜","140687521220","16930","8309954","9453000","1143046","2024-09"
"084990","헬릭스미스","180734035400","3925","46046888","46092797","45909","2024-09"
"187660","현대ADM","78688895880","3720","21152929","21836250","683321","2024-09"
"000720","현대건설","3357376314750","30150","111355765","111355765","0","2024-09"
"170030","현대공업","81887021580","5460","14997623","15340000","342377","2024-09"
"453340","현대그린푸드","394359315250","11650","33850585","33880914","30329","2024-09"
"086280","현대글로비스","9045000000000","120600","75000000","75000000","0","2024-09"
"064350","현대로템","7094249045000","65000","109142293","109142293","0","2024-09"
"079430","현대리바트","161114758020","8010","20114202","20535282","421080","2024-09"
"012330","현대모비스","22007113213500","244500","90008643","92995094","2986451","2024-09"
"319400","현대무벡스","370779719280","3180","116597396","117741058","1143662","2024-09"
"048410","현대바이오","704404336880","17690","39819352","39821608","2256","2024-09"
"052260","현대바이오랜드","164100000000","5470","30000000","30000000","0","2024-09"
"069960","현대백화점","1015173389700","46450","21855186","23402441","1547255","2024-09"
"004560","현대비앤지스틸","196778483550","13050","15078811","15078811","0","2024-09"
"016790","현대사료","187340898626","994","188471729","188471729","0","2024-09"
"004310","현대약품","113298250830","4335","26135698","32000000","5864302","2024-08"
"041440","현대에버다임","148799878080","8340","17841712","17915944","74232","2024-09"
"039010","현대에이치티","45759410000","5890","7769000","8625000","856000","2024-09"
"017800","현대엘리베이","1615701524500","44750","36105062","39092385","2987323","2024-09"
"307950","현대오토에버","3833751616800","139800","27423116","27423982","866","2024-09"
"011210","현대위아","1263009166200","47400","26645763","27195083","549320","2024-09"
"090850","현대이지웰","119444195830","5030","23746361","23746361","0","2024-09"
"004020","현대제철","3584621387750","27250","131545739","133445785","1900046","2024-09"
"005440","현대지에프홀딩스","694553660955","4455","155904301","155904301","0","2024-09"
"005380","현대차","47799514094500","234500","203835881","209416191","5580310","2024-09"
"001500","현대차증권","287950062960","9080","31712562","31712562","0","2024-09"
"011760","현대코퍼레이션","218839800520","18220","12010966","13228966","1218000","2024-09"
"227840","현대코퍼레이션홀딩스","93421813590","10590","8821701","9100836","279135","2024-09"
"126560","현대퓨처넷","438961119675","3985","110153355","110202945","49590","2024-09"
"001450","현대해상","2383800800000","30400","78414500","89400000","10985500","2024-09"
"057050","현대홈쇼핑","548347225000","47900","11447750","12000000","552250","2024-09"
"460930","현대힘스","361818839040","10240","35333871","35333871","0","2024-09"
"092300","현우산업","54618303165","2985","18297589","18672816","375227","2024-09"
"138360","협진","41310988830","855","48316946","48348248","31302","2024-09"
"011080","형지I&C","15297718200","600","25496197","25503364","7167","2024-09"
"093240","형지엘리트","45710882550","1350","33859913","34164255","304342","2024-09"
"003010","혜인","54386514380","5060","10748323","12712747","1964424","2024-09"
"111110","호전실업","71726518480","7790","9207512","9749984","542472","2024-09"
"008770","호텔신라","1673801757100","45100","37113121","39248121","2135000","2024-09"
"060560","홈센타홀딩스","99647906280","785","126940008","127669525","729517","2024-09"
"064240","홈캐스트","93976637575","2735","34360745","35038012","677267","2024-09"
"039610","화성밸브","107955848000","10370","10410400","10410400","0","2024-09"
"378850","화승알앤에이","77577360810","4085","18990786","18993623","2837","2024-09"
"241590","화승엔터프라이즈","535003307080","8830","60589276","60589276","0","2024-09"
"006060","화승인더","200593725365","4055","49468243","55320000","5851757","2024-09"
"013520","화승코퍼레이션","84103528348","1894","44405242","50051252","5646010","2024-09"
"010690","화신","342272143850","9850","34748441","34920410","171969","2024-09"
"126640","화신정공","47360534410","1351","35055910","36373887","1317977","2024-09"
"133820","화인베스틸","27589375610","895","30826118","30826118","0","2024-09"
"127980","화인써키트","82167059960","6940","11839634","11840684","1050","2024-09"
"061250","화일약품","108824971920","1460","74537652","76877652","2340000","2024-09"
"010660","화천기계","61930000000","2815","22000000","22000000","0","2024-09"
"000850","화천기공","60720000000","27600","2200000","2200000","0","2024-09"
"016580","환인제약","210074883200","13760","15267070","18600070","3333000","2024-09"
"032560","황금에스티","90380320240","5320","16988782","17000000","11218","2024-09"
"004800","효성","825885205600","49400","16718324","16740407","22083","2024-09"
"094280","효성ITX","137758795200","12480","11038365","11558200","519835","2024-09"
"097870","효성오앤비","48681300000","6170","7890000","8490000","600000","2024-09"
"298040","효성중공업","3785222716500","406500","9311741","9324548","12807","2024-09"
"298020","효성티앤씨","1307654070000","303000","4315690","4327682","11992","2024-09"
"298000","효성화학","152313044000","40300","3779480","3791811","12331","2024-09"
"093370","후성","660692253760","6160","107255236","107255330","94","2024-09"
"081660","휠라홀딩스","2428493601600","40800","59521902","60095839","573937","2024-09"
"290270","휴네시온","33571586780","3620","9273919","9607672","333753","2024-09"
"005870","휴니드","100927677900","7710","13090490","14116015","1025525","2024-09"
"353190","휴럼","32328934889","821","39377509","39378420","911","2024-09"
"192410","휴림네트웍스","37826742800","2660","14220580","14235530","14950","2024-09"
"090710","휴림로봇","146941963128","1341","109576408","109623165","46757","2024-09"
"078590","휴림에이텍","33615537692","626","53698942","54210339","511397","2024-09"
"205470","휴마시스","183309220800","1620","113153840","129375009","16221169","2024-09"
"115160","휴맥스","74211968983","1721","43121423","43970124","848701","2024-09"
"028080","휴맥스홀딩스","33081715740","3030","10918058","12577506","1659448","2024-09"
"175140","휴먼테크놀로지","111018906720","5160","21515292","21515292","0","2024-09"
"200670","휴메딕스","327817264200","31800","10308719","11229930","921211","2024-09"
"079980","휴비스","92148896000","2800","32910320","34500000","1589680","2024-09"
"065510","휴비츠","98444949750","9050","10877895","12159371","1281476","2024-09"
"215090","휴센텍","149904424845","1505","99604269","99649272","45003","2024-09"
"005010","휴스틸","226437942250","4030","56188075","56188075","0","2024-09"
"263920","휴엠앤씨","49976991546","1019","49045134","49045134","0","2024-09"
"243070","휴온스","350187314300","29650","11810702","11979665","168963","2024-09"
"084110","휴온스글로벌","455567752850","37450","12164693","12621492","456799","2024-09"
"145020","휴젤","3129278659000","284500","10999222","12604033","1604811","2024-09"
"024060","흥구석유","248647970700","17100","14540817","15000000","459183","2024-09"
"010240","흥국","55353480000","5000","11070696","12322696","1252000","2024-09"
"189980","흥국에프엔비","68719206672","1776","38693247","40137827","1444580","2024-09"
"000540","흥국화재","217140140100","3380","64242645","64242645","0","2024-09"
"003280","흥아해운","484133656630","2015","240264842","240424899","160057","2024-09"
"037440","희림","60597696000","4800","12624520","13922475","1297955","2024-09"
"238490","힘스","49672231500","4475","11099940","11312236","212296","2024-09"