종목코드,종목명,자기주식 제외 시가총액(A*B),종가,자기주식 제외 발행주식수(B=C-D),총발행주식수(C),자기주식수(D),자기주식수 반영시점
"060310","3S","109576557090","2145","51084642","51084642","0","2024-09"
"095570","AJ네트웍스","219727655500","4910","44751050","45252759","501709","2024-09"
"006840","AK홀딩스","158633219200","12160","13045495","13247561","202066","2024-09"
"054620","APS","115739358280","6370","18169444","19894221","1724777","2024-09"
"265520","AP시스템","262551942320","17480","15020134","15281421","261287","2024-09"
"211270","AP위성","145462905420","10220","14233161","15082304","849143","2024-09"
"109960","AP헬스케어","62080147936","544","114117919","114153169","35250","2024-09"
"139050","BF랩스","24234697905","2805","8639821","8644551","4730","2024-09"
"027410","BGF","341680294620","3570","95708766","95716791","8025","2024-09"
"282330","BGF리테일","1946894190500","112700","17275015","17283906","8891","2024-09"
"126600","BGF에코머티리얼즈","208065312000","3360","61924200","62766899","842699","2024-09"
"138930","BNK금융지주","3132893826960","9840","318383519","320436727","2053208","2024-09"
"001460","BYC","199778240000","32000","6243070","6246150","3080","2024-09"
"013720","CBI","48716785032","1093","44571624","44628136","56512","2024-09"
"083790","CG인바이츠","196849105920","2560","76894182","76894182","0","2024-09"
"001040","CJ","2841137775000","105000","27058455","29176998","2118543","2024-09"
"079160","CJ CGV","917313216620","5540","165580003","165580003","0","2024-09"
"035760","CJ ENM","1305965997000","63000","20729619","21929154","1199535","2024-09"
"311690","CJ 바이오사이언스","100237522000","11000","9112502","9112502","0","2024-09"
"000120","CJ대한통운","1805034174500","90500","19945129","22812344","2867215","2024-09"
"011150","CJ씨푸드","114439512005","3185","35930773","35930773","0","2024-09"
"097950","CJ제일제당","4026944846000","274000","14696879","15054186","357307","2024-09"
"051500","CJ프레시웨이","212976252840","17940","11871586","11871586","0","2024-09"
"058820","CMG제약","291673712400","2100","138892244","138892244","0","2024-09"
"023460","CNH","6789438434","206","32958439","37200000","4241561","2024-09"
"056730","CNT85","55701358400","800","69626698","74111186","4484488","2024-09"
"000480","CR홀딩스","233924649840","5670","41256552","46890490","5633938","2024-09"
"065770","CS","19605241300","1010","19411130","19411130","0","2024-09"
"083660","CSA 코스믹","48401117598","817","59242494","61247181","2004687","2024-09"
"000590","CS홀딩스","71114916200","68300","1041214","1154482","113268","2024-09"
"012030","DB","300299997876","1572","191030533","201173933","10143400","2024-09"
"456440","DB금융스팩11호","12091625000","2275","5315000","5315000","0","2024-09"
"477760","DB금융스팩12호","12293200000","2105","5840000","5840000","0","2024-09"
"016610","DB금융투자","219129492820","5380","40730389","42446389","1716000","2024-09"
"005830","DB손해보험","6820938078400","113600","60043469","70800000","10756531","2024-09"
"000990","DB하이텍","1561776558450","37550","41591919","44398588","2806669","2024-09"
"139130","DGB금융지주","1357765509120","8160","166392832","169145833","2753001","2024-09"
"099520","DGI","58000622016","1284","45171824","45281824","110000","2024-09"
"060900","DGP","30531587892","1209","25253588","25258229","4641","2024-09"
"290120","DH오토리드","39951480350","2575","15515138","15515138","0","2024-09"
"025440","DH오토웨어","35398406450","230","153906115","153906120","5","2024-09"
"001530","DI동일","723500089650","37350","19370819","25215672","5844853","2024-09"
"000210","DL","841415225400","40200","20930727","20955884","25157","2024-09"
"375500","DL이앤씨","1174982572400","30550","38460968","38693623","232655","2024-09"
"068790","DMS","127764077280","5430","23529296","24573061","1043765","2024-09"
"007340","DN오토모티브","905241042450","18010","50263245","59065865","8802620","2024-09"
"004840","DRB동일","88171065300","4575","19272364","19930000","657636","2024-09"
"241520","DSC인베스트먼트","74393336000","2845","26148800","27496125","1347325","2024-09"
"155660","DSR","61040000000","3815","16000000","16000000","0","2024-09"
"069730","DSR제강","50400000000","3500","14400000","14400000","0","2024-09"
"017860","DS단석","492944076400","84100","5861404","5861404","0","2024-09"
"180400","DXVX","113695187760","2310","49218696","49219432","736","2024-09"
"017940","E1","432474974800","74800","5781751","6860000","1078249","2024-09"
"245620","EDGC","57441040175","415","138412145","138493951","81806","2024-09"
"037370","EG","61323550920","7110","8624972","8624972","0","2024-09"
"050120","ES큐브","24149574921","1803","13394107","13564086","169979","2024-09"
"383220","F&F","2151980361700","56900","37820393","38307075","486682","2024-09"
"007700","F&F홀딩스","520410974760","13320","39069893","39114367","44474","2024-09"
"214270","FSN","71315917530","2145","33247514","33250463","2949","2024-09"
"130500","GH신소재","44871426805","3085","14545033","14545052","19","2024-09"
"114090","GKL","687835050400","11120","61855670","61855670","0","2024-09"
"078930","GS","3948058537500","42500","92895495","92915378","19883","2024-09"
"083450","GST","292036171000","15700","18601030","18618260","17230","2024-09"
"006360","GS건설","1553466778500","18300","84888895","85581490","692595","2024-09"
"001250","GS글로벌","268521882510","3255","82495202","82533764","38562","2024-09"
"007070","GS리테일","2151515724800","20800","103438256","104717922","1279666","2024-09"
"297890","HB솔루션","277569768630","3795","73140914","73140914","0","2024-09"
"440290","HB인베스트먼트","50554573650","1865","27107010","27107010","0","2024-09"
"078150","HB테크놀러지","204365621400","2300","88854618","92715916","3861298","2024-09"
"012630","HDC","550340846000","11000","50030986","59741721","9710735","2024-09"
"039570","HDC랩스","185403028710","8070","22974353","25957601","2983248","2024-09"
"089470","HDC현대EP","100309869810","3870","25919863","31900000","5980137","2024-09"
"294870","HDC현대산업개발","1341138997000","20900","64169330","65907330","1738000","2024-09"
"009540","HD한국조선해양","13301421903000","188100","70714630","70773116","58486","2024-09"
"267250","HD현대","5745343359000","81300","70668430","78993085","8324655","2024-09"
"267270","HD현대건설기계","875141644950","49550","17661789","18305586","643797","2024-09"
"443060","HD현대마린솔루션","6414135000000","144300","44450000","44450000","0","2024-09"
"071970","HD현대마린엔진","676394171620","19940","33921473","33921495","22","2024-09"
"010620","HD현대미포","4259643026400","106800","39884298","39942149","57851","2024-09"
"322000","HD현대에너지솔루션","255920000000","22850","11200000","11200000","0","2024-09"
"042670","HD현대인프라코어","1249915797680","6490","192591032","192655867","64835","2024-09"
"267260","HD현대일렉트릭","12309504768000","342000","35992704","36047135","54431","2024-09"
"329180","HD현대중공업","16600572692000","187000","88773116","88773116","0","2024-09"
"097230","HJ중공업","184855714800","2220","83268340","83274281","5941","2024-09"
"195940","HK이노엔","1307424469650","46150","28329891","28329891","0","2024-09"
"014790","HL D&I","91239228410","2410","37858601","37858601","0","2024-09"
"028300","HLB","8812030953600","67200","131131413","131387433","256020","2024-09"
"003580","HLB글로벌","192783947860","4060","47483731","47489591","5860","2024-09"
"278650","HLB바이오스텝","181441349910","2155","84195522","86730589","2535067","2024-09"
"067630","HLB생명과학","1054437130390","8890","118609351","118679271","69920","2024-09"
"024850","HLB이노베이션","311969814480","3420","91219244","91226268","7024","2024-09"
"047920","HLB제약","623586488930","19610","31799413","31799994","581","2024-09"
"115450","HLB테라퓨틱스","703862786340","8820","79803037","80139933","336896","2024-09"
"046210","HLB파나진","125424313840","2960","42373079","42373079","0","2024-09"
"204320","HL만도","1690456320000","36000","46957120","46957120","0","2024-09"
"060980","HL홀딩스","331016486850","34850","9498321","10169410","671089","2024-09"
"011200","HMM","13003325650560","17360","749039496","749039496","0","2024-09"
"403870","HPSP","2438502898650","30450","80082197","82934144","2851947","2024-09"
"036640","HRS","81826636800","5120","15981765","16354800","373035","2024-09"
"035000","HS애드","103728921600","6400","16207644","16567409","359765","2024-09"
"002460","HS화성","84520029970","8930","9464729","10150000","685271","2024-09"
"487570","HS효성","148434391350","40050","3706227","3725927","19700","2024-09"
"298050","HS효성첨단소재","1195195885000","267500","4468022","4479948","11926","2024-09"
"439730","IBKS제20호스팩","9503550000","2205","4310000","4310000","0","2024-09"
"442770","IBKS제21호스팩","9219900000","2190","4210000","4210000","0","2024-09"
"448760","IBKS제22호스팩","9746000000","2200","4430000","4430000","0","2024-09"
"467930","IBKS제23호스팩","9242550000","2185","4230000","4230000","0","2024-09"
"469480","IBKS제24호스팩","9348300000","2210","4230000","4230000","0","2024-09"
"003560","IHQ","63786625000","10760","5928125","6010174","82049","2024-09"
"095340","ISC","1293336934400","63200","20464192","21197058","732866","2024-09"
"175330","JB금융지주","3467139368640","18080","191766558","195083198","3316640","2024-09"
"234080","JW생명과학","168471947520","10880","15484554","15834554","350000","2024-09"
"067290","JW신약","70665335242","1394","50692493","50841502","149009","2024-09"
"001060","JW중외제약","612606721350","26650","22987119","23285930","298811","2024-09"
"096760","JW홀딩스","215131648440","2985","72070904","73924942","1854038","2024-09"
"035900","JYP Ent.","1656652950000","50000","33133059","35532492","2399433","2024-09"
"318000","KBG","49760344920","5720","8699361","8740223","40862","2024-09"
"024840","KBI메탈","95456341940","2740","34838081","34909199","71118","2024-09"
"105560","KB금융","36024098395000","95500","377215690","393528423","16312733","2024-09"
"024120","KB오토시스","42205000000","3670","11500000","11500000","0","2024-09"
"455250","KB제25호스팩","11365200000","2640","4305000","4305000","0","2024-09"
"458320","KB제26호스팩","12386250000","2250","5505000","5505000","0","2024-09"
"464680","KB제27호스팩","25642235000","1987","12905000","12905000","0","2024-09"
"476470","KB제28호스팩","11560500000","2100","5505000","5505000","0","2024-09"
"478390","KB제29호스팩","12751000000","2050","6220000","6220000","0","2024-09"
"486630","KB제30호스팩","10699650000","2015","5310000","5310000","0","2024-09"
"002380","KCC","1912084460000","260000","7354171","8886471","1532300","2024-09"
"021320","KCC건설","84768103000","4250","19945436","21400000","1454564","2024-09"
"344820","KCC글라스","617804153750","38750","15943333","15970512","27179","2024-09"
"036670","KCI","81777520000","7600","10760200","11270000","509800","2024-09"
"009070","KCTC","135772105000","4540","29905750","30000000","94250","2024-09"
"009440","KC그린홀딩스","19115982720","864","22124980","22434980","310000","2024-09"
"119650","KC코트렐","28382733418","442","64214329","64214329","0","2024-09"
"044180","KD","12367281433","463","26711191","26717799","6608","2024-09"
"092220","KEC","177474616644","884","200763141","200763141","0","2024-09"
"046440","KG모빌리언스","163624327020","4410","37103022","38825568","1722546","2024-09"
"003620","KG모빌리티","906405632210","4615","196404254","196404254","0","2024-09"
"016380","KG스틸","675782953560","6780","99673002","100008897","335895","2024-09"
"151860","KG에코솔루션","216937015460","5170","41960738","49603002","7642264","2024-09"
"035600","KG이니시스","245156274480","9210","26618488","27904434","1285946","2024-09"
"001390","KG케미칼","271479743600","3965","68469040","68469040","0","2024-09"
"226360","KH 건설","60474013950","2555","23668890","23756732","87842","2024-09"
"111870","KH 미래물산","43747975260","8910","4909986","4930249","20263","2024-09"
"033180","KH 필룩스","125157155370","6630","18877399","18903579","26180","2024-09"
"060720","KH바텍","199438850100","9050","22037442","23677442","1640000","2024-09"
"015590","KIB플러그에너지","94792616400","400","236981541","236981544","3","2024-09"
"001940","KISCO홀딩스","247284787640","19580","12629458","16176380","3546922","2024-09"
"058400","KNN","105811346280","799","132429720","132429720","0","2024-09"
"025000","KPX케미칼","223733148050","47050","4755221","4840000","84779","2024-09"
"092230","KPX홀딩스","220933945800","56200","3931209","4224646","293437","2024-09"
"000040","KR모터스","31082691420","517","60121260","60132868","11608","2024-09"
"044450","KSS해운","209293656750","9270","22577525","23085880","508355","2024-09"
"101000","KS인더스트리","65839818400","2185","30132640","30149619","16979","2024-09"
"030200","KT","10754877656250","43750","245825775","252021685","6195910","2024-09"
"033780","KT&G","12134594355800","110600","109716043","130322497","20606454","2024-09"
"058850","KTcs","109832620455","2895","37938729","42685000","4746271","2024-09"
"058860","KTis","81754817940","2670","30619782","34802000","4182218","2024-09"
"122450","KX","146146337920","3520","41518846","45335964","3817118","2024-09"
"052900","KX하이텍","51573139280","949","54344720","55107517","762797","2024-09"
"376190","LB루셈","113037000000","4595","24600000","24600000","0","2024-09"
"061970","LB세미콘","193746819600","4425","43784592","43784592","0","2024-09"
"309960","LB인베스트먼트","89912182130","3910","22995443","23217239","221796","2024-09"
"093050","LF","415270440000","15000","27684696","29240000","1555304","2024-09"
"003550","LG","11762737911200","77800","151192004","157300993","6108989","2024-09"
"034220","LG디스플레이","5350000000000","10700","500000000","500000000","0","2024-09"
"051900","LG생활건강","5130924750000","350000","14659785","15618197","958412","2024-09"
"373220","LG에너지솔루션","95706000000000","409000","234000000","234000000","0","2024-09"
"032640","LG유플러스","4268195535360","9930","429828352","436611361","6783009","2024-09"
"011070","LG이노텍","4188617739000","177000","23664507","23667107","2600","2024-09"
"066570","LG전자","14887655913200","91400","162884638","163647814","763176","2024-09"
"037560","LG헬로비전","203298020625","2625","77446865","77446865","0","2024-09"
"051910","LG화학","22483661245500","318500","70592343","70592343","0","2024-09"
"079550","LIG넥스원","5405001280000","248000","21794360","22000000","205640","2024-09"
"225190","LK삼양","133214655000","2625","50748440","50748440","0","2024-09"
"006260","LS","2950799350200","107900","27347538","32200000","4852462","2024-09"
"010120","LS ELECTRIC","4424532863200","149200","29655046","30000000","344954","2024-09"
"000680","LS네트웍스","252563659870","3205","78803014","78803016","2","2024-09"
"060370","LS마린솔루션","418348252740","15290","27360906","28706781","1345875","2024-09"
"417200","LS머트리얼즈","1064852852660","15740","67652659","67652659","0","2024-09"
"229640","LS에코에너지","865852294800","28550","30327576","30624879","297303","2024-09"
"078020","LS증권","221785044800","4400","50405692","55481190","5075498","2024-09"
"108320","LX세미콘","990495870000","60900","16264300","16264300","0","2024-09"
"001120","LX인터내셔널","1059254713900","29450","35967902","38760000","2792098","2024-09"
"108670","LX하우시스","357991800000","40000","8949795","8967670","17875","2024-09"
"383800","LX홀딩스","541267995900","7100","76234929","76280690","45761","2024-09"
"476080","M83","101205000000","13000","7785000","7785000","0","2024-09"
"086960","MDS테크","97741342764","1053","92821788","92821788","0","2024-09"
"023150","MH에탄올","36821577660","5740","6414909","7378526","963617","2024-09"
"038340","MIT","39924432729","1233","32379913","32424892","44979","2024-09"
"035420","NAVER","25590644524800","169200","151244944","160784508","9539564","2024-09"
"160550","NEW","66137471220","2370","27906106","27906106","0","2024-09"
"053290","NE능률","58668389850","3550","16526307","16526307","0","2024-09"
"181710","NHN","544139168400","16530","32918280","33766123","847843","2024-09"
"060250","NHN KCP","281104124590","7270","38666317","40160611","1494294","2024-09"
"104200","NHN벅스","47592420480","3520","13520574","14827550","1306976","2024-09"
"005940","NH투자증권","4428256909400","13550","326808628","327492299","683671","2024-09"
"034310","NICE","393303414680","11240","34991407","37503477","2512070","2024-09"
"030190","NICE평가정보","660323883380","11270","58591294","60107670","1516376","2024-09"
"008260","NI스틸","106821436995","3735","28600117","28600117","0","2024-09"
"004250","NPC","169875898650","5010","33907365","36720000","2812635","2024-09"
"222160","NPX","79551289560","8040","9894439","9894439","0","2024-09"
"456040","OCI","654427384500","73100","8952495","8952495","0","2024-09"
"010060","OCI홀딩스","1294563233400","67800","19093853","19563983","470130","2024-09"
"178920","PI첨단소재","593199704400","20200","29366322","29366322","0","2024-09"
"024940","PN풍년","61561354000","6550","9398680","10000000","601320","2024-09"
"005490","POSCO홀딩스","26202599923500","346500","75620779","82624377","7003598","2024-09"
"218410","RFHIC","360947607290","14030","25726843","26484442","757599","2024-09"
"327260","RF머트리얼즈","54404402670","6570","8280731","8433231","152500","2024-09"
"091340","S&K폴리텍","28540239195","2665","10709283","11703721","994438","2024-09"
"010950","S-Oil","6563576773600","58300","112582792","112582792","0","2024-09"
"419530","SAMG엔터","104468202500","13150","7944350","8590930","646580","2024-09"
"019550","SBI인베스트먼트","110221403652","684","161142403","162066575","924172","2024-09"
"034120","SBS","282677524560","15240","18548394","18551238","2844","2024-09"
"036120","SCI평가정보","77084203665","2265","34032761","35500000","1467239","2024-09"
"246960","SCL사이언스","61908908500","8500","7283401","7283401","0","2024-09"
"099220","SDN","68852371781","1271","54171811","56171811","2000000","2024-09"
"036540","SFA반도체","593553296380","3620","163964999","164460303","495304","2024-09"
"255220","SG","239157551025","2865","83475585","94073791","10598206","2024-09"
"040610","SG&G","55647295814","1649","33746086","34087196","341110","2024-09"
"049470","SGA","19885381100","340","58486415","58862249","375834","2024-09"
"184230","SGA솔루션즈","32303131126","518","62361257","62599161","237904","2024-09"
"016250","SGC E&C","49071642940","15170","3234782","3243585","8803","2024-09"
"005090","SGC에너지","400521327600","27800","14407242","14409333","2091","2024-09"
"001380","SG글로벌","136016532575","3025","44964143","44964143","0","2024-09"
"004060","SG세계물산","69770809836","351","198777236","202424960","3647724","2024-09"
"001770","SHD","21661274740","17830","1214878","1214878","0","2024-09"
"002360","SH에너지화학","55099532136","506","108892356","111133730","2241374","2024-09"
"009160","SIMPAC","213007850300","3925","54269516","65429516","11160000","2024-09"
"033530","SJG세종","120653253540","4460","27052299","27820961","768662","2024-09"
"123700","SJM","50871967480","3260","15604898","15604898","0","2024-09"
"025530","SJM홀딩스","48312847915","3565","13551991","14934008","1382017","2024-09"
"034730","SK","8265284908400","151600","54520349","72502703","17982354","2024-09"
"011790","SKC","5222510958000","153300","34067260","37868298","3801038","2024-09"
"018670","SK가스","1743851437800","194300","8975046","9230244","255198","2024-09"
"001740","SK네트웍스","1010367953900","5210","193928590","221277902","27349312","2024-09"
"006120","SK디스커버리","584420694000","33000","17709718","18785855","1076137","2024-09"
"210980","SK디앤디","149406910730","8030","18606091","18617382","11291","2024-09"
"302440","SK바이오사이언스","4168075987600","53200","78347293","78347293","0","2024-09"
"326030","SK바이오팜","9436746625000","120500","78313250","78313250","0","2024-09"
"402340","SK스퀘어","11986289146600","89900","133329134","134749960","1420826","2024-09"
"361610","SK아이이테크놀로지","2366958808000","33200","71293940","71297592","3652","2024-09"
"100090","SK오션플랜트","782565408960","13220","59195568","59195568","0","2024-09"
"096770","SK이노베이션","11464415037600","120400","95219394","95735590","516196","2024-09"
"475150","SK이터닉스","539378533440","16020","33669072","33691895","22823","2024-09"
"001510","SK증권","211919975936","512","413906203","472590171","58683968","2024-09"
"285130","SK케미칼","839617642500","48750","17222926","17253783","30857","2024-09"
"017670","SK텔레콤","12177098762400","57200","212886342","214790053","1903711","2024-09"
"000660","SK하이닉스","131124070509300","190300","689038731","728002365","38963634","2024-09"
"048550","SM C&C","163154655900","1700","95973327","96714620","741293","2024-09"
"063440","SM Life Design","63059940980","1370","46029154","46029154","0","2024-09"
"003570","SNT다이내믹스","588958281300","26300","22393851","33252697","10858846","2024-09"
"064960","SNT모티브","546510661400","45650","11971756","14623136","2651380","2024-09"
"100840","SNT에너지","266577346920","13490","19761108","20680783","919675","2024-09"
"036530","SNT홀딩스","323896428800","22400","14459662","16303886","1844224","2024-09"
"067160","SOOP","940956588000","88300","10656360","11494767","838407","2024-09"
"005610","SPC삼립","398371710450","49150","8105223","8629009","523786","2024-09"
"011810","STX","151492444500","4890","30980050","31017927","37877","2024-09"
"465770","STX그린로지스","73589277000","10300","7144590","7171032","26442","2024-09"
"077970","STX엔진","462292100700","20100","22999607","23008904","9297","2024-09"
"002820","SUN&L","36853088220","3055","12063204","12607989","544785","2024-09"
"289080","SV인베스트먼트","84642060000","1590","53234000","53234000","0","2024-09"
"084870","TBH글로벌","28844980677","1383","20856819","20856819","0","2024-09"
"002710","TCC스틸","1251704031750","47750","26213697","26213697","0","2024-09"
"089230","THE E&M","28699004192","1312","21874241","21882953","8712","2024-09"
"032540","TJ미디어","72305050710","5190","13931609","13931609","0","2024-09"
"022220","TKG애강","52675086843","1017","51794579","51794579","0","2024-09"
"069260","TKG휴켐스","750918062890","19570","38370877","40878588","2507711","2024-09"
"007980","TP","65245435074","1341","48654314","51175130","2520816","2024-09"
"048770","TPC","37047258760","2360","15697991","15697991","0","2024-09"
"246690","TS인베스트먼트","40837116320","1001","40796320","41477862","681542","2024-09"
"317240","TS트릴리온","29786621715","279","106762085","107240922","478837","2024-09"
"002900","TYM","133288108335","3105","42926927","45050956","2124029","2024-09"
"024070","WISCOM","32492048560","2120","15326438","15326438","0","2024-09"
"057030","YBM넷","56726136235","3505","16184347","16312697","128350","2024-09"
"037270","YG PLUS","411656870900","6490","63429410","63429410","0","2024-09"
"040300","YTN","135660000000","3230","42000000","42000000","0","2024-09"
"051390","YW","30157181820","3735","8074212","11355368","3281156","2024-09"
"052220","iMBC","59110000000","2570","23000000","23000000","0","2024-09"
"079940","가비아","174480014840","13460","12962854","13535684","572830","2024-09"
"078890","가온그룹","58326883560","3630","16068012","17410157","1342145","2024-09"
"000500","가온전선","271601488800","38100","7128648","7357946","229298","2024-09"
"399720","가온칩스","440002656000","38300","11488320","11488320","0","2024-09"
"036620","감성코퍼레이션","337117273780","3715","90744892","90744892","0","2024-09"
"000860","강남제비스코","163150000000","25100","6500000","6500000","0","2024-09"
"198440","강동씨앤엘","87759289408","1442","60859424","60931896","72472","2024-09"
"217730","강스템바이오텍","118834795880","2120","56054149","56054149","0","2024-09"
"035250","강원랜드","3474946425720","17140","202738998","213940500","11201502","2024-09"
"114190","강원에너지","333591195260","12770","26123038","26123038","0","2024-09"
"094480","갤럭시아머니트리","346007171160","8820","39229838","39229838","0","2024-09"
"011420","갤럭시아에스엠","64052922300","2325","27549644","27549644","0","2024-09"
"039240","경남스틸","75677789220","2805","26979604","26979604","0","2024-09"
"053950","경남제약","22850779830","642","35593115","35593402","287","2024-09"
"002100","경농","166141245000","9300","17864650","19522575","1657925","2024-09"
"009450","경동나비엔","1244397445200","86100","14452932","14568592","115660","2024-09"
"267290","경동도시가스","109974272090","18670","5890427","5895406","4979","2024-09"
"012320","경동인베스트","165924787200","76100","2180352","2365023","184671","2024-09"
"011040","경동제약","169194315600","6280","26941770","30768766","3826996","2024-09"
"000050","경방","157464506400","6320","24915270","27415270","2500000","2024-09"
"214390","경보제약","177867038400","7440","23906860","23906860","0","2024-09"
"012610","경인양행","123683867580","2990","41365842","41616365","250523","2024-09"
"009140","경인전자","26962515900","20700","1302537","1570797","268260","2024-09"
"024910","경창산업","80775407600","2270","35583880","35819005","235125","2024-09"
"013580","계룡건설","118428745890","13370","8857797","8930907","73110","2024-09"
"012200","계양전기","40766285346","1499","27195654","27222829","27175","2024-09"
"002140","고려산업","73274117400","2970","24671420","24939425","268005","2024-09"
"049720","고려신용정보","135496243680","9730","13925616","14300000","374384","2024-09"
"010130","고려아연","31713863797000","1543000","20553379","20703283","149904","2024-09"
"002240","고려제강","486765519240","19480","24987963","25000000","12037","2024-09"
"014570","고려제약","52598758875","4875","10789489","11000000","210511","2024-09"
"348150","고바이오랩","136779381000","7060","19373850","19373850","0","2024-09"
"098460","고영","677012727720","10290","65793268","68654755","2861487","2024-09"
"035290","골드앤에스","21454416000","450","47676480","47676480","0","2024-09"
"215000","골프존","395135580000","65800","6005100","6275415","270315","2024-09"
"121440","골프존뉴딘홀딩스","156835686700","3850","40736542","42836818","2100276","2024-09"
"366030","공구우먼","97411555000","4300","22653850","22653850","0","2024-09"
"009290","광동제약","221244978240","5520","40080612","52420851","12340239","2024-09"
"014200","광림","87868591200","30200","2909556","3023556","114000","2024-09"
"017040","광명전기","57292327030","1322","43337615","43337615","0","2024-09"
"029480","광무","200920108810","3655","54971302","55009083","37781","2024-09"
"017900","광전자","92115322527","1829","50363763","57943763","7580000","2024-09"
"037710","광주신세계","224238856800","29400","7627172","7957190","330018","2024-09"
"026910","광진실업","14027836950","2190","6405405","6405405","0","2024-09"
"421800","교보12호스팩","16205800000","2710","5980000","5980000","0","2024-06"
"440790","교보13호스팩","8910000000","2200","4050000","4050000","0","2024-09"
"456490","교보14호스팩","9072000000","2160","4200000","4200000","0","2024-09"
"465320","교보15호스팩","8191500000","2150","3810000","3810000","0","2024-09"
"482520","교보16호스팩","12535500000","2055","6100000","6100000","0","2024-09"
"030610","교보증권","612880641090","5430","112869363","113962961","1093598","2024-09"
"339770","교촌에프앤비","258069638200","10330","24982540","24982540","0","2024-09"
"053270","구영테크","58296881760","2235","26083616","27410405","1326789","2024-09"
"007690","국도화학","279407889000","33500","8340534","9010616","670082","2024-09"
"005320","국동","29068399926","439","66215034","67327897","1112863","2024-09"
"001140","국보","33448047050","2110","15852155","15856388","4233","2024-09"
"066620","국보디자인","107405415000","16250","6609564","7500000","890436","2024-09"
"043650","국순당","80276376600","5100","15740466","17858304","2117838","2024-09"
"006050","국영지앤엠","70671581655","2085","33895243","34895243","1000000","2024-09"
"060480","국일신동","21791850000","1965","11090000","11090000","0","2024-09"
"078130","국일제지","901924696800","800","1127405871","1127405871","0","2024-09"
"307750","국전약품","205354401120","4185","49069152","49069269","117","2024-09"
"002720","국제약품","111993761000","5500","20362502","21159832","797330","2024-09"
"035080","그래디언트","155963696400","11400","13681026","14527584","846558","2024-09"
"453450","그리드위즈","151309387500","19050","7942750","7942750","0","2024-09"
"204020","그리티","56461072740","2820","20021657","20147430","125773","2024-09"
"402490","그린리소스","133825633360","16190","8265944","8265944","0","2024-09"
"114450","그린생명과학","38365814700","2010","19087470","20000000","912530","2024-09"
"083420","그린케미칼","135292679200","5800","23326324","24000000","673676","2024-09"
"186230","그린플러스","95587673200","8900","10740188","10820188","80000","2024-09"
"014530","극동유화","124408506900","3695","33669420","34869420","1200000","2024-09"
"204620","글로벌텍스프리","244461212000","4000","61115303","61116035","732","2024-09"
"019660","글로본","17012674794","489","34790746","34790746","0","2024-09"
"014280","금강공업","106547943905","3965","26872117","29329357","2457240","2024-09"
"053260","금강철강","74476470520","4685","15896792","18720000","2823208","2024-09"
"008870","금비","45672300000","55800","818500","1000000","181500","2024-09"
"001570","금양","2554510625100","44100","57925411","58050037","124626","2024-09"
"282720","금양그린파워","125616429000","10410","12066900","12119500","52600","2024-09"
"002990","금호건설","103917078780","2895","35895364","36953595","1058231","2024-09"
"011780","금호석유","3274203377800","142600","22960753","27334587","4373834","2024-09"
"214330","금호에이치티","123063298532","604","203747183","213914131","10166948","2024-09"
"001210","금호전기","36354701976","852","42669838","43535722","865884","2024-09"
"073240","금호타이어","1272563071410","4430","287260287","287260287","0","2024-09"
"036190","금화피에스시","161228067000","27300","5905790","6000000","94210","2024-09"
"049080","기가레인","57973038634","683","84879998","84883347","3349","2024-09"
"420770","기가비스","481678804000","38000","12675758","12675758","0","2024-09"
"035460","기산텔레콤","26078861260","1789","14577340","14577340","0","2024-09"
"092440","기신정기","76066000000","2605","29200000","29200000","0","2024-09"
"000270","기아","36714962831300","93700","391835249","399858417","8023168","2024-09"
"024110","기업은행","11586597847510","14530","797425867","797425869","2","2024-09"
"013700","까뮤이앤씨","78811344770","1319","59750830","59750830","0","2024-09"
"308100","까스텔바작","19027095850","2950","6449863","6624733","174870","2024-09"
"004540","깨끗한나라","78388614935","2105","37239247","37240693","1446","2024-09"
"407400","꿈비","73716406250","6250","11794625","12259474","464849","2024-09"
"187790","나노","31435070025","1025","30668361","30840830","172469","2024-09"
"286750","나노브릭","48630133900","2350","20693674","20694559","885","2024-09"
"121600","나노신소재","1020577991600","85300","11964572","12196078","231506","2024-09"
"247660","나노씨엠에스","33272663580","7790","4271202","4343920","72718","2024-09"
"039860","나노엔텍","135022894810","4205","32110082","32110082","0","2024-09"
"091970","나노캠텍","21539237956","596","36139661","37417493","1277832","2024-09"
"417010","나노팀","183239007120","9290","19724328","19724328","0","2024-09"
"405920","나라셀라","46124178030","3710","12432393","12878076","445683","2024-09"
"051490","나라엠앤디","64716039500","4900","13207355","14200000","992645","2024-09"
"137080","나래나노텍","35887824390","3245","11059422","11059422","0","2024-09"
"190510","나무가","192035950200","12150","15805428","16264384","458956","2024-09"
"242040","나무기술","55935438304","1688","33137108","34606264","1469156","2024-09"
"089600","나스미디어","172984385700","15300","11306169","11568163","261994","2024-09"
"293580","나우IB","91224941850","963","94729950","94929950","200000","2024-09"
"138610","나이벡","199487915700","18390","10847630","10847630","0","2024-09"
"130580","나이스디앤비","77154000000","5010","15400000","15400000","0","2024-09"
"036800","나이스정보통신","163841346000","18680","8770950","10000000","1229050","2024-09"
"267320","나인테크","96787050950","2230","43402265","43664104","261839","2024-09"
"001260","남광토건","61889398200","6300","9823714","9832572","8858","2024-09"
"008350","남선알미늄","177096511480","1372","129079090","129079090","0","2024-09"
"004270","남성","40719233100","1300","31322487","36212160","4889673","2024-09"
"003920","남양유업","433040103000","659000","657117","679731","22614","2024-09"
"025860","남해화학","313584465300","6540","47948695","49678843","1730148","2024-09"
"111710","남화산업","109939920000","5340","20588000","20588000","0","2024-09"
"091590","남화토건","46607800000","3970","11740000","11740000","0","2024-09"
"168330","내츄럴엔도텍","47896758297","1517","31573341","31754900","181559","2024-09"
"094860","네오리진","28462202494","1331","21384074","21399569","15495","2024-09"
"253590","네오셈","499788969120","11760","42499062","43869164","1370102","2024-09"
"212560","네오오토","66382515510","8430","7874557","7874963","406","2024-09"
"095660","네오위즈","409130011650","20550","19909003","22033719","2124716","2024-09"
"042420","네오위즈홀딩스","137191967900","21100","6501989","8856866","2354877","2024-09"
"311390","네오크레마","77974698360","7160","10890321","10979147","88826","2024-09"
"085910","네오티스","46954231740","3510","13377274","13934818","557544","2024-09"
"092730","네오팜","207246642000","26500","7820628","8207361","386733","2024-09"
"290660","네오펙트","39306835629","933","42129513","42129513","0","2024-09"
"306620","네온테크","113051360520","2765","40886568","42608149","1721581","2024-09"
"153460","네이블","40334716800","6300","6402336","6530014","127678","2024-09"
"007390","네이처셀","1100507367600","17100","64357156","64357156","0","2024-09"
"033640","네패스","176458411360","7760","22739486","23059202","319716","2024-09"
"330860","네패스아크","155955776000","12800","12184045","12184045","0","2024-09"
"005720","넥센","224062796250","4625","48446010","53543977","5097967","2024-09"
"002350","넥센타이어","672182347740","6990","96163426","97667877","1504451","2024-09"
"089140","넥스턴바이오","57057283580","5060","11276143","11282627","6484","2024-09"
"389650","넥스트바이오메디컬","274542989700","33950","8086686","8086686","0","2024-09"
"137940","넥스트아이","32155948440","420","76561782","78320992","1759210","2024-09"
"396270","넥스트칩","255054054000","14100","18088940","18088940","0","2024-09"
"348210","넥스틴","689452954200","66700","10336626","10437250","100624","2024-09"
"092790","넥스틸","243638740000","9370","26002000","26002000","0","2024-09"
"225570","넥슨게임즈","955061156310","14930","63969267","65860174","1890907","2024-09"
"217270","넵튠","233758377710","5210","44867251","46676150","1808899","2024-09"
"251270","넷마블","4703044375400","57400","81934571","85953502","4018931","2024-09"
"104620","노랑풍선","70180618180","4430","15842126","15842126","0","2024-09"
"090350","노루페인트","166000000000","8300","20000000","20000000","0","2024-09"
"000320","노루홀딩스","134462852160","13120","10248693","13291151","3042458","2024-09"
"194700","노바렉스","170649362240","9640","17702216","18754848","1052632","2024-09"
"285490","노바텍","117832457310","11870","9926913","10575831","648918","2024-09"
"145170","노브랜드","106890376560","12890","8292504","9079834","787330","2024-09"
"106520","노블엠앤비","15902299386","411","38691726","38695952","4226","2024-09"
"376930","노을","121740562700","3295","36947060","36947060","0","2024-09"
"006280","녹십자","1814695302000","159000","11413178","11686538","273360","2024-09"
"142280","녹십자엠에스","90626416050","4175","21706926","21741926","35000","2024-09"
"234690","녹십자웰빙","192180147780","10830","17745166","17752276","7110","2024-09"
"005250","녹십자홀딩스","708162834400","15760","44934190","47028210","2094020","2024-09"
"004370","농심","2093309526000","362000","5782623","6082642","300019","2024-09"
"072710","농심홀딩스","311195709000","67100","4637790","4637790","0","2024-09"
"054050","농우바이오","115900956030","7230","16030561","16030561","0","2024-09"
"069140","누리플랜","17756310362","1358","13075339","13102743","27404","2024-09"
"040160","누리플렉스","28527412125","2525","11297985","12055535","757550","2024-09"
"332290","누보","37841199650","1150","32905391","33384803","479412","2024-09"
"348340","뉴로메카","218895277500","20750","10549170","10549170","0","2024-09"
"060260","뉴보텍","14303005632","1072","13342356","13512009","169653","2024-09"
"123840","뉴온","57962451461","223","259921307","292370108","32448801","2024-09"
"012340","뉴인텍","27131615069","533","50903593","50907162","3569","2024-09"
"270870","뉴트리","78704902500","8750","8994846","9200224","205378","2024-09"
"144960","뉴파워프라즈마","196461376465","4855","40465783","43692624","3226841","2024-09"
"085670","뉴프렉스","135210070520","5530","24450284","24450761","477","2024-09"
"064260","다날","217077233750","3250","66792995","68949040","2156045","2024-09"
"340360","다보링크","120185347240","2770","43388212","43388212","0","2024-09"
"039560","다산네트웍스","135584854340","3505","38683268","39505981","822713","2024-09"
"154040","다산솔루에타","32112718166","1789","17950094","17950094","0","2024-09"
"058730","다스코","61998028400","3410","18181240","18796941","615701","2024-09"
"030210","다올투자증권","167352748575","2825","59239911","60911106","1671195","2024-09"
"023590","다우기술","792249587640","18360","43150849","44866617","1715768","2024-09"
"032190","다우데이타","429343000000","11210","38300000","38300000","0","2024-09"
"323350","다원넥스뷰","48358746800","6370","7591640","7596111","4471","2024-09"
"068240","다원시스","414836560190","10870","38163437","38163437","0","2024-09"
"145210","다이나믹디자인","95388878880","2760","34561188","34581687","20499","2024-09"
"019680","대교","154307248620","2290","67383078","84702850","17319772","2024-09"
"006370","대구백화점","60498111970","7270","8321611","10821611","2500000","2024-09"
"008060","대덕","210118930000","6200","33890150","33890150","0","2024-09"
"353200","대덕전자","808955062250","16370","49416925","49416925","0","2024-09"
"000490","대동","191613425310","8130","23568687","25640788","2072101","2024-09"
"020400","대동금속","20251204100","6350","3189166","3189166","0","2024-09"
"008830","대동기어","67765900800","7540","8987520","8987520","0","2024-09"
"048470","대동스틸","34327253550","3650","9404727","10000000","595273","2024-09"
"008110","대동전자","105136322880","15040","6990447","10490447","3500000","2024-09"
"004780","대륙제관","64726019930","4070","15903199","15903199","0","2024-09"
"005750","대림B&Co","58019395200","3480","16672240","16672240","0","2024-09"
"017650","대림제지","58345000000","7000","8335000","9000000","665000","2024-09"
"006570","대림통상","40975363840","2720","15064472","15225000","160528","2024-09"
"007720","대명소노시즌","115819717050","1149","100800450","100800450","0","2024-09"
"389260","대명에너지","206646000000","12120","17050000","17050000","0","2024-09"
"317850","대모","81163095000","9750","8324420","8324420","0","2024-09"
"290670","대보마그네틱","122009137760","16330","7471472","7857660","386188","2024-09"
"078140","대봉엘에스","189403323700","17300","10948169","11086579","138410","2024-09"
"065150","대산F&B","18113400725","145","124920005","125282405","362400","2024-09"
"001680","대상","696425302500","20100","34648025","34648025","0","2024-09"
"084690","대상홀딩스","316859707500","8750","36212538","36212538","0","2024-09"
"036480","대성미생물","38304000000","10080","3800000","3800000","0","2024-09"
"128820","대성산업","129051815230","3445","37460614","45235478","7774864","2024-09"
"117580","대성에너지","248558150440","9140","27194546","27500000","305454","2024-09"
"027830","대성창투","80460000000","1490","54000000","54000000","0","2024-09"
"104040","대성파인텍","45286878708","972","46591439","47224987","633548","2024-09"
"129920","대성하이텍","56368867830","4110","13715053","13715053","0","2024-09"
"016710","대성홀딩스","125327966060","7790","16088314","16089459","1145","2024-09"
"438220","대신밸런스제13호스팩","14692200000","2605","5640000","5640000","0","2024-09"
"442310","대신밸런스제14호스팩","15063950000","2245","6710000","6710000","0","2024-09"
"457390","대신밸런스제15호스팩","16778475000","2385","7035000","7035000","0","2024-09"
"457630","대신밸런스제16호스팩","15935800000","2180","7310000","7310000","0","2024-09"
"471050","대신밸런스제17호스팩","12847200000","2120","6060000","6060000","0","2024-09"
"478780","대신밸런스제18호스팩","16294600000","2060","7910000","7910000","0","2024-09"
"020180","대신정보통신","33510013880","872","38428915","38428915","0","2024-09"
"003540","대신증권","640709937690","17070","37534267","50773400","13239133","2024-09"
"045390","대아티아이","190982851670","2710","70473377","70473377","0","2024-09"
"009190","대양금속","72004049100","1700","42355323","42359986","4663","2024-09"
"108380","대양전기공업","107689244800","11650","9243712","9567333","323621","2024-09"
"014160","대영포장","98783679441","1037","95259093","108394549","13135456","2024-09"
"047040","대우건설","1503841735200","3660","410885720","415622638","4736918","2024-09"
"003090","대웅","1036579498500","25350","40890710","58141980","17251270","2024-09"
"069620","대웅제약","1730543008000","150400","11506270","11586575","80305","2024-09"
"007680","대원","58223232420","4330","13446474","13446474","0","2024-09"
"000430","대원강업","243970000000","3935","62000000","62000000","0","2024-09"
"048910","대원미디어","97279532700","8050","12084414","12578946","494532","2024-09"
"005710","대원산업","117821088000","5880","20037600","20037600","0","2024-09"
"006340","대원전선","211816169375","2825","74979175","74979175","0","2024-09"
"003220","대원제약","310141862330","14470","21433439","22427583","994144","2024-09"
"024890","대원화성","42593773640","1045","40759592","41249152","489560","2024-09"
"290380","대유","56838037000","2300","24712190","24713612","1422","2024-09"
"002880","대유에이텍","49395884664","1057","46732152","46744020","11868","2024-09"
"000300","대유플러스","156936737152","1984","79101178","79101178","0","2024-09"
"120240","대정화금","99133499620","13820","7173191","7190391","17200","2024-09"
"003310","대주산업","51000376350","1441","35392350","35392350","0","2024-09"
"078600","대주전자재료","1590304644000","106200","14974620","15480593","505973","2024-09"
"012800","대창","95476477626","1251","76320126","91140499","14820373","2024-09"
"015230","대창단조","129599651600","5140","25213940","28572230","3358290","2024-09"
"096350","대창솔루션","53635329023","337","159155279","163761009","4605730","2024-09"
"140520","대창스틸","46753856740","2215","21107836","21109243","1407","2024-09"
"131220","대한과학","35473409720","4760","7452397","7454490","2093","2024-09"
"010170","대한광통신","75479811158","1013","74511166","74511166","0","2024-09"
"054670","대한뉴팜","107791019520","7680","14035289","14354920","319631","2024-09"
"001070","대한방직","21204289050","5870","3612315","5300000","1687685","2024-09"
"023910","대한약품","149058000000","25350","5880000","6000000","120000","2024-09"
"006650","대한유화","633667860000","102600","6176100","6500000","323900","2024-09"
"001440","대한전선","2264378975860","12190","185757094","186447300","690206","2024-09"
"084010","대한제강","228723313470","13110","17446477","23414397","5967920","2024-09"
"001790","대한제당","255675930200","2890","88469180","89696580","1227400","2024-09"
"001130","대한제분","217659563100","132300","1645197","1690000","44803","2024-09"
"003490","대한항공","8892527803950","24150","368220613","368220661","48","2024-09"
"005880","대한해운","571966008320","1792","319177460","319177460","0","2024-09"
"003830","대한화섬","131902859000","117700","1120670","1328000","207330","2024-09"
"016090","대현","88786031550","2005","44282310","44282310","0","2024-09"
"069460","대호에이엘","78066793220","1157","67473460","67544896","71436","2024-09"
"021040","대호특수강","28116174410","1535","18316726","21704774","3388048","2024-09"
"067080","대화제약","296031385000","16900","17516650","18616650","1100000","2024-09"
"298540","더네이쳐홀딩스","142967158730","9790","14603387","14765856","162469","2024-09"
"032860","더라미","70304767425","1745","40289265","40395863","106598","2024-09"
"192080","더블유게임즈","1003173184200","50600","19825557","21495906","1670349","2024-09"
"393890","더블유씨피","608559115080","18060","33696518","33696518","0","2024-09"
"299170","더블유에스아이","44651558676","1487","30027948","30027963","15","2024-09"
"012510","더존비즈온","1502346520800","53600","28028853","30382784","2353931","2024-09"
"224060","더코디","22330902330","4730","4721121","4748398","27277","2024-09"
"043090","더테크놀로지","29244211143","393","74412751","74412751","0","2024-09"
"213420","덕산네오룩스","668111288000","27200","24562915","24831179","268264","2024-09"
"317330","덕산테코피아","734085536400","35850","20476584","20476584","0","2024-09"
"077360","덕산하이메탈","210146134250","4625","45437002","45437002","0","2024-09"
"004830","덕성","91621958500","6620","13840175","15680000","1839825","2024-09"
"090410","덕신이피씨","65900170050","1430","46084035","46084095","60","2024-09"
"024900","덕양산업","109605220400","3380","32427580","32564980","137400","2024-09"
"263600","덕우전자","93351616600","5860","15930310","15930310","0","2024-09"
"194480","데브시스터즈","388695744000","36000","10797104","12035480","1238376","2024-09"
"263800","데이타솔루션","70311012300","4335","16219380","16219380","0","2024-09"
"206560","덱스터","194449178090","7730","25155133","25411736","256603","2024-09"
"261200","덴티스","108319779250","7090","15277825","15809700","531875","2024-09"
"145720","덴티움","659727661500","76500","8623891","11068830","2444939","2024-09"
"067990","도이치모터스","138452805570","4665","29679058","30181550","502492","2024-09"
"002150","도화엔지니어링","218420612000","6560","33295825","33720000","424175","2024-09"
"006620","동구바이오제약","150769396880","5560","27116798","28464992","1348194","2024-09"
"100130","동국S&C","138498301655","2485","55733723","57143000","1409277","2024-09"
"005160","동국산업","353972703570","6870","51524411","54244482","2720071","2024-09"
"460850","동국씨엠","191029862400","6400","29848416","29898656","50240","2024-09"
"075970","동국알앤에스","46552000000","2530","18400000","18400000","0","2024-09"
"460860","동국제강","427121362040","8620","49550042","49608017","57975","2024-09"
"086450","동국제약","765048768000","17400","43968320","44460000","491680","2024-09"
"001230","동국홀딩스","247257266850","7950","31101543","31800483","698940","2024-09"
"023450","동남합성","113854815000","32850","3465900","3500000","34100","2024-09"
"004140","동방","112078820070","2345","47794806","47971766","176960","2024-09"
"099410","동방선기","42674928300","3060","13946055","14000000","53945","2024-09"
"007590","동방아그로","77783682570","6270","12405691","13617577","1211886","2024-09"
"005960","동부건설","91882926270","4005","22942054","22946345","4291","2024-09"
"026960","동서","2323737916650","23550","98672523","99700000","1027477","2024-09"
"002210","동성제약","101639316660","4445","22865988","26100970","3234982","2024-09"
"102260","동성케미컬","208706658330","4285","48706338","49689728","983390","2024-09"
"033500","동성화인텍","311525474170","10730","29033129","29989494","956365","2024-09"
"025950","동신건설","175140000000","20850","8400000","8400000","0","2024-09"
"000640","동아쏘시오홀딩스","753837193800","120600","6250723","6348913","98190","2024-09"
"170900","동아에스티","676031201400","75300","8977838","9167274","189436","2024-09"
"088130","동아엘텍","82530682080","9440","8742657","8742657","0","2024-09"
"028100","동아지질","174092911200","13140","13249080","14052646","803566","2024-09"
"041930","동아화성","100367491120","6760","14847262","15800000","952738","2024-09"
"001520","동양","143871479754","758","189804063","238684063","48880000","2024-09"
"084670","동양고속","21680790000","8310","2609000","2895569","286569","2024-09"
"082640","동양생명","924755409590","5930","155945263","161358585","5413322","2024-09"
"060380","동양에스텍","27907800000","1446","19300000","19700000","400000","2024-09"
"079960","동양이엔피","145842870710","18890","7720639","7860000","139361","2024-09"
"008970","동양철관","116521883618","742","157037579","157052160","14581","2024-09"
"228340","동양파일","39780000000","1989","20000000","20000000","0","2024-09"
"092780","동양피스톤","68910288720","5460","12620932","13168460","547528","2024-09"
"088910","동우팜투테이블","51186310360","1990","25721764","25831764","110000","2024-09"
"094170","동운아나텍","383536775600","20350","18847016","19067208","220192","2024-09"
"049770","동원F&B","598164220000","31000","19295620","19295620","0","2024-09"
"013120","동원개발","231560655000","2550","90808100","90808100","0","2024-09"
"018500","동원금속","60300798450","1290","46744805","46754933","10128","2024-09"
"006040","동원산업","1213937861500","33700","36021895","36021895","0","2024-09"
"030720","동원수산","26154384100","5620","4653805","4653805","0","2024-09"
"014820","동원시스템즈","1472757125600","50800","28991282","28991282","0","2024-09"
"111380","동인기연","109395854070","18430","5935749","6128000","192251","2024-09"
"163560","동일고무벨트","104528000000","7520","13900000","13900000","0","2024-09"
"109860","동일금속","73341480750","8670","8459225","9100000","640775","2024-09"
"032960","동일기연","41873668960","11080","3779212","3986323","207111","2024-09"
"004890","동일산업","85343197400","39400","2166071","2425215","259144","2024-09"
"002690","동일제강","28004679360","1476","18973360","20300360","1327000","2024-09"
"023790","동일철강","26217477691","1259","20824049","20841335","17286","2024-09"
"005290","동진쎄미켐","1395903512100","27150","51414494","51414494","0","2024-09"
"025900","동화기업","514587127500","11250","45741078","50557285","4816207","2024-09"
"000020","동화약품","208161654300","7510","27717930","27931470","213540","2024-09"
"000150","두산","2731639738000","202000","13522969","16523835","3000866","2024-09"
"454910","두산로보틱스","4550362596000","70200","64819980","64819980","0","2024-09"
"241560","두산밥캣","3763467058400","37600","100092209","100249166","156957","2024-09"
"034020","두산에너빌리티","13994163920800","21850","640465168","640561146","95978","2024-09"
"131970","두산테스나","491463862050","29050","16917861","17006566","88705","2024-09"
"336260","두산퓨얼셀","1215358522240","18560","65482679","65493726","11047","2024-09"
"016740","두올","107471771100","3450","31151238","32066680","915442","2024-09"
"073190","듀오백","28045815330","2535","11063438","11968040","904602","2024-09"
"030350","드래곤플라이","17277854277","249","69388973","69388973","0","2024-09"
"203650","드림시큐리티","165259784610","3390","48749199","50605754","1856555","2024-09"
"223250","드림씨아이에스","99362177700","4175","23799324","23799324","0","2024-09"
"060570","드림어스컴퍼니","169770431385","2245","75621573","75621573","0","2024-09"
"362990","드림인사이트","34433884800","2100","16397088","16800574","403486","2024-09"
"192650","드림텍","571872352590","8470","67517397","68883113","1365716","2024-09"
"217620","디딤이앤에프","21715711458","381","56996618","57747210","750592","2024-09"
"016670","디모아","20580459540","4170","4935362","4941846","6484","2024-09"
"187870","디바이스이엔지","88862010920","13220","6721786","7036609","314823","2024-09"
"024090","디씨엠","103632561360","11940","8679444","11400000","2720556","2024-09"
"003160","디아이","521636218450","20050","26016769","28300000","2283231","2024-09"
"092200","디아이씨","142391090625","3675","38745875","38888569","142694","2024-09"
"110990","디아이티","262162891980","14220","18436209","18900000","463791","2024-09"
"263690","디알젬","73983051000","6750","10960452","11325610","365158","2024-09"
"214680","디알텍","231871364680","3145","73726984","73727108","124","2024-09"
"347850","디앤디파마텍","458608711500","43500","10542729","10542729","0","2024-09"
"263720","디앤씨미디어","214365446570","17270","12412591","12524473","111882","2024-09"
"376300","디어유","747759789000","31500","23738406","23738406","0","2024-09"
"109740","디에스케이","127780376100","5070","25203230","25710390","507160","2024-09"
"196490","디에이테크놀로지","36209568780","203","178372260","178549360","177100","2024-09"
"066900","디에이피","42681195525","2425","17600493","22744503","5144010","2024-09"
"127120","디엔에이링크","80829415585","3595","22483843","22483843","0","2024-09"
"092070","디엔에프","118032951600","10200","11571858","11571858","0","2024-09"
"039840","디오","239469441160","16570","14451988","14981755","529767","2024-09"
"013570","디와이","114095008375","4625","24669191","26319633","1650442","2024-09"
"219550","디와이디","42939932677","547","78500791","78500791","0","2024-09"
"310870","디와이씨","26809427952","1296","20686287","20687271","984","2024-09"
"210540","디와이파워","133644155610","12110","11035851","11041708","5857","2024-09"
"104460","디와이피엔에프","97336841540","10070","9666022","10713625","1047603","2024-09"
"079810","디이엔티","165643155220","7580","21852659","22028094","175435","2024-09"
"113810","디젠스","28680056829","879","32628051","32628051","0","2024-09"
"043360","디지아이","19619531800","2200","8917969","9000000","82031","2024-09"
"197140","디지캡","33942202950","2675","12688674","13013154","324480","2024-09"
"068930","디지털대성","193906640000","7400","26203600","27675342","1471742","2024-09"
"033130","디지틀조선","67809592809","1827","37115267","37115267","0","2024-09"
"105740","디케이락","71993072040","7080","10168513","10168513","0","2024-09"
"263020","디케이앤디","56692156110","3810","14879831","15069831","190000","2024-09"
"290550","디케이티","167410295100","8370","20001230","20001230","0","2024-09"
"066670","디티씨","50546381480","3220","15697634","18691918","2994284","2024-09"
"187220","디티앤씨","41489758800","3600","11524933","11698021","173088","2024-09"
"383930","디티앤씨알오","96672775840","7570","12770512","12770512","0","2024-09"
"131180","딜리","28898335440","1040","27786861","29350000","1563139","2024-09"
"315640","딥노이드","139908712320","6240","22421268","22421268","0","2024-09"
"223310","딥마인드","49093332200","2150","22834108","22839375","5267","2024-09"
"317120","라닉스","33960872250","3525","9634290","9660000","25710","2024-09"
"462510","라메디텍","92476357150","10690","8650735","8650735","0","2024-09"
"042510","라온시큐어","103630221180","1917","54058540","56025871","1967331","2024-09"
"232680","라온테크","87697206520","7190","12197108","12534234","337126","2024-09"
"418420","라온텍","96852567900","3225","30031804","30108433","76629","2024-09"
"300120","라온피플","100858158020","4835","20860012","20860012","0","2024-09"
"171120","라이온켐텍","91945298500","2605","35295700","35901760","606060","2024-09"
"388790","라이콤","88997843655","2985","29815023","29913930","98907","2024-09"
"347700","라이프시맨틱스","72458056215","3555","20382013","20382013","0","2024-09"
"214260","라파스","146300737700","17420","8398435","8912435","514000","2024-09"
"115390","락앤락","374233582080","8640","43314072","43326411","12339","2024-09"
"200350","래몽래인","144142680500","14420","9996025","9996025","0","2024-09"
"171010","램테크놀러지","52762394880","3690","14298752","14298752","0","2024-09"
"084650","랩지노믹스","269491163700","3630","74239990","74239990","0","2024-09"
"217500","러셀","48617196824","1676","29007874","31812000","2804126","2024-09"
"038390","레드캡투어","132512514350","15850","8360411","8589480","229069","2024-09"
"294140","레몬","102976958115","4905","20994283","21000000","5717","2024-09"
"443250","레뷰코퍼레이션","98598204000","9150","10775760","11279386","503626","2024-09"
"228670","레이","129230418360","8340","15495254","15495254","0","2024-09"
"228850","레이언스","109682986800","6970","15736440","16591014","854574","2024-09"
"412350","레이저쎌","43067606820","4935","8726972","8726972","0","2024-09"
"199550","레이저옵텍","72263250600","6200","11655363","11656947","1584","2024-09"
"281740","레이크머티리얼즈","947833954200","14420","65730510","65730548","38","2024-09"
"277810","레인보우로보틱스","2424982250000","125000","19399858","19399858","0","2024-09"
"215100","로보로보","69855548250","3450","20247985","20348454","100469","2024-09"
"090360","로보스타","206700000000","21200","9750000","9750000","0","2024-09"
"108490","로보티즈","234350573050","18170","12897665","13053665","156000","2024-09"
"067730","로지시스","26119589400","2700","9673922","9673922","0","2024-09"
"071280","로체시스템즈","290266702740","19460","14916069","15296603","380534","2024-09"
"032350","롯데관광개발","733007280460","9620","76196183","76196183","0","2024-09"
"089860","롯데렌탈","1035235795500","28500","36324063","36634063","310000","2024-09"
"000400","롯데손해보험","701679768100","2270","309110030","310336320","1226290","2024-09"
"023530","롯데쇼핑","1826283344000","64600","28270640","28288755","18115","2024-09"
"020150","롯데에너지머티리얼즈","1759128355250","38150","46110835","46110835","0","2024-09"
"280360","롯데웰푸드","1145828203200","129600","8841267","9434574","593307","2024-09"
"286940","롯데이노베이트","343436630900","22700","15129367","15129367","0","2024-09"
"004000","롯데정밀화학","1137235500000","44650","25470000","25800000","330000","2024-09"
"004990","롯데지주","1678085610000","23700","70805300","104909237","34103937","2024-09"
"005300","롯데칠성","1097691977200","118300","9278884","9278884","0","2024-09"
"011170","롯데케미칼","3908894526900","92700","42167147","42775419","608272","2024-09"
"071840","롯데하이마트","182540767680","7890","23135712","23607712","472000","2024-09"
"328130","루닛","1110172694400","38450","28873152","28873152","0","2024-09"
"038060","루멘스","60802279216","1264","48103069","48103069","0","2024-09"
"474170","루미르","146329556880","8530","17154696","17154696",,"자료 없음"
"141080","리가켐바이오","4803143514600","131700","36470338","36610338","140000","2024-09"
"058470","리노공업","2745902808000","180900","15179120","15242370","63250","2024-09"
"016100","리더스코스메틱","49965128575","2725","18335827","19100894","765067","2024-09"
"012700","리드코프","111081657680","4340","25594852","26446135","851283","2024-09"
"302550","리메드","121786368000","3975","30638080","30638080","0","2024-09"
"073570","리튬포어스","58800831375","1625","36185127","36189497","4370","2024-09"
"377450","리파인","206029647000","13550","15205140","17330000","2124860","2024-09"
"277070","린드먼아시아","48967424250","3865","12669450","13692000","1022550","2024-09"
"042500","링네트","74873444400","4650","16101816","19070134","2968318","2024-09"
"193250","링크드","26215878078","414","63323377","63323377","0","2024-09"
"219420","링크제니시스","49858573510","4430","11254757","11469507","214750","2024-09"
"439090","마녀공장","302506462200","18470","16378260","16378260","0","2024-09"
"027740","마니커","58611624214","923","63501218","63511228","10010","2024-09"
"195500","마니커에프앤지","46575870000","2915","15978000","15978000","0","2024-09"
"377480","마음AI","66572754820","10670","6239246","6239246","0","2024-09"
"305090","마이크로디지탈","209026289600","12640","16536890","16536890","0","2024-09"
"098120","마이크로컨텍솔","44223915120","5320","8312766","8312766","0","2024-09"
"424980","마이크로투나노","51612720800","8720","5918890","5918890","0","2024-09"
"038290","마크로젠","179523235430","17990","9979057","10841400","862343","2024-09"
"001080","만호제강","89424203000","30250","2956172","4150000","1193828","2024-09"
"267980","매일유업","276399303600","38300","7216692","7843638","626946","2024-09"
"005990","매일홀딩스","104830742750","8390","12494725","13718304","1223579","2024-09"
"093520","매커스","88329438000","9000","9814382","16163092","6348710","2024-09"
"377030","맥스트","46872262390","2395","19570882","19570882","0","2024-09"
"100590","머큐리","54455279120","3440","15830023","15830023","0","2024-09"
"067280","멀티캠퍼스","175728997350","29650","5926779","5926779","0","2024-09"
"072870","메가스터디","127302142320","11160","11407002","11920959","513957","2024-09"
"215200","메가스터디교육","461557968300","42900","10758927","11461955","703028","2024-09"
"133750","메가엠디","45253719250","2050","22074985","23407077","1332092","2024-09"
"446540","메가터치","85784230000","4130","20771000","20771000","0","2024-09"
"235980","메드팩토","183686401650","5470","33580695","33580695","0","2024-09"
"041920","메디아나","86117704000","4640","18559850","18598223","38373","2024-09"
"014100","메디앙스","25144086425","2225","11300713","11800000","499287","2024-09"
"054180","메디콕스","19368634012","329","58871228","58878283","7055","2024-09"
"086900","메디톡스","1161821689600","172600","6731296","7298497","567201","2024-09"
"078160","메디포스트","226756920250","6650","34098785","34217785","119000","2024-09"
"138040","메리츠금융지주","19241146184000","104000","185011021","190720114","5709093","2024-09"
"408920","메쎄이상","94899491190","2205","43038318","43232455","194137","2024-09"
"021880","메이슨캐피탈","45959691216","302","152184408","152184408","0","2024-09"
"140410","메지온","1018603212000","34000","29958918","29958918","0","2024-09"
"241770","메카로","75626112000","7680","9847150","10192640","345490","2024-09"
"090370","메타랩스","40589655270","1630","24901629","24904689","3060","2024-09"
"059210","메타바이오메드","94114609420","4115","22871108","23862351","991243","2024-09"
"118000","메타케어","55858796190","339","164775210","164777364","2154","2024-09"
"058110","멕아이씨에스","39053775600","2520","15497530","16050530","553000","2024-09"
"017180","명문제약","77386586265","2315","33428331","33953454","525123","2024-09"
"009900","명신산업","685259936980","13060","52470133","52470133","0","2024-09"
"012690","모나리자","131253182250","3590","36560775","36571255","10480","2024-09"
"005360","모나미","42235481145","2235","18897307","18897307","0","2024-09"
"070960","모나용평","190164021660","4020","47304483","48133333","828850","2024-09"
"434480","모니터랩","48233630000","4100","11764300","12253300","489000","2024-09"
"080420","모다이노칩","151152195312","1896","79721622","79721622","0","2024-09"
"417970","모델솔루션","60320881000","9430","6396700","6396700","0","2024-09"
"080160","모두투어","171218538210","9890","17312289","18900000","1587711","2024-09"
"087260","모바일어플라이언스","68849301015","2115","32552861","32552861","0","2024-09"
"101330","모베이스","70945643885","3065","23147029","23147029","0","2024-09"
"012860","모베이스전자","127771693152","1758","72680144","73233457","553313","2024-09"
"363260","모비데이즈","80585411600","2540","31726540","32163769","437229","2024-09"
"348030","모비릭스","50708064000","5280","9603800","9603800","0","2024-09"
"250060","모비스","103173266140","3220","32041387","32171314","129927","2024-09"
"288980","모아데이타","57191110110","1655","34556562","34556562","0","2024-09"
"142760","모아라이프플러스","50489177118","1338","37734811","37734811","0","2024-09"
"033200","모아텍","29270402220","3180","9204529","14331185","5126656","2024-09"
"333050","모코엠시스","28524414784","1241","22985024","24444326","1459302","2024-09"
"009680","모토닉","187295223840","8660","21627624","33000000","11372376","2024-09"
"118990","모트렉스","250677672420","10110","24795022","24861990","66968","2024-09"
"006920","모헨즈","28119000000","2575","10920000","10920000","0","2024-09"
"009580","무림P&P","172124027280","2760","62363778","62368324","4546","2024-09"
"001810","무림SP","36150537500","1633","22137500","22137500","0","2024-09"
"009200","무림페이퍼","85715178600","2060","41609310","41609310","0","2024-09"
"033920","무학","157596864600","5950","26486868","28500000","2013132","2024-09"
"008420","문배철강","42415267575","2215","19149105","20503505","1354400","2024-09"
"279600","미디어젠","52938025300","11300","4684781","4684781","0","2024-09"
"095500","미래나노텍","293654164050","10350","28372383","31009999","2637616","2024-09"
"254490","미래반도체","228120400000","15800","14438000","14438000","0","2024-09"
"025560","미래산업","31830869630","1022","31145665","31166865","21200","2024-09"
"218150","미래생명자원","86657804205","4445","19495569","20415802","920233","2024-09"
"007120","미래아이앤지","31011734390","1135","27323114","28878608","1555494","2024-09"
"442900","미래에셋드림스팩1호","76723200000","9990","7680000","7680000","0","2024-09"
"100790","미래에셋벤처투자","257634803300","4850","53120578","53124634","4056","2024-09"
"412930","미래에셋비전스팩1호","17725120000","2870","6176000","6176000","0","2024-09"
"446190","미래에셋비전스팩2호","11236500000","2270","4950000","4950000","0","2024-09"
"448830","미래에셋비전스팩3호","10578000000","2150","4920000","4920000","0","2024-09"
"477380","미래에셋비전스팩4호","16321500000","2015","8100000","8100000","0","2024-09"
"477470","미래에셋비전스팩5호","11343600000","2070","5480000","5480000","0","2024-09"
"478440","미래에셋비전스팩6호","13963950000","2015","6930000","6930000","0","2024-09"
"482680","미래에셋비전스팩7호","16290345000","1983","8215000","8215000","0","2024-09"
"085620","미래에셋생명","686324800000","5260","130480000","177016189","46536189","2024-09"
"006800","미래에셋증권","4114235260360","9160","449152321","595316408","146164087","2024-09"
"049950","미래컴퍼니","146404837630","18470","7926629","8817884","891255","2024-09"
"207760","미스터블루","112948073265","1371","82383715","83079783","696068","2024-09"
"002840","미원상사","927910161000","199800","4644195","4750000","105805","2024-09"
"268280","미원에스씨","701214452400","143600","4883109","5000000","116891","2024-09"
"107590","미원홀딩스","185930635000","80300","2315450","2320000","4550","2024-09"
"134380","미원화학","160003105800","79900","2002542","2199268","196726","2024-09"
"003650","미창석유","145245984000","96000","1512979","1739672","226693","2024-09"
"059090","미코","310866477390","9870","31496097","33416778","1920681","2024-09"
"214610","미코바이오메드","71307037371","1637","43559583","43568945","9362","2024-09"
"201490","미투온","66713890360","2180","30602702","31257770","655068","2024-09"
"452200","민테크","143741715000","6550","21945300","21945300","0","2024-09"
"418470","밀리의서재","117120202420","13780","8499289","8499289","0","2024-09"
"206640","바디텍메드","342392249680","15580","21976396","23486560","1510164","2024-09"
"018700","바른손","38731014000","1125","34427568","35119757","692189","2024-09"
"035620","바른손이앤에이","35276934725","475","74267231","74439675","172444","2024-09"
"053030","바이넥스","649692590400","20400","31847676","32684188","836512","2024-09"
"301300","바이브컴퍼니","51159563875","4135","12372325","12394861","22536","2024-09"
"377740","바이오노트","467868116000","4600","101710460","102056048","345588","2024-09"
"064550","바이오니아","601379780300","23300","25810291","25810291","0","2024-09"
"314930","바이오다인","607221256000","20600","29476760","29764103","287343","2024-09"
"208710","바이오로그디바이스","28864490832","438","65900664","65900664","0","2024-09"
"086820","바이오솔루션","136481742180","17010","8023618","8143426","119808","2024-09"
"038460","바이오스마트","82955952000","3600","23043320","23933216","889896","2024-09"
"251120","바이오에프디엔씨","143371632690","16810","8528949","8695700","166751","2024-09"
"199730","바이오인프라","39060867010","8030","4864367","4864367","0","2024-09"
"086040","바이오톡스텍","70036114995","4455","15720789","15958247","237458","2024-09"
"099430","바이오플러스","298400478100","5300","56301977","57930864","1628887","2024-09"
"032980","바이온","28695653410","641","44767010","44777990","10980","2024-09"
"308080","바이젠셀","57694901300","2995","19263740","19263740","0","2024-09"
"043150","바텍","343876026400","23150","14854256","14854256","0","2024-09"
"323990","박셀바이오","295094403250","12850","22964545","22993200","28655","2024-09"
"003610","방림","113615410890","3210","35394209","42314090","6919881","2024-09"
"267790","배럴","35379922500","4485","7888500","7888500","0","2024-09"
"001340","백광산업","445022998560","10080","44149107","44918407","769300","2024-09"
"046310","백금T&A","38918544060","2420","16082043","16418641","336598","2024-09"
"035150","백산","279930000000","13020","21500000","21500000","0","2024-09"
"331520","밸로프","33555989376","684","49058464","50864390","1805926","2024-09"
"199480","뱅크웨어글로벌","75156186720","7440","10101638","10101638","0","2024-09"
"438700","버넥트","40010155100","3590","11144890","11144890","0","2024-09"
"066410","버킷스튜디오","96977294204","1153","84108668","84109926","1258","2024-09"
"002410","범양건영","25177571328","1014","24829952","24831982","2030","2024-09"
"382900","범한퓨얼셀","120927425000","14090","8582500","8761000","178500","2024-09"
"206400","베노티앤알","128867234250","3975","32419430","32420452","1022","2024-09"
"019010","베뉴지","86631000000","2155","40200000","48200000","8000000","2024-09"
"177350","베셀","28098995715","315","89203161","89372043","168882","2024-09"
"424760","벨로크","20014191072","1032","19393596","19665002","271406","2024-09"
"007210","벽산","111963770000","2000","55981885","67560000","11578115","2024-09"
"225530","보광산업","140266806860","3860","36338551","36338727","176","2024-09"
"250000","보라티알","63854758500","9750","6549206","6750733","201527","2024-09"
"002760","보락","76731900000","1281","59900000","59900000","0","2024-09"
"003850","보령","717936239000","10900","65865710","68690000","2824290","2024-09"
"310210","보로노이","1849178673000","103000","17953191","18356592","403401","2024-09"
"006910","보성파워텍","157554033280","3220","48929824","49129824","200000","2024-09"
"000890","보해양조","59107126600","425","139075592","139120129","44537","2024-09"
"226340","본느","68843855580","1641","41952380","41952420","40","2024-09"
"003000","부광약품","335085614545","4895","68454671","68454671","0","2024-09"
"001270","부국증권","165107591600","27800","5939122","10369886","4430764","2024-09"
"026940","부국철강","49900000000","2495","20000000","20000000","0","2024-09"
"014470","부방","93433343421","1741","53666481","60052260","6385779","2024-09"
"011390","부산산업","65683200000","62200","1056000","1056000","0","2024-09"
"005030","부산주공","38288532168","486","78782988","78782988","0","2024-09"
"008470","부스타","32003971560","3960","8081811","8404800","322989","2024-09"
"338220","뷰노","405535936400","29200","13888217","13888217","0","2024-09"
"100120","뷰웍스","224956819500","24500","9181911","10001865","819954","2024-09"
"406820","뷰티스킨","49158496400","13910","3534040","3534040","0","2024-09"
"337930","브랜드엑스코퍼레이션","247682572150","8450","29311547","29311547","0","2024-09"
"099390","브레인즈컴퍼니","51926001570","6570","7903501","8208283","304782","2024-09"
"064480","브리지텍","58647697240","5060","11590454","11952500","362046","2024-09"
"288330","브릿지바이오테라퓨틱스","217596099675","4575","47561989","47561989","0","2024-09"
"365900","브이씨","23319857000","3190","7310300","7310300","0","2024-09"
"089970","브이엠","181749018000","8250","22030184","24075595","2045411","2024-09"
"251630","브이원텍","61584772575","4035","15262645","15942886","680241","2024-09"
"018290","브이티","1118014600500","31500","35492527","35798007","305480","2024-09"
"439580","블루엠텍","246303373050","22050","11170221","11170221","0","2024-09"
"033560","블루콤","56997924980","3340","17065247","17100000","34753","2024-09"
"369370","블리츠웨이스튜디오","78034881834","1638","47640343","49871911","2231568","2024-09"
"126340","비나텍","211638394600","35800","5911687","6085118","173431","2024-09"
"121800","비덴트","256296018720","3320","77197596","77201611","4015","2024-09"
"082800","비보존 제약","268475253600","5650","47517744","48242965","725221","2024-09"
"318410","비비씨","45497440170","8190","5555243","5555243","0","2024-09"
"002070","비비안","24520453770","823","29793990","29793990","0","2024-09"
"100220","비상교육","64075423450","5230","12251515","12996741","745226","2024-09"
"419540","비스토스","42233465835","1837","22990455","22992511","2056","2024-09"
"146320","비씨엔씨","164025911680","12920","12695504","12792923","97419","2024-09"
"200780","비씨월드제약","40800461775","4835","8438565","8892384","453819","2024-09"
"413640","비아이매트릭스","53691703000","7450","7206940","7206940","0","2024-09"
"141000","비아트론","73692550920","6680","11031819","12114710","1082891","2024-09"
"090460","비에이치","523455279480","16680","31382211","34464379","3082168","2024-09"
"083650","비에이치아이","385229568300","12450","30942134","30944375","2241","2024-09"
"445360","비엔케이제1호스팩","9051000000","2100","4310000","4310000","0","2024-09"
"473370","비엔케이제2호스팩","8546300000","2030","4210000","4210000","0","2024-09"
"065170","비엘팜텍","21263531728","239","88968752","88970559","1807","2024-09"
"086670","비엠티","79389013800","8700","9125174","9125174","0","2024-09"
"335890","비올","496011854600","8590","57742940","58419125","676185","2024-09"
"230980","비유테크놀러지","21370405721","229","93320549","93320557","8","2024-09"
"138580","비즈니스온","356042480800","15850","22463248","22556163","92915","2024-09"
"082920","비츠로셀","430121548800","19200","22402164","22872213","470049","2024-09"
"054220","비츠로시스","21434021164","436","49160599","49160599","0","2024-09"
"042370","비츠로테크","183138174750","6990","26200025","26200025","0","2024-09"
"050090","비케이홀딩스","15406772410","782","19701755","19784735","82980","2024-09"
"148780","비큐AI","32263313850","1026","31445725","31445725","0","2024-09"
"307870","비투엔","32840962275","725","45297879","45297879","0","2024-09"
"357880","비트나인","20156835080","1930","10443956","10443956","0","2024-09"
"032850","비트컴퓨터","79796257200","4950","16120456","16623293","502837","2024-09"
"238200","비피도","31697500000","3875","8180000","8180000","0","2024-09"
"093190","빅솔론","68027080280","4520","15050239","19238905","4188666","2024-09"
"065450","빅텍","144696640000","5050","28652800","28652800","0","2024-09"
"210120","빅텐츠","74527257000","23700","3144610","3144610","0","2024-09"
"044480","빌리언스","23788280880","585","40663728","40663728","0","2024-09"
"005180","빙그레","559686003300","63300","8841801","9851241","1009440","2024-09"
"069540","빛과전자","59641294600","1405","42449320","42449320","0","2024-09"
"072950","빛샘전자","31401646080","3920","8010624","8052610","41986","2024-09"
"451250","삐아","97152569340","9820","9893337","10089877","196540","2024-09"
"143240","사람인","175220068680","16140","10856262","11709263","853001","2024-09"
"003960","사조대림","372848083650","44650","8350461","9164467","814006","2024-09"
"008040","사조동아원","147570665118","1047","140946194","141144600","198406","2024-09"
"007160","사조산업","348012100000","69700","4993000","5000000","7000","2024-09"
"014710","사조씨푸드","120874171860","7020","17218543","17218543","0","2024-09"
"006090","사조오양","81223984320","8620","9422736","9422739","3","2024-09"
"452430","사피엔반도체","95768156120","11830","8095364","8096454","1090","2024-09"
"419120","산돌","45215234580","6180","7316381","7774326","457945","2024-09"
"062040","산일전기","1248800771700","41100","30384447","30445200","60753","2024-09"
"122350","삼기","54171157536","1427","37961568","38339428","377860","2024-09"
"419050","삼기이브이","123543878400","2160","57196240","57196240","0","2024-09"
"014970","삼륭물산","58505595600","3930","14886920","15125000","238080","2024-09"
"018310","삼목에스폼","310827218700","21850","14225502","14700000","474498","2024-09"
"053700","삼보모터스","95806800360","4310","22228956","22877190","648234","2024-09"
"009620","삼보산업","19479117768","264","73784537","73785902","1365","2024-09"
"023600","삼보판지","142802912220","9110","15675402","16170000","494598","2024-09"
"001470","삼부토건","103532274512","463","223611824","223611824","0","2024-09"
"028050","삼성E&A","3598560000000","18360","196000000","196000000","0","2024-09"
"006400","삼성SDI","22508999816000","344000","65433139","68764530","3331391","2024-09"
"006660","삼성공조","82695258320","10520","7860766","8126314","265548","2024-09"
"028260","삼성물산","22087224532200","136200","162167581","177784107","15616526","2024-09"
"207940","삼성바이오로직스","74519178000000","1047000","71174000","71174000","0","2024-09"
"032830","삼성생명","18406414847500","102500","179574779","200000000","20425221","2024-09"
"425290","삼성스팩6호","11757600000","2130","5520000","5520000","0","2024-09"
"439250","삼성스팩7호","36350760000","10380","3502000","3502000","0","2024-09"
"448740","삼성스팩8호","46873200000","10050","4664000","4664000","0","2024-09"
"468510","삼성스팩9호","22321000000","2020","11050000","11050000","0","2024-09"
"018260","삼성에스디에스","11494237639600","148600","77350186","77377800","27614","2024-09"
"009150","삼성전기","8737782259200","120200","72693696","74693696","2000000","2024-09"
"005930","삼성전자","355799039980000","59600","5969782550","5969782550","0","2024-09"
"001360","삼성제약","148427706792","1577","94120296","94162079","41783","2024-09"
"010140","삼성중공업","8326846817250","9750","854035571","880000000","25964429","2024-09"
"016360","삼성증권","4210495000000","47150","89300000","89300000","0","2024-09"
"068290","삼성출판사","143400000000","14340","10000000","10000000","0","2024-09"
"029780","삼성카드","4220407987250","39550","106710695","115858891","9148196","2024-09"
"000810","삼성화재","14158959228000","355500","39828296","47374837","7546541","2024-09"
"006110","삼아알미늄","765019632000","52000","14711916","14711916","0","2024-09"
"009300","삼아제약","130611518800","21400","6103342","6370000","266658","2024-09"
"145990","삼양사","477517690000","49400","9666350","10313449","647099","2024-09"
"003230","삼양식품","3885684688000","521000","7458128","7533015","74887","2024-09"
"002170","삼양통상","132248000000","48800","2710000","3000000","290000","2024-09"
"272550","삼양패키징","251708976330","16230","15508871","15788671","279800","2024-09"
"000070","삼양홀딩스","529410804000","71200","7435545","8564271","1128726","2024-09"
"003720","삼영","146750456625","4425","33163945","34000000","836055","2024-09"
"002810","삼영무역","223876920800","12700","17628104","18466948","838844","2024-09"
"361670","삼영에스앤씨","36034900680","6460","5578158","5667658","89500","2024-09"
"054540","삼영엠텍","48701950000","4015","12130000","13000000","870000","2024-09"
"065570","삼영이엔씨","34476826115","2165","15924631","15924631","0","2024-09"
"005680","삼영전자","195176618720","9770","19977136","20000000","22864","2024-09"
"023000","삼원강재","103125185820","2595","39739956","40000000","260044","2024-09"
"004380","삼익THK","183816000000","8880","20700000","21000000","300000","2024-09"
"002450","삼익악기","83329882840","1096","76030915","90530915","14500000","2024-09"
"032280","삼일","23188526400","1495","15510720","16213590","702870","2024-09"
"002290","삼일기업공사","35526000000","2865","12400000","12400000","0","2024-09"
"004440","삼일씨엔에스","55192990245","4335","12731947","12731947","0","2024-09"
"000520","삼일제약","334522873020","15810","21158942","21621100","462158","2024-09"
"009770","삼정펄프","67124221350","26850","2499971","2499971","0","2024-09"
"037460","삼지전자","133254596160","8680","15351912","16318522","966610","2024-09"
"032750","삼진","38356496500","4250","9025058","9031122","6064","2024-09"
"054090","삼진엘앤디","21465518618","866","24786973","24959232","172259","2024-09"
"005500","삼진제약","227998316000","18200","12527380","13900000","1372620","2024-09"
"000250","삼천당제약","3028122854400","130200","23257472","23457472","200000","2024-09"
"004690","삼천리","306107835000","89400","3424025","4055025","631000","2024-09"
"024950","삼천리자전거","48289645320","3990","12102668","13273577","1170909","2024-09"
"038500","삼표시멘트","329038636880","3065","107353552","107916306","562754","2024-09"
"437730","삼현","79903068840","7560","10569189","10569189","0","2024-09"
"017480","삼현철강","70882865100","4590","15442890","15702890","260000","2024-09"
"010960","삼호개발","70434000000","3150","22360000","25000000","2640000","2024-09"
"046390","삼화네트웍스","61126011984","1544","39589386","43172933","3583547","2024-09"
"004450","삼화왕관","55753457100","30900","1804319","2154379","350060","2024-09"
"009470","삼화전기","259923126000","39300","6613820","6613820","0","2024-09"
"011230","삼화전자","49942183140","2955","16900908","16902700","1792","2024-09"
"001820","삼화콘덴서","345795700000","33700","10261000","10395000","134000","2024-09"
"000390","삼화페인트","170088730700","7210","23590670","27203469","3612799","2024-09"
"027580","상보","67260698142","1194","56332243","59181279","2849036","2024-09"
"038540","상상인","88598602844","1619","54724276","55328313","604037","2024-09"
"415580","상상인제3호스팩","11177550000","2105","5310000","5310000","0","2024-09"
"452670","상상인제4호스팩","10492200000","2010","5220000","5220000","0","2024-09"
"001290","상상인증권","49093894542","462","106263841","108337120","2073279","2024-09"
"041650","상신브레이크","66018657100","3410","19360310","21471450","2111140","2024-09"
"091580","상신이디피","136081115990","10210","13328219","13428219","100000","2024-09"
"263810","상신전자","46497149055","3265","14241087","14244718","3631","2024-09"
"089980","상아프론테크","329739984450","21150","15590543","15989037","398494","2024-09"
"042940","상지건설","23914066460","6010","3979046","3981814","2768","2024-09"
"042600","새로닉스","167327863920","13680","12231569","12423574","192005","2024-09"
"075180","새론오토모티브","74784000000","3895","19200000","19200000","0","2024-09"
"107600","새빗켐","115322766750","23150","4981545","4981545","0","2024-09"
"411080","샌즈랩","108387353100","7450","14548638","15248638","700000","2024-09"
"252990","샘씨엔에스","326689498020","5730","57013874","58388063","1374189","2024-09"
"007540","샘표","88781365400","44050","2015468","2875800","860332","2024-09"
"248170","샘표식품","134257922400","29400","4566596","4568286","1690","2024-09"
"378800","샤페론","136547930430","4530","30143031","30143031","0","2024-09"
"294630","서남","86565846990","3610","23979459","23979459","0","2024-09"
"038070","서린바이오","60375987100","7150","8444194","8900676","456482","2024-09"
"006730","서부T&D","394707882240","6120","64494752","66426923","1932171","2024-09"
"079650","서산","24040000000","1202","20000000","20000000","0","2024-09"
"100660","서암기계공업","48069000000","3815","12600000","12600000","0","2024-09"
"007860","서연","154338803460","7110","21707286","23479844","1772558","2024-09"
"200880","서연이화","378318514000","14000","27022751","27028437","5686","2024-09"
"019770","서연탑메탈","42930250000","3685","11650000","11650000","0","2024-09"
"017390","서울가스","203070021600","52300","3882792","5000000","1117208","2024-09"
"043710","서울리거","32076741177","639","50198343","50198880","537","2024-09"
"092190","서울바이오시스","185434607300","4100","45227953","45868383","640430","2024-09"
"046890","서울반도체","518708328000","9200","56381340","58305400","1924060","2024-09"
"004410","서울식품","58461843804","156","374755409","374755559","150","2024-09"
"063170","서울옥션","138568658140","8230","16837018","17774267","937249","2024-09"
"027040","서울전자통신","18301688184","263","69588168","69588847","679","2024-09"
"018680","서울제약","46229199835","3965","11659319","11659319","0","2024-09"
"021050","서원","59960407170","1263","47474590","47474590","0","2024-09"
"093920","서원인텍","108252000000","5820","18600000","18600000","0","2024-09"
"189860","서전기전","51888473000","5350","9698780","9698780","0","2024-09"
"178320","서진시스템","1594629495900","28350","56247954","56247954","0","2024-09"
"122690","서진오토모티브","48979646320","2255","21720464","21844410","123946","2024-09"
"140070","서플러스글로벌","113343704460","3290","34450974","36988000","2537026","2024-09"
"011370","서한","77377553620","788","98194865","100894865","2700000","2024-09"
"065710","서호전기","106747100300","21650","4930582","5150000","219418","2024-09"
"008490","서흥","173902927320","15640","11119113","11569113","450000","2024-09"
"035890","서희건설","274691406920","1421","193308520","229808457","36499937","2024-09"
"357550","석경에이티","247474500000","45500","5439000","5455000","16000","2024-09"
"003100","선광","99193300000","15770","6290000","6600000","310000","2024-09"
"007610","선도전기","50907057000","3000","16969019","18000000","1030981","2024-09"
"067370","선바이오","79984664500","6500","12305333","12313555","8222","2024-09"
"171090","선익시스템","372104542500","42500","8755401","9494405","739004","2024-09"
"136490","선진","159082901520","6690","23779208","23779604","396","2024-09"
"086710","선진뷰티사이언스","122744857200","10220","12010260","12203280","193020","2024-09"
"014620","성광벤드","340820404570","12730","26773009","28600000","1826991","2024-09"
"037350","성도이엔지","65688875000","4625","14203000","15470000","1267000","2024-09"
"014910","성문전자","25593697881","1233","20757257","22460985","1703728","2024-09"
"003080","성보화학","51320615020","2620","19588021","20020000","431979","2024-09"
"004980","성신양회","193403077940","8020","24115097","24516073","400976","2024-09"
"011300","성안머티리얼스","36030668960","440","81887884","81887884","0","2024-09"
"081580","성우전자","67660910550","4450","15204699","15508143","303444","2024-09"
"045300","성우테크론","26626460800","2720","9789140","10151583","362443","2024-09"
"015750","성우하이텍","497547708460","6220","79991593","80000000","8407","2024-09"
"365340","성일하이텍","667554085000","55000","12137347","12137347","0","2024-09"
"000180","성창기업지주","95280685600","1366","69751600","69751600","0","2024-09"
"080470","성창오토텍","30404500000","4165","7300000","7300000","0","2024-09"
"043260","성호전자","93638360115","1535","61002189","61002189","0","2024-09"
"148150","세경하이테크","253459911640","7160","35399429","35860429","461000","2024-09"
"002420","세기상사","32852791680","5910","5558848","5558848","0","2024-09"
"188260","세니젠","20301140860","2860","7098301","7228470","130169","2024-09"
"053060","세동","20729179468","1174","17656882","17657419","537","2024-09"
"340440","세림B&G","39417540651","1389","28378359","28378364","5","2024-09"
"017510","세명전기","79279200000","5200","15246000","15246000","0","2024-09"
"004360","세방","215068514760","11990","17937324","19308690","1371366","2024-09"
"004490","세방전지","911605325400","69300","13154478","14000000","845522","2024-09"
"011560","세보엠이씨","101655625500","10250","9917622","10530000","612378","2024-09"
"396300","세아메카닉스","78437552500","2995","26189500","26489500","300000","2024-09"
"001430","세아베스틸지주","708635471440","19760","35862119","35862119","0","2024-09"
"306200","세아제강","322291510000","115100","2800100","2836300","36200","2024-09"
"003030","세아제강지주","646473760000","160000","4040461","4141657","101196","2024-09"
"019440","세아특수강","114992294820","13780","8344869","8570000","225131","2024-09"
"058650","세아홀딩스","391119143600","100400","3895609","4000000","104391","2024-09"
"013000","세우글로벌","35964835193","1253","28702981","28705031","2050","2024-09"
"100700","세운메디칼","119483436000","2760","43291100","43800000","508900","2024-09"
"024830","세원물산","51519500000","6170","8350000","8350000","0","2024-09"
"091090","세원이앤씨","54828158060","1270","43171778","43180255","8477","2024-09"
"021820","세원정공","69800000000","6980","10000000","10000000","0","2024-09"
"067830","세이브존I&C","81088868950","2150","37715753","41040895","3325142","2024-09"
"258830","세종메디칼","22974088612","412","55762351","55786351","24000","2024-09"
"036630","세종텔레콤","94213098944","496","189945764","200000000","10054236","2024-09"
"039310","세중","31785403918","1754","18121667","18121667","0","2024-09"
"075580","세진중공업","405905115840","7140","56849456","56849456","0","2024-09"
"067770","세진티에스","20614787165","2485","8295689","8396593","100904","2024-09"
"053450","세코닉스","79870501620","5460","14628297","14792803","164506","2024-09"
"222810","세토피아","81189010800","1080","75175010","75659350","484340","2024-09"
"252500","세화피앤씨","37669642120","908","41486390","41486390","0","2024-09"
"321370","센서뷰","56902489200","2160","26343745","26343745","0","2024-09"
"347000","센코","79762398450","2450","32556081","33004976","448895","2024-09"
"331920","셀레믹스","31595252760","3870","8164148","8164148","0","2024-09"
"049180","셀루메드","140871366030","2735","51506898","51515906","9008","2024-09"
"299660","셀리드","101821864025","4825","21102977","21102977","0","2024-09"
"268600","셀리버리","248384003120","6680","37183234","37183234","0","2024-09"
"108860","셀바스AI","288251895960","10710","26914276","26914790","514","2024-09"
"208370","셀바스헬스케어","107885243905","4195","25717579","25740564","22985","2024-09"
"318160","셀바이오휴먼텍","31419207700","3580","8776315","9260901","484586","2024-09"
"308430","셀비온","201148952110","15790","12739009","12739009","0","2024-09"
"068270","셀트리온","38972546157300","189100","206094903","217021190","10926287","2024-09"
"068760","셀트리온제약","2603470060900","62900","41390621","41600387","209766","2024-09"
"068940","셀피글로벌","29334496224","778","37705008","38260597","555589","2024-09"
"060230","소니드","44895176586","981","45764706","46066730","302024","2024-09"
"290690","소룩스","400924550400","8800","45559608","45564340","4732","2024-09"
"032680","소프트센","41294645568","396","104279408","105590764","1311356","2024-09"
"258790","소프트캠프","21676701408","904","23978652","24991284","1012632","2024-09"
"066910","손오공","52244285709","1551","33684259","33784259","100000","2024-09"
"336370","솔루스첨단소재","856590035600","12200","70212298","70217344","5046","2024-09"
"248070","솔루엠","896033404560","18410","48671016","50005551","1334535","2024-09"
"035610","솔본","99459411875","3875","25666945","27345997","1679052","2024-09"
"357780","솔브레인","1525398974000","197000","7743142","7778566","35424","2024-09"
"036830","솔브레인홀딩스","1035145809300","50100","20661593","20964056","302463","2024-09"
"304100","솔트룩스","210465354800","17350","12130568","12130568","0","2024-09"
"328380","솔트웨어","36245163962","1058","34258189","34262778","4589","2024-09"
"004430","송원산업","328320000000","13680","24000000","24000000","0","2024-09"
"086980","쇼박스","277536910000","4445","62438000","62638000","200000","2024-09"
"050960","수산아이앤티","66969920000","9920","6751000","6751000","0","2024-09"
"126720","수산인더스트리","318076355000","22600","14074175","14286000","211825","2024-09"
"017550","수산중공업","106452915780","1706","62399130","62399130","0","2024-09"
"084180","수성웹툰","71539518057","609","117470473","117470473","0","2024-09"
"253840","수젠텍","92196698040","6030","15289668","16743200","1453532","2024-09"
"298830","슈어소프트테크","253659904560","4860","52193396","52619061","425665","2024-09"
"236200","슈프리마","175935873000","25500","6899446","7193273","293827","2024-09"
"094840","슈프리마에이치큐","52999448220","5790","9153618","10471840","1318222","2024-09"
"192440","슈피겐코리아","123008572800","20400","6029832","6216363","186531","2024-09"
"424960","스마트레이더시스템","170853699600","10940","15617340","15617340","0","2024-09"
"099440","스맥","116330735040","3120","37285492","40243394","2957902","2024-09"
"053210","스카이라이프","234813379380","4965","47293732","47522955","229223","2024-09"
"276040","스코넥","38353918070","3055","12554474","12554474","0","2024-09"
"159910","스킨앤스킨","26807534910","741","36177510","36410098","232588","2024-09"
"060240","스타코링크","15939853330","505","31564066","32314179","750113","2024-09"
"115570","스타플렉스","23709504090","3005","7890018","7984508","94490","2024-09"
"330730","스톤브릿지벤처스","68432751800","3925","17435096","18150830","715734","2024-09"
"352090","스톰테크","86531053560","3220","26872998","26872998","0","2024-09"
"253450","스튜디오드래곤","1208351619600","40200","30058498","30058498","0","2024-09"
"408900","스튜디오미르","167782041630","5130","32706051","32706134","83","2024-09"
"204630","스튜디오산타클로스","23613109200","4650","5078088","5089941","11853","2024-09"
"415380","스튜디오삼익","33329058600","8220","4054630","4225498","170868","2024-09"
"026890","스틱인베스트먼트","294216149500","8050","36548590","41678175","5129585","2024-09"
"013810","스페코","70272978650","4795","14655470","14655470","0","2024-09"
"203690","스피어파워","63743966440","4840","13170241","13337850","167609","2024-09"
"049830","승일","41943434600","7100","5907526","6132112","224586","2024-09"
"020710","시공테크","65549845875","3475","18863265","20047970","1184705","2024-09"
"033170","시그네틱스","85299677405","995","85728319","85728319","0","2024-09"
"048870","시너지이노베이션","231583363200","2800","82708344","82708344","0","2024-09"
"025320","시노펙스","601003166400","7200","83472662","83817936","345274","2024-09"
"134790","시디즈","49697156800","29600","1678958","2000000","321042","2024-09"
"269620","시스웍","131663951937","889","148103433","148582691","479258","2024-09"
"429270","시지트로닉스","30056687500","6670","4506250","4506250","0","2024-09"
"418250","시큐레터","52279100100","6550","7981542","7981542","0","2024-09"
"131090","시큐브","34755060650","895","38832470","44000000","5167530","2024-09"
"232830","시큐센","23766168160","2030","11707472","11707472","0","2024-09"
"462870","시프트업","3733422080000","64000","58334720","58334720","0","2024-09"
"016590","신대양제지","180659452370","5890","30672233","40297820","9625587","2024-09"
"290520","신도기연","33990114240","2160","15736164","15929362","193198","2024-09"
"029530","신도리코","353533939000","41000","8622779","10080029","1457250","2024-09"
"004970","신라교역","149483950000","9470","15785000","16000000","215000","2024-09"
"001000","신라섬유","24763090800","1020","24277540","24277540","0","2024-09"
"025870","신라에스지","24880000000","6220","4000000","4000000","0","2024-09"
"215600","신라젠","339798009375","2475","137292125","137367125","75000","2024-09"
"065350","신성델타테크","1200171304200","44150","27183948","27483948","300000","2024-09"
"416180","신성에스티","228299919000","25500","8952938","9039778","86840","2024-09"
"011930","신성이엔지","294560000553","1447","203565999","205848151","2282152","2024-09"
"005390","신성통상","322625335550","2245","143708390","143708390","0","2024-09"
"004170","신세계","1375656090900","149100","9226399","9845181","618782","2024-09"
"035510","신세계 I&C","128434563700","9770","13145810","17200000","4054190","2024-09"
"034300","신세계건설","137363108200","18100","7589122","7760554","171432","2024-09"
"031430","신세계인터내셔날","440134590000","12710","34629000","35700000","1071000","2024-09"
"031440","신세계푸드","134949341350","34850","3872291","3872480","189","2024-09"
"006880","신송홀딩스","72506790720","6720","10789701","11828858","1039157","2024-09"
"162300","신스틸","98857120320","2410","41019552","41471382","451830","2024-09"
"290560","신시웨이","24337725520","6280","3875434","3877972","2538","2024-09"
"002800","신신제약","86320145000","5690","15170500","15170500","0","2024-09"
"472220","신영스팩10호","10083500000","2150","4690000","4690000","0","2024-09"
"430220","신영스팩8호","14770600000","2185","6760000","6760000","0","2024-09"
"445970","신영스팩9호","11684800000","2180","5360000","5360000","0","2024-09"
"005800","신영와코루","82170000000","9130","9000000","9000000","0","2024-09"
"001720","신영증권","624694484800","81100","7702768","16440000","8737232","2024-09"
"009270","신원","94265759136","1256","75052356","102586356","27534000","2024-09"
"017000","신원종합개발","35041958820","3130","11195514","11668027","472513","2024-09"
"002700","신일전자","100306438556","1427","70291828","71047521","755693","2024-09"
"012790","신일제약","83691221640","7240","11559561","11986415","426854","2024-09"
"138070","신진에스엠","41815920020","2485","16827332","17503204","675872","2024-09"
"226330","신테카바이오","68129090875","4465","15258475","15258475","0","2024-09"
"002870","신풍","25406750460","917","27706380","34958700","7252320","2024-09"
"019170","신풍제약","593223189160","12040","49271029","52984990","3713961","2024-09"
"418210","신한제10호스팩","8216700000","2245","3660000","3660000","0","2024-09"
"452980","신한제11호스팩","36864750000","1950","18905000","18905000","0","2024-09"
"474660","신한제12호스팩","11592000000","2100","5520000","5520000","0","2024-09"
"474930","신한제13호스팩","7801100000","2155","3620000","3620000","0","2024-09"
"055550","신한지주","28545349870800","56700","503445324","509393214","5947890","2024-09"
"056700","신화인터텍","48535555243","1673","29011091","29135091","124000","2024-09"
"187270","신화콘텍","30079399110","3270","9198593","10143845","945252","2024-09"
"004080","신흥","134940541450","14290","9443005","9500000","56995","2024-09"
"243840","신흥에스이씨","297812394200","7720","38576735","38919035","342300","2024-09"
"257720","실리콘투","2301008245200","37800","60873234","60873234","0","2024-09"
"222800","심텍","521635465260","16380","31845877","31854143","8266","2024-09"
"036710","심텍홀딩스","69458698310","1499","46336690","48350145","2013455","2024-09"
"160980","싸이맥스","112629116560","11020","10220428","10924243","703815","2024-09"
"356890","싸이버원","34374544200","2885","11914920","11916325","1405","2024-09"
"217330","싸이토젠","181095943950","7850","23069547","23129547","60000","2024-09"
"102280","쌍방울","70634046631","269","262580099","262592129","12030","2024-09"
"010280","쌍용정보통신","39269635722","603","65123774","65123786","12","2024-09"
"004770","써니전자","58102157841","1599","36336559","36702884","366325","2024-09"
"208640","썸에이지","32721459690","235","139240254","139240254","0","2024-09"
"222420","쎄노텍","38504813116","847","45460228","45460231","3","2024-09"
"037760","쎄니트","47854197654","1574","30402921","33832921","3430000","2024-09"
"099320","쎄트렉아이","411768052800","37600","10951278","10951278","0","2024-09"
"049960","쎌바이오텍","92529528000","13520","6843900","9400000","2556100","2024-09"
"088280","쏘닉스","46035263400","2660","17306490","17306490","0","2024-09"
"403550","쏘카","609044581120","18560","32814902","32814902","0","2024-09"
"050890","쏠리드","266642367200","4400","60600538","61095231","494693","2024-09"
"475400","씨메스","199931170800","17480","11437710","11437710",,"자료 없음"
"109670","씨싸이트","54735104620","9380","5835299","5836602","1303","2024-09"
"066790","씨씨에스","94477821482","1562","60485161","65152039","4666878","2024-09"
"222080","씨아이에스","625479731440","8720","71729327","71729327","0","2024-09"
"004920","씨아이테크","71293689232","1424","50065793","50065793","0","2024-09"
"352480","씨앤씨인터내셔널","663807705600","66400","9997104","10013941","16837","2024-09"
"264660","씨앤지하이테크","119020405680","12760","9327618","9627896","300278","2024-09"
"352700","씨앤투스","74076987870","2895","25587906","27276899","1688993","2024-09"
"458870","씨어스테크놀로지","149992576000","11950","12551680","12551680","0","2024-09"
"297090","씨에스베어링","145349100000","5330","27270000","27270000","0","2024-09"
"112610","씨에스윈드","2324193884100","56100","41429481","42171403","741922","2024-09"
"359090","씨엔알리서치","68587260300","1215","56450420","56450891","471","2024-09"
"115530","씨엔플러스","28884275000","425","67963000","67963000","0","2024-09"
"115480","씨유메디칼","35949044826","747","48124558","48224558","100000","2024-09"
"340810","씨유박스","34178108175","3225","10597863","10597863","0","2024-09"
"376290","씨유테크","55709412500","3155","17657500","17657500","0","2024-09"
"189330","씨이랩","41122917000","6750","6092284","6092284","0","2024-09"
"096530","씨젠","1064612839400","23050","46187108","52225994","6038886","2024-09"
"101240","씨큐브","50451665280","4880","10338456","10340947","2491","2024-09"
"060590","씨티씨바이오","187683883750","7850","23908775","24181020","272245","2024-09"
"308170","씨티알모빌리티","47527200000","5520","8610000","8610000","0","2024-09"
"260930","씨티케이","109105538310","5790","18843789","19341591","497802","2024-09"
"052300","씨티프라퍼티","62059298832","368","168639399","168651433","12034","2024-09"
"413630","씨피시스템","96245055400","2600","37017329","38703425","1686096","2024-09"
"013990","아가방컴퍼니","137052792720","4560","30055437","32887536","2832099","2024-09"
"123860","아나패스","218221470000","18000","12123415","12123415","0","2024-09"
"025980","아난티","458214401260","5170","88629478","88629478","0","2024-09"
"008700","아남전자","98252574420","1274","77121330","77124820","3490","2024-09"
"125210","아모그린텍","116302369500","7050","16496790","16496790","0","2024-09"
"002790","아모레G","1761884932500","23100","76272075","82458180","6186105","2024-09"
"090430","아모레퍼시픽","7039849795000","120500","58421990","58492759","70769","2024-09"
"357580","아모센스","80673698160","7190","11220264","11220264","0","2024-09"
"052710","아모텍","59838375870","4095","14612546","14615109","2563","2024-09"
"074430","아미노로직스","103635675920","1180","87826844","87826844","0","2024-09"
"092040","아미코젠","264762332940","4830","54816218","55018347","202129","2024-09"
"083930","아바코","226465059600","15600","14516991","14912798","395807","2024-09"
"149950","아바텍","161304614900","11660","13834015","15607500","1773485","2024-09"
"036010","아비코전자","69123256800","5200","13292934","13292934","0","2024-09"
"002030","아세아","426861732000","254000","1680558","2115648","435090","2024-09"
"183190","아세아시멘트","405259829650","10790","37558835","38501886","943051","2024-09"
"002310","아세아제지","327252334500","8190","39957550","42782510","2824960","2024-09"
"050860","아세아텍","44148482980","2230","19797526","22500000","2702474","2024-09"
"012170","아센디오","46295515542","447","103569386","103569488","102","2024-09"
"136410","아셈스","86305701720","8120","10628781","11019106","390325","2024-09"
"246720","아스타","56236458500","4145","13567300","13567300","0","2024-09"
"067390","아스트","184421838920","536","344070595","344203992","133397","2024-09"
"159010","아스플로","78711971100","6090","12924790","13334739","409949","2024-09"
"127710","아시아경제","45130978026","1293","34904082","34904082","0","2024-09"
"267850","아시아나IDT","199689000000","17990","11100000","11100000","0","2024-09"
"020560","아시아나항공","750814698760","10090","74411764","74411764","0","2024-09"
"154030","아시아종묘","27239677200","2350","11591352","11591352","0","2024-09"
"227610","아우딘퓨쳐스","48918774060","1380","35448387","35583547","135160","2024-09"
"143160","아이디스","150401880600","14920","10080555","10716390","635835","2024-09"
"054800","아이디스홀딩스","80102693630","9070","8831609","10347756","1516147","2024-09"
"332370","아이디피","47489654310","3765","12613454","13273726","660272","2024-09"
"122900","아이마켓코리아","262097952200","8330","31464340","33428840","1964500","2024-09"
"339950","아이비김영","76580417820","1766","43363770","44946655","1582885","2024-09"
"469750","아이비젼웍스","47690674944","1408","33871218","33936481","65263","2024-09"
"460470","아이빔테크놀로지","76477755900","5070","15084370","15084370","0","2024-09"
"099190","아이센스","538310047280","19480","27633986","27637273","3287","2024-09"
"461300","아이스크림미디어","186301213280","14560","12795413","13063433","268020","2024-09"
"289010","아이스크림에듀","29944776050","2390","12529195","12864037","334842","2024-09"
"214430","아이쓰리시스템","259271822700","37350","6941682","7106760","165078","2024-09"
"040910","아이씨디","77886701025","4775","16311351","18574275","2262924","2024-09"
"368600","아이씨에이치","61615620855","3585","17187063","17538346","351283","2024-09"
"456010","아이씨티케이","104585197360","7910","13221896","13221896","0","2024-09"
"052860","아이앤씨","26242630953","1617","16229209","17862854","1633645","2024-09"
"464500","아이언디바이스","61507949815","4505","13653263","13653263","0","2024-09"
"010780","아이에스동서","609776915200","20200","30186976","30186976","0","2024-09"
"038880","아이에이","63066816477","207","304670611","315334702","10664091","2024-09"
"307180","아이엘사이언스","82885234915","3065","27042491","27042828","337","2024-09"
"101390","아이엠","33696180945","3205","10513629","10548085","34456","2024-09"
"461030","아이엠비디엑스","211668025000","15100","14017750","14017750","0","2024-09"
"451220","아이엠티","75832503930","9630","7874611","7874611","0","2024-09"
"090150","아이윈","35664820728","898","39715836","41875293","2159457","2024-09"
"123010","아이윈플러스","21560634655","665","32422007","32658542","236535","2024-09"
"031310","아이즈비전","43436499106","1778","24429977","25334636","904659","2024-09"
"185490","아이진","78386373600","2900","27029784","27029784","0","2024-09"
"059100","아이컴포넌트","30387995600","4600","6606086","7070860","464774","2024-09"
"262840","아이퀘스트","41119838380","2185","18819148","19290000","470852","2024-09"
"175250","아이큐어","92863667225","2485","37369685","37558368","188683","2024-09"
"052460","아이크래프트","28579467040","2390","11957936","14607936","2650000","2024-09"
"119830","아이텍","116250508920","5460","21291302","21434297","142995","2024-09"
"052770","아이톡시","68131104886","1391","48979946","48979946","0","2024-09"
"124500","아이티센","143868067400","6200","23204527","23204527","0","2024-09"
"372800","아이티아이즈","34026802200","5780","5886990","6026990","140000","2024-09"
"084850","아이티엠반도체","378189819880","18280","20688721","22682934","1994213","2024-09"
"114840","아이패밀리에스씨","317917086240","18460","17221944","17221944","0","2024-09"
"027360","아주IB투자","233505127376","1972","118410308","120945406","2535098","2024-09"
"139990","아주스틸","133118321880","5020","26517594","26517744","150","2024-09"
"032080","아즈텍WB","23823682915","1135","20990029","21491029","501000","2024-09"
"013310","아진산업","105934761660","2730","38803942","38806582","2640","2024-09"
"059120","아진엑스텍","71409257400","7800","9155033","9748596","593563","2024-09"
"009320","아진전자부품","54673444930","1109","49299770","49299770","0","2024-09"
"158430","아톤","89762080800","4200","21371924","22602474","1230550","2024-09"
"321820","아티스트유나이티드","222557386500","16650","13366810","13366810","0","2024-09"
"001540","안국약품","81035052450","7130","11365365","13042420","1677055","2024-09"
"053800","안랩","575168075800","58700","9798434","11126506","1328072","2024-09"
"065660","안트로젠","146067908730","15010","9731373","9731373","0","2024-09"
"297570","알로이스","37910233710","1095","34621218","34621218","0","2024-09"
"001780","알루코","225130056900","2325","96830132","96830132","0","2024-09"
"260660","알리코제약","56825684935","3785","15013391","15327021","313630","2024-09"
"354320","알멕","198132811000","31000","6391381","6391381","0","2024-09"
"361570","알비더블유","64858934115","2265","28635291","28635291","0","2024-09"
"131370","알서포트","154440261770","2965","52087778","53267083","1179305","2024-09"
"140670","알에스오토메이션","96265003280","10420","9238484","9303140","64656","2024-09"
"096610","알에프세미","51550708615","2965","17386411","17386411","0","2024-09"
"061040","알에프텍","92883510300","2975","31221348","32089259","867911","2024-09"
"148250","알엔투테크놀로지","28948401375","4035","7174325","7391186","216861","2024-09"
"347860","알체라","50645236400","2300","22019668","22019668","0","2024-09"
"196170","알테오젠","20571916320000","386000","53295120","53318828","23708","2024-09"
"123750","알톤","20370075200","1600","12731297","12746297","15000","2024-09"
"085810","알티캐스트","41271616830","1362","30302215","31081959","779744","2024-09"
"043100","알파녹스","21752902080","2730","7968096","7975920","7824","2024-09"
"117670","알파홀딩스","37743429465","945","39940137","39940137","0","2024-09"
"314140","알피바이오","52418042520","6060","8649842","8666361","16519","2024-09"
"291650","압타머사이언스","37016949360","2180","16980252","16980252","0","2024-09"
"293780","압타바이오","207239076000","8380","24730200","24730200","0","2024-09"
"018250","애경산업","404798121000","15750","25701468","26409935","708467","2024-09"
"161000","애경케미칼","503046610920","10420","48277026","48648709","371683","2024-09"
"196300","애니젠","78044031000","13000","6003387","6003387","0","2024-09"
"310200","애니플러스","119664128140","2690","44484806","45520979","1036173","2024-09"
"299910","애닉","32483121920","6880","4721384","4721384","0","2024-09"
"179530","애드바이오텍","29386527460","3215","9140444","9140444","0","2024-09"
"205500","액션스퀘어","56911646760","1096","51926685","51928120","1435","2024-09"
"052790","액토즈소프트","72866728490","6670","10924547","11330638","406091","2024-09"
"290740","액트로","52261031200","5600","9332327","10065011","732684","2024-09"
"238090","앤디포스","88652326670","3895","22760546","23541303","780757","2024-09"
"092600","앤씨앤","29754623430","1215","24489402","25083517","594115","2024-09"
"129890","앱코","58672021800","1225","47895528","50643410","2747882","2024-09"
"174900","앱클론","277756269340","15940","17425111","17425111","0","2024-09"
"255440","야스","122132906280","10120","12068469","13058000","989531","2024-09"
"030960","양지사","125410319100","9130","13736070","15980000","2243930","2024-09"
"102120","어보브반도체","162677714440","9860","16498754","17780753","1281999","2024-09"
"263540","어스앤에어로스페이스","1343206420","94","14289430","14294091","4661","2023-12"
"238120","얼라인드","43208582480","3005","14378896","14378896","0","2024-09"
"019990","에너토크","60957186290","6370","9569417","9756088","186671","2024-09"
"011090","에넥스","31193147086","526","59302561","59991641","689080","2024-09"
"270660","에브리봇","194845278060","15930","12231342","12231342","0","2024-09"
"038680","에스넷","66986891785","3685","18178261","19549677","1371416","2024-09"
"137310","에스디바이오센서","1080328124780","8830","122347466","124477353","2129887","2024-09"
"217480","에스디생명공학","54756837359","499","109733141","109733141","0","2024-09"
"121890","에스디시스템","18794104644","1414","13291446","13291446","0","2024-09"
"304360","에스바이오메딕스","339453504400","28900","11745796","11745796","0","2024-09"
"389500","에스비비테크","87045404400","14600","5962014","6174904","212890","2024-09"
"042110","에스씨디","69981208672","1448","48329564","48329564","0","2024-09"
"298060","에스씨엠생명과학","38834237780","1898","20460610","20467248","6638","2024-09"
"065420","에스아이리소스","18537856106","259","71574734","71577299","2565","2024-09"
"103230","에스앤더블류","24768000000","3440","7200000","7200000","0","2024-09"
"260970","에스앤디","97196534400","33600","2892754","2892754","0","2024-09"
"101490","에스앤에스텍","486044640000","23200","20950200","21451447","501247","2024-09"
"095910","에스에너지","27891765088","1496","18644228","19504503","860275","2024-09"
"275630","에스에스알","17666288120","3265","5410808","6017989","607181","2024-09"
"031330","에스에이엠티","304340609040","3120","97545067","99995067","2450000","2024-09"
"060540","에스에이티","37500760290","1435","26132934","26133306","372","2024-09"
"351320","에스에이티이엔지","33948172392","1542","22015676","22015886","210","2024-09"
"056190","에스에프에이","664423316100","21150","31414814","35908760","4493946","2024-09"
"080000","에스엔유","59399021136","1736","34216026","34322870","106844","2024-09"
"005850","에스엘","1478380330200","32100","46055462","46448520","393058","2024-09"
"214310","에스엘에너지","22487615640","6120","3674447","3679130","4683","2024-09"
"246250","에스엘에스바이오","45046984610","2935","15348206","15348206","0","2024-09"
"041510","에스엠","1620944052000","70800","22894690","23353627","458937","2024-09"
"010580","에스엠벡셀","136216284568","1226","111106268","111251760","145492","2024-09"
"007820","에스엠코어","94639240080","4840","19553562","20033946","480384","2024-09"
"464080","에스오에스랩","99195066300","5610","17681830","17681830","0","2024-09"
"109610","에스와이","182435598200","3820","47758010","48907400","1149390","2024-09"
"365330","에스와이스틸텍","170803800000","5580","30610000","30610000","0","2024-09"
"012750","에스원","2116520961400","62600","33810239","37999178","4188939","2024-09"
"031860","에스유홀딩스","17169645366","1143","15021562","15026356","4794","2024-09"
"306040","에스제이그룹","53289443360","5660","9415096","9865828","450732","2024-09"
"457940","에스케이증권제10호스팩","7050300000","2130","3310000","3310000","0","2024-09"
"472230","에스케이증권제11호스팩","8663175000","2085","4155000","4155000","0","2024-09"
"473000","에스케이증권제12호스팩","6951000000","2100","3310000","3310000","0","2024-09"
"473950","에스케이증권제13호스팩","9105200000","2060","4420000","4420000","0","2024-09"
"435870","에스케이증권제8호스팩","7849200000","2110","3720000","3720000","0","2024-09"
"455910","에스케이증권제9호스팩","10717700000","2135","5020000","5020000","0","2024-09"
"096630","에스코넥","54835550115","703","78002205","79052205","1050000","2024-09"
"069510","에스텍","91921300000","10930","8410000","10910000","2500000","2024-09"
"234300","에스트래픽","117373716975","4265","27520215","27809848","289633","2024-09"
"039440","에스티아이","299898906450","20350","14737047","15830000","1092953","2024-09"
"098660","에스티오","37625468800","3100","12137248","12500976","363728","2024-09"
"052020","에스티큐브","263073564360","5640","46644249","46694249","50000","2024-09"
"237690","에스티팜","1904198243000","94700","20107690","20107690","0","2024-09"
"050760","에스폴리텍","24075276871","1559","15442769","16334678","891909","2024-09"
"288620","에스퓨얼셀","73841163280","10580","6979316","6979316","0","2024-09"
"443670","에스피소프트","156087407100","6450","24199598","24201392","1794","2024-09"
"317830","에스피시스템스","53396269500","5250","10170718","10773818","603100","2024-09"
"058610","에스피지","467942296000","21100","22177360","22177360","0","2024-09"
"043340","에쎈테크","46550000000","490","95000000","95000000","0","2024-09"
"023960","에쓰씨엔지니어링","62655996264","1844","33978306","33978308","2","2024-09"
"298690","에어부산","277465121920","2380","116581984","116640000","58016","2024-09"
"054630","에이디칩스","12594094838","158","79709461","79709461","0","2024-09"
"200710","에이디테크놀로지","187194562450","14450","12954641","13440822","486181","2024-09"
"096690","에이루트","41739673784","1247","33472072","33477189","5117","2024-09"
"078520","에이블씨엔씨","184700521800","7100","26014158","26014161","3","2024-09"
"298380","에이비엘바이오","1823413592550","37950","48047789","48047789","0","2024-09"
"203400","에이비온","216680791480","8590","25224772","25224772","0","2024-09"
"195990","에이비프로바이오","150599902274","529","284687906","284689721","1815","2024-09"
"003800","에이스침대","288732445750","27350","10556945","11090000","533055","2024-09"
"088800","에이스테크","122180916196","964","126743689","127068928","325239","2024-09"
"241840","에이스토리","64308217050","6930","9279685","9539994","260309","2024-09"
"453860","에이에스텍","127637619750","22650","5635215","5657215","22000","2024-09"
"312610","에이에프더블류","33504892752","1654","20256888","20256888","0","2024-09"
"015260","에이엔피","30270915598","671","45113138","45116894","3756","2024-09"
"172670","에이엘티","78844432500","8900","8858925","8960259","101334","2024-09"
"445090","에이직랜드","410939820900","38150","10771686","10771686","0","2024-09"
"295310","에이치브이엠","173173096050","14550","11901931","11901931","0","2024-09"
"072990","에이치시티","74193767840","10480","7079558","7287341","207783","2024-09"
"044990","에이치엔에스하이텍","130827121920","16280","8036064","8036064",,"자료 없음"
"239610","에이치엘사이언스","78482374910","15410","5092951","5392115","299164","2024-09"
"462020","에이치엠씨제6호스팩","8863800000","2040","4345000","4345000","0","2024-09"
"477340","에이치엠씨제7호스팩","14967430000","1993","7510000","7510000","0","2024-09"
"148930","에이치와이티씨","43360387600","4460","9722060","10175213","453153","2024-09"
"044780","에이치케이","23590522155","1285","18358383","18505787","147404","2024-09"
"357230","에이치피오","121125134285","2935","41269211","42089487","820276","2024-09"
"355690","에이텀","34213523400","6330","5404980","5404980","0","2024-09"
"071670","에이테크솔루션","61700000000","6170","10000000","10000000","0","2024-09"
"045660","에이텍","115039198500","15250","7543554","8260000","716446","2024-09"
"224110","에이텍모빌리티","65154189920","13280","4906189","5340000","433811","2024-09"
"021080","에이티넘인베스트","119585895000","2600","45994575","48000000","2005425","2024-09"
"200470","에이팩트","122211568665","2885","42361029","42362093","1064","2024-09"
"262260","에이프로","104439519750","7250","14405451","14468152","62701","2024-09"
"007460","에이프로젠","302813936420","1138","266093090","286851768","20758678","2024-09"
"003060","에이프로젠바이오로직스","162997564950","825","197572806","198407845","835039","2024-09"
"397030","에이프릴바이오","461353186800","21050","21917016","21917016","0","2024-09"
"244920","에이플러스에셋","95743579855","4235","22607693","22607693","0","2024-09"
"278470","에이피알","1984308631500","266500","7445811","7622678","176867","2024-09"
"230240","에치에프알","131237740000","10000","13123774","13309000","185226","2024-09"
"230360","에코마케팅","328526222760","10440","31468029","31468029","0","2024-09"
"038870","에코바이오","55980988185","3995","14012763","14014949","2186","2024-09"
"097780","에코볼트","59264045750","875","67730338","67730338","0","2024-09"
"448280","에코아이","191022011620","19340","9877043","9877043","0","2024-09"
"101360","에코앤드림","696641546200","39700","17547646","17786114","238468","2024-09"
"128540","에코캡","32541250328","1252","25991414","26690460","699046","2024-09"
"086520","에코프로","10776666971000","81800","131744095","133138340","1394245","2024-09"
"450080","에코프로머티","8212494102200","118900","69070598","69070598","0","2024-09"
"247540","에코프로비엠","16973322077800","173800","97660081","97801344","141263","2024-09"
"383310","에코프로에이치엔","702081799800","46050","15246076","15304932","58856","2024-09"
"038110","에코플라스틱","112500466400","2800","40178738","41169370","990632","2024-09"
"073540","에프알텍","14569200000","1278","11400000","11400000","0","2024-09"
"064850","에프앤가이드","117868729560","10330","11410332","11410332","0","2024-09"
"036810","에프에스티","368188052400","18450","19955992","21756789","1800797","2024-09"
"173940","에프엔씨엔터","55083917790","3690","14927891","15392808","464917","2024-09"
"083500","에프엔에스테크","75457696000","9440","7993400","8575722","582322","2024-09"
"054940","엑사이엔씨","24283037136","732","33173548","33173548","0","2024-09"
"373110","엑셀세라퓨틱스","63873002700","5850","10918462","10918462","0","2024-09"
"205100","엑셈","123406968440","1715","71957416","71963431","6015","2024-09"
"356680","엑스게이트","157218934820","5510","28533382","28543492","10110","2024-09"
"070300","엑스큐어","37749313360","4520","8351618","8351618","0","2024-09"
"317770","엑스페릭스","77533502280","3380","22938906","22938906","0","2024-09"
"373200","엑스플러스","47921186508","633","75704876","75705657","781","2024-09"
"069920","엑시온그룹","44386106688","1268","35004816","35194116","189300","2024-09"
"092870","엑시콘","147028329840","11760","12502409","13050797","548388","2024-09"
"317870","엔바이오니아","158991157500","18690","8506750","8506750","0","2024-09"
"067570","엔브이에이치코리아","104695325205","2505","41794541","42170000","375459","2024-09"
"236810","엔비티","60559701250","3755","16127750","16975426","847676","2024-09"
"333620","엔시스","97639375050","9450","10332209","10556344","224135","2024-09"
"101400","엔시트론","26542852042","427","62161246","62162413","1167","2024-09"
"036570","엔씨소프트","4275876220000","214000","19980730","21954022","1973292","2024-09"
"078860","엔에스이엔엠","94913040200","9020","10522510","10531054","8544","2024-09"
"422040","엔에이치스팩23호","15036000000","2100","7160000","7160000","0","2024-09"
"437780","엔에이치스팩24호","10663600000","2120","5030000","5030000","0","2024-09"
"438580","엔에이치스팩25호","6613800000","2190","3020000","3020000","0","2024-09"
"439410","엔에이치스팩26호","18348000000","2085","8800000","8800000","0","2024-09"
"440820","엔에이치스팩27호","16380000000","2100","7800000","7800000","0","2024-09"
"451700","엔에이치스팩29호","28771750000","2005","14350000","14350000","0","2024-09"
"466910","엔에이치스팩30호","18154500000","1995","9100000","9100000","0","2024-09"
"481890","엔에이치스팩31호","12816900000","2020","6345000","6345000","0","2024-09"
"265740","엔에프씨","48678310000","5450","8931800","8931800","0","2024-09"
"354200","엔젠바이오","46985615280","3420","13738484","13738484","0","2024-09"
"455900","엔젤로보틱스","360183682100","24100","14945381","14945381","0","2024-09"
"419080","엔젯","93909698100","9300","10097817","10517817","420000","2024-09"
"208860","엔지스테크널러지","41831348265","2205","18971133","18971133","0","2024-09"
"183490","엔지켐생명과학","116322863051","1457","79837243","85065562","5228319","2024-09"
"085310","엔케이","61053369228","774","78880322","79983352","1103030","2024-09"
"182400","엔케이맥스","172744574320","2020","85517116","85518831","1715","2024-09"
"348370","엔켐","3760354370700","180900","20786923","20786923","0","2024-09"
"069410","엔텔스","35300653840","3560","9915914","10244824","328910","2024-09"
"227950","엔투텍","44951780020","434","103575530","103575530","0","2024-09"
"291230","엔피","95908284525","2175","44095763","44095775","12","2024-09"
"198080","엔피디","56529860625","2625","21535185","21535185","0","2024-09"
"048830","엔피케이","21911005284","1172","18695397","18723923","28526","2024-09"
"096870","엘디티","15427104000","2310","6678400","6678400","0","2024-09"
"290650","엘앤씨바이오","416267749850","18350","22684891","22684891","0","2024-09"
"066970","엘앤에프","3862494377700","115100","33557727","36296338","2738611","2024-09"
"156100","엘앤케이바이오","154110946090","7730","19936733","19936743","10","2024-09"
"073110","엘엠에스","36848080360","6370","5784628","8895755","3111127","2024-09"
"083310","엘오티베큠","155975383160","9640","16180019","17810033","1630014","2024-09"
"037950","엘컴텍","103482254982","1226","84406407","84447519","41112","2024-09"
"170920","엘티씨","101399424380","10930","9277166","9805620","528454","2024-09"
"058630","엠게임","118684422120","6380","18602574","19543877","941303","2024-09"
"058970","엠로","554161316500","46750","11853718","11853718","0","2024-09"
"019590","엠벤처투자","104963185182","921","113966542","113966542","0","2024-09"
"169330","엠브레인","39065219600","2200","17756918","18256918","500000","2024-09"
"097520","엠씨넥스","296486958440","17170","17267732","17977732","710000","2024-09"
"373170","엠아이큐브솔루션","38288268000","7600","5037930","5037930","0","2024-09"
"179290","엠아이텍","272842665540","8430","32365678","32365678","0","2024-09"
"009780","엠에스씨","92576000000","5260","17600000","17600000","0","2024-09"
"123040","엠에스오토텍","173545308735","3155","55006437","69172213","14165776","2024-09"
"323230","엠에프엠코리아","6967193212","161","43274492","43274492","0","2024-06"
"032790","엠젠솔루션","56451659408","1319","42798832","42798832","0","2024-09"
"033160","엠케이전자","168062773200","8040","20903330","22066331","1163001","2024-09"
"347890","엠투아이","91281200040","5580","16358638","16913204","554566","2024-09"
"033310","엠투엔","78966999720","1995","39582456","40342231","759775","2024-09"
"259630","엠플러스","114805680510","9510","12072101","12282402","210301","2024-09"
"105550","엣지파운드리","146914705350","2570","57165255","57165255","0","2024-09"
"060850","영림원소프트랩","55697350000","6850","8131000","8131000","0","2024-09"
"014440","영보화학","65422500000","3355","19500000","20000000","500000","2024-09"
"143540","영우디에스피","31629243200","724","43686800","44599895","913095","2024-09"
"111770","영원무역","1719273479400","40200","42767997","44311468","1543471","2024-09"
"009970","영원무역홀딩스","1016589064800","87600","11604898","13635592","2030694","2024-09"
"003520","영진약품","434369578250","2375","182892454","182892731","277","2024-09"
"000670","영풍","665691858000","387000","1720134","1842040","121906","2024-09"
"036560","영풍정밀","340200000000","21600","15750000","15750000","0","2024-09"
"006740","영풍제지","55297766340","1252","44167545","46482148","2314603","2024-09"
"012280","영화금속","38782200830","766","50629505","51664505","1035000","2024-09"
"265560","영화테크","91238948000","8600","10609180","10690180","81000","2024-09"
"012160","영흥","31767361198","466","68170303","101310372","33140069","2024-09"
"036000","예림당","48141638930","2090","23034277","23034277","0","2024-09"
"250930","예선테크","17353274877","531","32680367","33000440","320073","2024-09"
"053280","예스24","153411903280","6140","24985652","25000000","14348","2024-09"
"015360","예스코홀딩스","224752500000","52500","4281000","6000000","1719000","2024-09"
"122640","예스티","394661822500","19580","20156375","20930108","773733","2024-09"
"045060","오공","45743329800","2700","16941974","16941974","0","2024-09"
"080520","오디텍","35809228480","3460","10349488","11746609","1397121","2024-09"
"007310","오뚜기","1427320705000","415000","3439327","4007830","568503","2024-09"
"039830","오로라","55742883600","5640","9883490","10762890","879400","2024-09"
"322310","오로스테크놀로지","150138354600","16300","9210942","9366542","155600","2024-09"
"046120","오르비텍","65496113760","2415","27120544","27449486","328942","2024-09"
"014940","오리엔탈정공","154633046155","3395","45547289","45573661","26372","2024-09"
"002630","오리엔트바이오","52999952322","447","118568126","118583005","14879","2024-09"
"065500","오리엔트정공","38230497570","1205","31726554","31742912","16358","2024-09"
"271560","오리온","3842198193600","97200","39528788","39536132","7344","2024-09"
"001800","오리온홀딩스","998600439800","16600","60156653","62645422","2488769","2024-09"
"010470","오리콤","84714565500","7300","11604735","11975050","370315","2024-09"
"417860","오브젠","43597241760","9840","4430614","4430614","0","2024-09"
"352910","오비고","84041383300","6650","12637802","12637802","0","2024-09"
"053980","오상자이엘","69923346090","3705","18872698","18982783","110085","2024-09"
"036220","오상헬스케어","176057162280","12840","13711617","14489416","777799","2024-09"
"052420","오성첨단소재","143586048207","1723","83334909","86315192","2980283","2024-09"
"039200","오스코텍","1107168895200","28950","38244176","38244176","0","2024-09"
"226400","오스테오닉","115643206960","5840","19801919","20661601","859682","2024-09"
"031510","오스템","34811723667","1329","26193923","28000000","1806077","2024-09"
"368970","오에스피","29814250400","3190","9346160","9346160","0","2024-09"
"138080","오이솔루션","105502518000","10350","10193480","10624095","430615","2024-09"
"080580","오킨스전자","102012515050","5930","17202785","17679298","476513","2024-09"
"067170","오텍","47802143485","3365","14205689","15391605","1185916","2024-09"
"353590","오토앤","61480846750","4775","12875570","12875570","0","2024-09"
"173130","오파스넷","116996463480","8970","13043084","13046473","3389","2024-09"
"440320","오픈놀","45887400000","4680","9805000","9805000","0","2024-09"
"049480","오픈베이스","68694357440","2290","29997536","31422383","1424847","2024-09"
"394280","오픈엣지테크놀로지","255436167630","11690","21850827","21850827","0","2024-09"
"309930","오하임앤컴퍼니","40330793028","1964","20535027","21290990","755963","2024-09"
"244460","올리패스","18290883206","454","40288289","40290730","2441","2024-09"
"226950","올릭스","465432021000","27000","17238223","17238223","0","2024-09"
"057540","옴니시스템","44686102782","753","59344094","61449355","2105261","2024-09"
"131030","옵투스제약","98824481610","6470","15274263","16153162","878899","2024-09"
"082210","옵트론텍","58588527900","2100","27899299","28566538","667239","2024-09"
"109080","옵티시스","34055874120","7160","4756407","5636000","879593","2024-09"
"380540","옵티코어","32469315762","1131","28708502","29779596","1071094","2024-09"
"153710","옵티팜","74229987480","5060","14669958","14669958","0","2024-09"
"432430","와이랩","83589608800","5090","16422320","16422320","0","2024-09"
"338840","와이바이오로직스","164680103400","11150","14769516","14769516","0","2024-09"
"122990","와이솔","169903212620","6140","27671533","28186941","515408","2024-09"
"232140","와이씨","929799567460","11590","80224294","82045350","1821056","2024-09"
"112290","와이씨켐","164801883500","16300","10110545","10110545","0","2024-09"
"065530","와이어블","68313747852","1428","47838759","52860000","5021241","2024-09"
"067900","와이엔텍","117466786910","6490","18099659","18199659","100000","2024-09"
"007530","와이엠","51174331350","2690","19023915","19174452","150537","2024-09"
"155650","와이엠씨","73987870960","4090","18089944","19474358","1384414","2024-09"
"273640","와이엠텍","127749529050","12090","10566545","10966000","399455","2024-09"
"251370","와이엠티","133452315520","8180","16314464","16314464","0","2024-09"
"066430","와이오엠","22038703686","563","39145122","39153476","8354","2024-09"
"209640","와이제이링크","222283185990","15630","14221573","14221573",,"자료 없음"
"273060","와이즈버즈","47684298375","945","50459575","50459582","7","2024-09"
"019210","와이지-원","170555000520","5080","33573819","33573819","0","2024-09"
"122870","와이지엔터테인먼트","752075902900","40550","18546878","18691049","144171","2024-09"
"011690","와이투솔루션","98187125970","2685","36568762","36574394","5632","2024-09"
"332570","와이팜","104793511520","2540","41257288","42233850","976562","2024-09"
"079000","와토스코리아","40437458710","5690","7106759","7200000","93241","2024-09"
"403490","우듬지팜","84272903240","1864","45210785","45212464","1679","2024-09"
"316140","우리금융지주","11999406904960","16160","742537556","742591501","53945","2024-09"
"032820","우리기술","366166445300","2305","158857460","158859048","1588","2024-09"
"041190","우리기술투자","737439847320","9470","77871156","84000000","6128844","2024-09"
"115440","우리넷","84212973950","8050","10461239","10754239","293000","2024-09"
"046970","우리로","49778833079","1147","43399157","43824999","425842","2024-09"
"082850","우리바이오","168058265680","3560","47207378","48456578","1249200","2024-09"
"215360","우리산업","107942166660","11820","9132163","9132163","0","2024-09"
"072470","우리산업홀딩스","56840024290","3010","18883729","18887341","3612","2024-09"
"073560","우리손에프앤지","96932700200","1400","69237643","69237643","0","2024-09"
"037400","우리엔터프라이즈","31501835964","1299","24250836","26223346","1972510","2024-09"
"153490","우리이앤엘","43346288700","857","50579100","51480000","900900","2024-09"
"101170","우림피티에스","68067045300","5150","13216902","13500000","283098","2024-09"
"006980","우성","41093763560","16010","2566756","3090000","523244","2024-09"
"066590","우수AMS","122802449975","3175","38677937","39073104","395167","2024-09"
"017370","우신시스템","124542700020","8010","15548402","18314054","2765652","2024-09"
"103840","우양","60801280020","3715","16366428","16366428","0","2024-09"
"046940","우원개발","42113235500","2330","18074350","18074350","0","2024-09"
"215380","우정바이오","33013125600","2100","15720536","15879576","159040","2024-09"
"065680","우주일렉트로","118969370800","14800","8038471","9530000","1491529","2024-09"
"105840","우진","167062840080","8430","19817656","20323614","505958","2024-09"
"018620","우진비앤지","29320478565","1015","28887171","28889293","2122","2024-09"
"010400","우진아이엔에스","23522875710","3490","6740079","7622000","881921","2024-09"
"457550","우진엔텍","209995828350","22650","9271339","9271339","0","2024-09"
"049800","우진플라임","44900000000","2245","20000000","20000000","0","2024-09"
"016880","웅진","70099332292","902","77715446","79927080","2211634","2024-09"
"095720","웅진씽크빅","198547602818","1762","112683089","115505985","2822896","2024-09"
"396470","워트","148948800000","9240","16120000","16120000","0","2024-09"
"005820","원림","32888711700","15990","2056830","2297970","241140","2024-09"
"307280","원바이오젠","46824198960","1320","35472878","36959013","1486135","2024-09"
"032940","원익","67860565130","3730","18193181","18193230","49","2024-09"
"240810","원익IPS","1369657673500","28150","48655690","49083901","428211","2024-09"
"074600","원익QnC","629597600000","23950","26288000","26288000","0","2024-09"
"104830","원익머트리얼즈","274224000000","21750","12608000","12608000","0","2024-09"
"014190","원익큐브","57587780517","1627","35395071","35399906","4835","2024-09"
"217820","원익피앤이","126753209670","2865","44241958","47454559","3212601","2024-09"
"030530","원익홀딩스","171479846225","2245","76383005","77237981","854976","2024-09"
"012620","원일특강","31416000000","7140","4400000","4400000","0","2024-09"
"382840","원준","213409398050","14050","15189281","15271581","82300","2024-09"
"336570","원텍","525300536880","5880","89336826","89340619","3793","2024-09"
"376980","원티드랩","41614447740","4660","8930139","9754994","824855","2024-09"
"008370","원풍","53626583010","4910","10921911","12000000","1078089","2024-09"
"008290","원풍물산","22055379144","552","39955397","40693679","738282","2024-09"
"101160","월덱스","312222877630","18910","16510993","16510993","0","2024-09"
"336060","웨이버스","66406020800","1379","48155200","48155200","0","2024-09"
"095270","웨이브일렉트로","56148215200","4400","12760958","14971256","2210298","2024-09"
"289930","웨이비스","129169154400","10400","12420111","12420111",,"자료 없음"
"010600","웰바이오텍","49552926545","545","90922801","90923407","606","2024-09"
"065950","웰크론","61577137460","2260","27246521","28231302","984781","2024-09"
"076080","웰크론한텍","32976884214","1494","22072881","22594156","521275","2024-09"
"043590","웰킵스하이텍","19867573632","744","26703728","27136762","433034","2024-09"
"196700","웹스","19176132240","1335","14364144","14364144","0","2024-09"
"069080","웹젠","477362403000","16200","29466815","34950884","5484069","2024-09"
"053580","웹케시","92067530400","7200","12787157","13636248","849091","2024-09"
"071460","위니아","21802751835","613","35567295","35967295","400000","2024-09"
"377460","위니아에이드","26030247855","1691","15393405","15393405","0","2024-09"
"044340","위닉스","92792396480","5870","15807904","17873425","2065521","2024-09"
"330350","위더스제약","93453734400","7080","13199680","13202139","2459","2024-09"
"348350","위드텍","83271072000","8520","9773600","10183600","410000","2024-09"
"112040","위메이드","1322755011350","39350","33615121","33948483","333362","2024-09"
"101730","위메이드맥스","341360200060","10340","33013559","33295292","281733","2024-09"
"123420","위메이드플레이","81752182260","7860","10401041","11469842","1068801","2024-09"
"065370","위세아이텍","30384786250","4375","6945094","7383954","438860","2024-09"
"038620","위즈코프","38145428457","607","62842551","66546465","3703914","2024-09"
"299900","위지윅스튜디오","203318260800","1200","169431884","171048884","1617000","2024-09"
"036090","위지트","90110312340","764","117945435","118392284","446849","2024-09"
"136540","윈스","153790047360","12440","12362544","13644162","1281618","2024-09"
"097800","윈팩","163146770829","1401","116450229","116450229","0","2024-09"
"192390","윈하이텍","42443590035","3885","10924991","10924991","0","2024-09"
"008600","윌비스","28622734650","435","65799390","67236039","1436649","2024-09"
"335870","윙스풋","20034387822","1201","16681422","16681422","0","2024-09"
"033270","유나이티드제약","309672212450","21050","14711269","16333822","1622553","2024-09"
"014830","유니드","449455493300","67700","6638929","6767600","128671","2024-09"
"446070","유니드비티플러스","45911215350","4490","10225215","10611215","386000","2024-09"
"036200","유니셈","207089013120","7040","29416053","30664223","1248170","2024-09"
"018000","유니슨","117537311672","698","168391564","168391564","0","2024-09"
"000910","유니온","75326061675","4825","15611619","15611619","0","2024-09"
"047400","유니온머티리얼","103950000000","2475","42000000","42000000","0","2024-09"
"203450","유니온커뮤니티","32571119835","2645","12314223","14079007","1764784","2024-09"
"011330","유니켐","134232916482","1494","89848003","96997167","7149164","2024-09"
"077500","유니퀘스트","101412478890","4695","21600102","21794015","193913","2024-09"
"011320","유니크","77379383475","4005","19320695","19320695","0","2024-09"
"086390","유니테스트","206378092550","10150","20332817","21134126","801309","2024-09"
"241690","유니테크노","89685137490","3665","24470706","24470706","0","2024-09"
"142210","유니트론텍","94360850645","4985","18928957","19246092","317135","2024-09"
"088340","유라클","49665879960","11470","4330068","4330068","0","2024-09"
"048430","유라테크","74673247040","6520","11452952","11520000","67048","2024-09"
"206650","유바이오로직스","565551072360","15480","36534307","36534307","0","2024-09"
"089850","유비벨록스","98337246800","6760","14546930","14730199","183269","2024-09"
"084440","유비온","16341911200","829","19712800","19712800","0","2024-09"
"032620","유비케어","192314613180","3790","50742642","52197139","1454497","2024-09"
"264450","유비쿼스","138343142990","13910","9945589","10245706","300117","2024-09"
"078070","유비쿼스홀딩스","158193716120","9580","16512914","18150700","1637786","2024-09"
"002920","유성기업","51551475000","2010","25647500","25947500","300000","2024-09"
"024800","유성티엔에스","65929483872","1974","33398928","37051812","3652884","2024-09"
"000700","유수홀딩스","125434449920","5120","24498916","26041812","1542896","2024-09"
"054930","유신","67800000000","22600","3000000","3000000","0","2024-09"
"069330","유아이디","17803401242","1262","14107291","14191091","83800","2024-09"
"049520","유아이엘","107352378720","5020","21384936","21784936","400000","2024-09"
"435380","유안타제10호스팩","12004350000","2095","5730000","5730000","0","2024-09"
"444920","유안타제11호스팩","10873000000","2075","5240000","5240000","0","2024-09"
"446150","유안타제12호스팩","9730800000","2040","4770000","4770000","0","2024-09"
"449020","유안타제13호스팩","19605950000","2015","9730000","9730000","0","2024-09"
"450940","유안타제14호스팩","9624800000","2120","4540000","4540000","0","2024-09"
"473050","유안타제15호스팩","14160200000","2020","7010000","7010000","0","2024-09"
"474490","유안타제16호스팩","11185300000","2030","5510000","5510000","0","2024-09"
"430700","유안타제9호스팩","11030200000","2105","5240000","5240000","0","2024-09"
"003470","유안타증권","554918696640","2880","192680103","199596576","6916473","2024-09"
"263770","유에스티","48906330720","2080","23512659","23700172","187513","2024-09"
"072130","유엔젤","57976337400","4850","11953884","13195454","1241570","2024-09"
"000220","유유제약","71527414660","4420","16182673","17032351","849678","2024-09"
"388720","유일로보틱스","369373246500","32250","11453434","11453434","0","2024-09"
"340930","유일에너테크","78781279500","2310","34104450","34204450","100000","2024-09"
"023410","유진기업","235430836395","3435","68538817","77310863","8772046","2024-09"
"056080","유진로봇","206691957520","5510","37512152","37512152","0","2024-09"
"468760","유진스팩10호","9031200000","2130","4240000","4240000","0","2024-09"
"442130","유진스팩9호","7715800000","2230","3460000","3460000","0","2024-09"
"084370","유진테크","791857564000","35600","22243190","22916042","672852","2024-09"
"240600","유진테크놀로지","44291665700","6460","6856295","6928151","71856","2024-09"
"001200","유진투자증권","380214060300","4140","91839145","96866418","5027273","2024-09"
"221800","유투바이오","36119027200","3200","11287196","11287196","0","2024-09"
"179900","유티아이","378927152350","23950","15821593","16286895","465302","2024-09"
"263050","유틸렉스","86467968000","2350","36794880","36798858","3978","2024-09"
"000100","유한양행","10567291492000","143200","73793935","80209064","6415129","2024-09"
"003460","유화증권","103408571300","2260","45756005","56702415","10946410","2024-09"
"191410","육일씨엔에쓰","18923986695","1689","11204255","11204255","0","2024-09"
"372170","윤성에프앤씨","450018307200","56400","7979048","7979048","0","2024-09"
"146060","율촌","29825312238","1242","24013939","24015595","1656","2024-09"
"008730","율촌화학","700600000000","28250","24800000","24800000","0","2024-09"
"072770","율호","131275278036","1869","70238244","70238244","0","2024-09"
"008250","이건산업","50968454540","4985","10224364","10952635","728271","2024-09"
"039020","이건홀딩스","71042244880","3280","21659221","22584709","925488","2024-09"
"025820","이구산업","149145918940","4460","33440789","33442000","1211","2024-09"
"067920","이글루","52353845000","5000","10470769","10996119","525350","2024-09"
"044960","이글벳","61619982940","5020","12274897","12641883","366986","2024-09"
"303530","이노뎁","53978486100","7590","7111790","7339299","227509","2024-09"
"296640","이노룰스","28511057280","5640","5055152","5178252","123100","2024-09"
"302430","이노메트리","90314954750","9190","9827525","9833208","5683","2024-09"
"214320","이노션","799600000000","19990","40000000","40000000","0","2024-09"
"462350","이노스페이스","182826033000","19500","9375694","9375694","0","2024-09"
"274400","이노시뮬레이션","39881112600","5100","7819826","7819826","0","2024-09"
"056090","이노시스","124097752275","1319","94084725","94084725","0","2024-09"
"073490","이노와이어리스","128581035860","16910","7603846","7603846","0","2024-09"
"215790","이노인스트루먼트","17925680460","445","40282428","40283149","721","2024-09"
"344860","이노진","22122300000","1850","11958000","12030000","72000","2024-09"
"088390","이녹스","97237240240","10360","9385834","9385844","10","2024-09"
"272290","이녹스첨단소재","473161749050","24550","19273391","20227658","954267","2024-09"
"053350","이니텍","68174639385","4065","16771129","19790916","3019787","2024-09"
"452400","이닉스","110217850200","12150","9071428","9071428","0","2024-09"
"264850","이랜시스","161167335840","5320","30294612","30294612","0","2024-09"
"054210","이랜텍","136628976690","5490","24886881","25291210","404329","2024-09"
"009730","이렘","78137480863","1697","46044479","46056774","12295","2024-09"
"065440","이루온","35186419818","1331","26436078","27275020","838942","2024-09"
"139480","이마트","1701060415500","63500","26788353","27875819","1087466","2024-09"
"115610","이미지스","61932850350","3930","15758995","15758995","0","2024-09"
"478110","이베스트스팩6호","10090200000","2010","5020000","5020000","0","2024-09"
"131400","이브이첨단소재","124831987030","2095","59585674","59589882","4208","2024-09"
"351330","이삭엔지니어링","66971241600","8080","8288520","8288520","0","2024-09"
"080010","이상네트웍스","50276504900","5300","9486133","9835071","348938","2024-09"
"457190","이수스페셜티케미컬","1248433990500","41700","29938465","30208280","269815","2024-09"
"086890","이수앱지스","221157139280","6160","35902133","35902133","0","2024-09"
"007660","이수페타시스","2675323523700","42300","63246419","63246419","0","2024-09"
"005950","이수화학","171553099620","7770","22078906","22722739","643833","2024-09"
"015020","이스타코","27223671300","700","38890959","42851600","3960641","2024-09"
"047560","이스트소프트","127852211960","12440","10277509","11603992","1326483","2024-09"
"239340","이스트에이드","44381379490","1645","26979562","26979634","72","2024-09"
"067010","이씨에스","34679657250","3045","11389050","12294000","904950","2024-09"
"093230","이아이디","354065768064","1392","254357592","254384360","26768","2024-09"
"418620","이에이트","127386296400","13200","9650477","9650477","0","2024-09"
"456070","이엔셀","216231626250","20250","10678105","10678105","0","2024-09"
"102710","이엔에프테크놀로지","234892023840","16440","14287836","14287836","0","2024-09"
"074610","이엔플러스","101770749123","1387","73374729","73374729","0","2024-09"
"041520","이엘씨","62701928560","5360","11698121","12188730","490609","2024-09"
"063760","이엘피","21146077700","2395","8829260","9325130","495870","2024-09"
"123570","이엠넷","56372260560","2640","21353129","22276078","922949","2024-09"
"083470","이엠앤아이","28679511168","1344","21338922","21340329","1407","2024-09"
"095190","이엠코리아","107181260780","2365","45319772","45319772","0","2024-09"
"091120","이엠텍","425721356200","25900","16437118","17132936","695818","2024-09"
"102460","이연제약","299508383030","16330","18340991","18586811","245820","2024-09"
"039030","이오테크닉스","2086411177200","172400","12102153","12319550","217397","2024-09"
"294090","이오플로우","176831178790","5810","30435659","30435659","0","2024-09"
"088290","이원컴포텍","35466967076","1132","31331243","31331669","426","2024-09"
"084680","이월드","279489727638","1971","141800978","141806193","5215","2024-09"
"353810","이지바이오","117733862400","3520","33447120","34191720","744600","2024-09"
"099750","이지케어텍","114726001980","17070","6720914","6834776","113862","2024-09"
"377330","이지트로닉스","45240166400","5720","7909120","8139954","230834","2024-09"
"035810","이지홀딩스","168707297685","2615","64515219","65145845","630626","2024-09"
"160600","이큐셀","106346383500","3100","34305285","34482552","177267","2024-09"
"092130","이크레더블","152712848000","12680","12043600","12043600","0","2024-09"
"096040","이트론","245561522409","271","906131079","906131295","216","2024-09"
"134060","이퓨쳐","15924874320","4140","3846588","4769250","922662","2024-09"
"001840","이화공영","48519226700","2450","19803766","19805760","1994","2024-09"
"000760","이화산업","31780000000","11350","2800000","2800000","0","2024-09"
"024810","이화전기","196810080587","899","218921113","218948640","27527","2024-09"
"014990","인디에프","60388431960","804","75109990","75112995","3005","2024-09"
"041830","인바디","310690300950","23850","13026847","13683782","656935","2024-09"
"352940","인바이오","24180699250","2225","10867730","10867730","0","2024-09"
"101140","인바이오젠","93257770480","9340","9984772","10044216","59444","2024-09"
"079950","인베니아","17410210000","799","21790000","23200000","1410000","2024-09"
"389470","인벤티지랩","177868672020","17730","10032074","10032074","0","2024-09"
"277410","인산가","50245011606","1333","37693182","38356789","663607","2024-09"
"060150","인선이엔티","249215829960","5560","44822991","46563612","1740621","2024-09"
"033230","인성정보","107479731645","2145","50107101","50515380","408279","2024-09"
"450520","인스웨이브시스템즈","49554427860","3370","14704578","14704578","0","2024-09"
"006490","인스코비","181133157777","1529","118465113","119368998","903885","2024-09"
"465480","인스피언","102797008080","10140","10137772","10137772",,"자료 없음"
"037330","인지디스플레","62951027692","1561","40327372","43885224","3557852","2024-09"
"100030","인지소프트","47964540600","17460","2747110","3283714","536604","2024-09"
"023800","인지컨트롤스","94045921400","6200","15168697","15809197","640500","2024-09"
"034590","인천도시가스","105317074450","25550","4121999","4374754","252755","2024-09"
"211050","인카금융서비스","246161517840","5040","48841571","51379800","2538229","2024-09"
"083640","인콘","25678021608","333","77111176","77720351","609175","2024-09"
"064090","인크레더블버즈","185035314720","3720","49740676","49742745","2069","2024-09"
"216050","인크로스","89560809800","7420","12070190","12843222","773032","2024-09"
"049070","인탑스","318929395150","20050","15906703","17200000","1293297","2024-09"
"119610","인터로조","312050211300","24900","12532137","13216478","684341","2024-09"
"017250","인터엠","20690867274","1022","20245467","21045467","800000","2024-09"
"129260","인터지스","61788949080","2190","28214132","29747874","1533742","2024-09"
"051370","인터플렉스","232341621120","9960","23327472","23327472","0","2024-09"
"064290","인텍플러스","156637711360","12640","12392224","12863962","471738","2024-09"
"189300","인텔리안테크","518800761000","49750","10428156","10733334","305178","2024-09"
"150840","인트로메딕","251537720850","5850","42997901","42997901","0","2024-09"
"048530","인트론바이오","191085822000","5840","32720175","34150762","1430587","2024-09"
"023810","인팩","70600000000","7060","10000000","10000000","0","2024-09"
"115310","인포바인","42379658780","19780","2142551","3192883","1050332","2024-09"
"039290","인포뱅크","49629015450","5950","8341011","8693978","352967","2024-09"
"071200","인피니트헬스케어","106403217345","4365","24376453","24396458","20005","2024-09"
"101930","인화정공","217163155300","22850","9503858","9615733","111875","2024-09"
"249420","일동제약","380997472240","13640","27932366","28062501","130135","2024-09"
"000230","일동홀딩스","89997957300","7970","11292090","11540400","248310","2024-09"
"013360","일성건설","67044876080","1241","54024880","54024880","0","2024-09"
"003120","일성아이에스","108914454540","15980","6815673","13300000","6484327","2024-09"
"333430","일승","86212707990","2810","30680679","30726747","46068","2024-09"
"068330","일신바이오","50845644760","1220","41676758","44216140","2539382","2024-09"
"003200","일신방직","170406480000","8000","21300810","23280000","1979190","2024-09"
"007110","일신석재","127293292440","1644","77429010","77456610","27600","2024-09"
"007570","일양약품","228973777760","12740","17972824","19085664","1112840","2024-09"
"178780","일월지엠엘","124101377000","8650","14346980","14349195","2215","2024-09"
"008500","일정실업","15266491640","12920","1181617","1200000","18383","2024-09"
"019540","일지테크","54107750970","4095","13213126","13513500","300374","2024-09"
"081000","일진다이아","175488886800","12360","14198130","14202975","4845","2024-09"
"020760","일진디스플","46460169021","903","51450907","51513741","62834","2024-09"
"103590","일진전기","1144254456000","24000","47677269","47685390","8121","2024-09"
"094820","일진파워","158778805770","10530","15078709","15078709","0","2024-09"
"271940","일진하이솔루스","744420395000","20500","36313190","36313190","0","2024-09"
"015860","일진홀딩스","184172075685","4005","45985537","49347483","3361946","2024-09"
"226320","잇츠한불","208581550400","11840","17616685","21929315","4312630","2024-09"
"049550","잉크테크","76268417530","3890","19606277","19606277","0","2024-09"
"389020","자람테크놀로지","195636256200","31900","6132798","6197730","64932","2024-09"
"254120","자비스","57585318750","1875","30712170","30754270","42100","2024-09"
"043910","자연과환경","66672998952","588","113389454","113391457","2003","2024-09"
"234920","자이글","42223263545","3145","13425521","13530910","105389","2024-09"
"289220","자이언트스텝","149100561300","6740","22121745","22121745","0","2024-09"
"317400","자이에스앤디","151878392200","3985","38112520","38782520","670000","2024-09"
"033240","자화전자","335486533200","15910","21086520","22155870","1069350","2024-09"
"174880","장원테크","11454988050","2650","4322637","4381265","58628","2024-09"
"049630","재영솔루텍","60147379147","719","83654213","83654213","0","2024-09"
"417840","저스템","56454357760","7960","7092256","7249175","156919","2024-09"
"000950","전방","22060139200","19360","1139470","1680000","540530","2024-09"
"079900","전진건설로봇","339100842000","23350","14522520","15360574","838054","2024-09"
"110020","전진바이오팜","19883982590","2195","9058762","9058762","0","2024-09"
"208140","정다운","85959540680","2630","32684236","32684246","10","2024-09"
"040420","정상제이엘에스","97549985260","6530","14938742","15677552","738810","2024-09"
"045510","정원엔시스","26695003536","848","31479957","32209292","729335","2024-09"
"217190","제너셈","73134911160","8340","8769174","8769174","0","2024-09"
"095700","제넥신","368840188580","8110","45479678","45540494","60816","2024-09"
"072520","제넨바이오","28838655818","389","74135362","74163194","27832","2024-09"
"122310","제노레이","80754676180","5990","13481582","14553844","1072262","2024-09"
"361390","제노코","114387032250","15250","7500789","7500789","0","2024-09"
"187420","제노포커스","124058891640","5240","23675361","23675361","0","2024-09"
"225220","제놀루션","53174993625","2945","18056025","19190021","1133996","2024-09"
"123330","제닉","169013217600","21600","7824686","7968680","143994","2024-09"
"381620","제닉스","121122128000","27700","4372640","4372640","0","2024-09"
"159580","제로투세븐","87642782500","4375","20032636","20032636","0","2024-09"
"147830","제룡산업","118167710430","6170","19151979","20000000","848021","2024-09"
"033100","제룡전기","868976326900","54100","16062409","16062409","0","2024-09"
"079370","제우스","398571663390","12990","30682961","31016990","334029","2024-09"
"054950","제이브이엠","230359360000","20000","11517968","12089892","571924","2024-09"
"023440","제이스코홀딩스","98712391820","1682","58687510","58687510","0","2024-09"
"090470","제이스텍","99590153740","5740","17350201","17476594","126393","2024-09"
"287410","제이시스메디칼","960860460300","12900","74485307","75692193","1206886","2024-06"
"137950","제이씨케미칼","102307832940","4740","21583931","22267814","683883","2024-09"
"033320","제이씨현시스템","81329849055","4305","18891951","19114432","222481","2024-09"
"417500","제이아이테크","104921774080","3320","31602944","32784744","1181800","2024-09"
"204270","제이앤티씨","1272630248300","22300","57068621","57848466","779845","2024-09"
"194370","제이에스코퍼레이션","229346119800","17220","13318590","13335601","17011","2024-09"
"026040","제이에스티나","25368723149","1771","14324519","16503790","2179271","2024-09"
"452160","제이엔비","55873009570","5810","9616697","9617527","830","2024-09"
"126880","제이엔케이글로벌","85606214485","3695","23168123","23204903","36780","2024-09"
"322510","제이엘케이","141821585280","8940","15863712","16195712","332000","2024-09"
"033050","제이엠아이","29801611008","936","31839328","32579342","740014","2024-09"
"094970","제이엠티","53478828800","3200","16712134","16748240","36106","2024-09"
"418550","제이오","575237114850","19450","29575173","31772273","2197100","2024-09"
"025620","제이준코스메틱","22550764320","5040","4474358","4484846","10488","2024-09"
"420570","제이투케이바이오","78908351360","13810","5713856","5732807","18951","2024-09"
"089790","제이티","42999559600","4705","9139120","10315513","1176393","2024-09"
"030000","제일기획","1852387880250","18290","101278725","115041225","13762500","2024-09"
"052670","제일바이오","56184286080","2080","27011676","29129064","2117388","2024-09"
"271980","제일약품","205021244190","14070","14571517","14704872","133355","2024-09"
"412540","제일엠앤에스","222487182000","10800","20600665","20600665","0","2024-09"
"001560","제일연마","56693980000","8330","6806000","9900000","3094000","2024-09"
"199820","제일일렉트릭","201313200000","9060","22220000","22220000","0","2024-09"
"038010","제일테크노스","54552960000","6560","8316000","9000000","684000","2024-09"
"002620","제일파마홀딩스","133554787500","8700","15351125","15973355","622230","2024-09"
"276730","제주맥주","37989712000","3200","11871785","11886605","14820","2024-09"
"080220","제주반도체","410933868800","12200","33683104","34442833","759729","2024-09"
"006220","제주은행","270845564820","8430","32128774","32128774","0","2024-09"
"089590","제주항공","733197110100","9100","80571111","80640985","69874","2024-09"
"216080","제테마","345924161830","19370","17858759","17858759","0","2024-09"
"229000","젠큐릭스","34146571200","2240","15244005","15244005","0","2024-09"
"082270","젬백스","541630853400","13650","39679916","39994174","314258","2024-09"
"044060","조광ILI","70075958688","732","95732184","95732184","0","2024-09"
"004910","조광페인트","62021421480","6060","10234558","12800000","2565442","2024-09"
"004700","조광피혁","184396703700","51900","3552923","6649138","3096215","2024-09"
"001550","조비","52385544520","10090","5191828","5192239","411","2024-09"
"462520","조선내화","207004370980","17470","11849134","11855168","6034","2024-09"
"120030","조선선재","90950131500","93900","968585","1257651","289066","2024-09"
"034940","조아제약","41079250602","1326","30979827","30979827","0","2024-09"
"067000","조이시티","111356189478","1593","69903446","69903446","0","2024-09"
"018470","조일알미늄","211728237512","1672","126631721","126631721","0","2024-09"
"002600","조흥","103920000000","173200","600000","600000","0","2024-09"
"185750","종근당","1291897139200","102400","12616183","13174420","558237","2024-09"
"063160","종근당바이오","141537742200","25800","5485959","5485962","3","2024-09"
"001630","종근당홀딩스","263734913200","55400","4760558","5009861","249303","2024-09"
"033340","좋은사람들","64472121070","665","96950558","96950558","0","2024-09"
"036930","주성엔지니어링","1467681367050","31050","47268321","47268321","0","2024-09"
"109070","주성코퍼레이션","216476814300","4100","52799223","52810230","11007","2024-09"
"044380","주연테크","22567740650","350","64479259","66403852","1924593","2024-09"
"072020","중앙백신","99398689920","10370","9585216","9658687","73471","2024-09"
"000440","중앙에너비스","85927722300","19380","4433835","6227130","1793295","2024-09"
"051980","중앙첨단소재","1142960235000","11460","99734750","99961003","226253","2024-09"
"228760","지노믹트리","398955562560","16630","23990112","24362333","372221","2024-09"
"314130","지놈앤컴퍼니","114282447570","3690","30970853","30970853","0","2024-09"
"013890","지누스","494448685600","24800","19937447","20260832","323385","2024-09"
"389030","지니너스","49961063810","1498","33351845","33351845","0","2024-09"
"043610","지니뮤직","143545131860","2470","58115438","58115438","0","2024-09"
"263860","지니언스","83680629300","9700","8626869","9444600","817731","2024-09"
"303030","지니틱스","40917894040","1145","35736152","35745668","9516","2024-09"
"036180","지더블유바이텍","53929030348","577","93464524","93464524","0","2024-09"
"208350","지란지교시큐리티","24178718520","3090","7824828","8838549","1013721","2024-09"
"144510","지씨셀","507917365800","33800","15027141","15800344","773203","2024-09"
"358570","지아이이노베이션","635852122180","14380","44217811","44217811","0","2024-09"
"382480","지아이텍","90051576345","2305","39067929","39357140","289211","2024-09"
"382800","지앤비에스 에코","105331366530","3330","31631041","31631041","0","2024-09"
"051160","지어소프트","137424757800","9460","14526930","15474430","947500","2024-09"
"053050","지에스이","109754605020","3660","29987597","29987597","0","2024-09"
"119850","지엔씨에너지","75171332880","5040","14914947","16448909","1533962","2024-09"
"065060","지엔코","33976397070","315","107861578","108008044","146466","2024-09"
"204840","지엘팜텍","82937535694","1079","76865186","76865206","20","2024-09"
"013870","지엠비코리아","72570025400","3805","19072280","19072280","0","2024-09"
"071320","지역난방공사","542464156400","46850","11578744","11578744","0","2024-09"
"270520","지오릿에너지","158155622856","996","158790786","158790786","0","2024-09"
"311320","지오엘리먼트","84643697600","6710","12614560","12614560","0","2024-09"
"388050","지투파워","167151317760","8960","18655281","18709437","54156","2024-09"
"088790","진도","22244118528","1787","12447744","12447744","0","2024-09"
"018120","진로발효","118060909760","17840","6617764","6621120","3356","2024-09"
"109820","진매트릭스","66979766865","3355","19964163","20393640","429477","2024-09"
"086060","진바이오텍","29103784060","3380","8610587","8610587","0","2024-09"
"036890","진성티이씨","168077987720","8410","19985492","22482268","2496776","2024-09"
"363250","진시스템","67163342400","9900","6784176","7006491","222315","2024-09"
"003780","진양산업","85150000000","6550","13000000","13000000","0","2024-09"
"007370","진양제약","65265237000","5750","11350476","12574867","1224391","2024-09"
"010640","진양폴리","67800000000","6780","10000000","10000000","0","2024-09"
"100250","진양홀딩스","177467552100","3175","55895292","55895292","0","2024-09"
"051630","진양화학","42897000000","2715","15800000","15800000","0","2024-09"
"272450","진에어","586452754920","11380","51533634","52200000","666366","2024-09"
"285800","진영","47013807880","2690","17477252","17477270","18","2024-09"
"011000","진원생명과학","182011421880","2280","79829571","80039035","209464","2024-09"
"002780","진흥기업","108769383272","748","145413614","145471745","58131","2024-09"
"085660","차바이오텍","969734708460","17220","56314443","56314443","0","2024-09"
"261780","차백신연구소","106226002080","3960","26824748","26824748","0","2024-09"
"351870","차이커뮤니케이션","92710734200","8330","11129740","11131089","1349","2024-09"
"009310","참엔지니어링","31733047904","376","84396404","84867419","471015","2024-09"
"094850","참좋은여행","61907553625","4625","13385417","14000000","614583","2024-09"
"004650","창해에탄올","71093478870","9370","7587351","9190885","1603534","2024-09"
"278280","천보","553101000000","55700","9930000","10000000","70000","2024-09"
"000650","천일고속","58366508600","40900","1427054","1429220","2166","2024-09"
"362320","청담글로벌","138248692320","6870","20123536","20551290","427754","2024-09"
"012600","청호ICT","116119947330","2490","46634517","46634517","0","2024-09"
"066360","체리부로","34093882665","711","47952015","47952015","0","2024-09"
"033250","체시스","47232000000","1476","32000000","32000000","0","2024-09"
"047820","초록뱀미디어","131865872400","5400","24419606","24453930","34324","2024-09"
"094360","칩스앤미디어","278936535500","13790","20227450","20823124","595674","2024-09"
"016920","카스","28579932997","1163","24574319","26493538","1919219","2024-09"
"284620","카이노스메드","149592019040","5380","27805208","28180793","375585","2024-09"
"035720","카카오","16392074550300","37350","438877498","443530908","4653410","2024-09"
"293490","카카오게임즈","1414552250930","17290","81813317","82667326","854009","2024-09"
"323410","카카오뱅크","10576774926600","22200","476431303","476963637","532334","2024-09"
"377300","카카오페이","3284630058400","24400","134615986","134615986","0","2024-09"
"140430","카티스","52058477940","3255","15993388","17922947","1929559","2024-09"
"042000","카페24","597200774300","24700","24178169","24253054","74885","2024-09"
"006380","카프로","618528628380","3660","168996893","168999996","3103","2024-09"
"313760","캐리","46908354360","6410","7317996","7417913","99917","2024-09"
"317530","캐리소프트","29733789580","4330","6866926","6971196","104270","2024-09"
"071850","캐스텍코리아","51918407320","2140","24260938","24529188","268250","2024-09"
"050110","캠시스","78805057476","1076","73238901","73824118","585217","2024-09"
"452300","캡스톤파트너스","38624081200","2740","14096380","14096380","0","2024-09"
"451760","컨텍","125139153060","8490","14739594","14940476","200882","2024-09"
"078340","컴투스","462010636950","40450","11421771","12737755","1315984","2024-09"
"063080","컴투스홀딩스","152013597500","23050","6594950","6595192","242","2024-09"
"307930","컴퍼니케이","81015900000","5190","15610000","15610000","0","2024-09"
"079190","케스피온","22260496074","591","37665814","38355514","689700","2024-09"
"263700","케어랩스","57520937735","2965","19399979","19414200","14221","2024-09"
"214370","케어젠","810364084540","16540","48994201","53715000","4720799","2024-09"
"221980","케이디켐","46586319640","12440","3744881","4034800","289919","2024-09"
"038530","케이바이오","30375669183","263","115496841","115714347","217506","2024-09"
"001620","케이비아이동국실업","62324097360","560","111293031","111293031","0","2024-09"
"424140","케이비제21호스팩","16692150000","2165","7710000","7710000","0","2024-09"
"192250","케이사인","65517422949","957","68461257","70671257","2210000","2024-09"
"431190","케이쓰리아이","42522990560","5680","7486442","7486442","0","2024-09"
"029460","케이씨","220623864030","18990","11617897","13554044","1936147","2024-09"
"115500","케이씨에스","93480000000","7790","12000000","12000000","0","2024-09"
"281820","케이씨텍","678003178600","33850","20029636","20861556","831920","2024-09"
"089150","케이씨티","43046500000","2510","17150000","17150000","0","2024-09"
"025880","케이씨피드","44356232160","2810","15785136","16715858","930722","2024-09"
"093320","케이아이엔엑스","351154366200","72600","4836837","4880000","43163","2024-09"
"093640","케이알엠","136854144000","4200","32584320","32584320","0","2024-09"
"073010","케이에스피","156470983570","3905","40069394","40191250","121856","2024-09"
"105330","케이엔더블유","60862995505","3835","15870403","16060028","189625","2024-09"
"053080","케이엔솔","200856688000","15500","12958496","12999807","41311","2024-09"
"199430","케이엔알시스템","79660336290","7330","10867713","10867713","0","2024-09"
"432470","케이엔에스","136277274760","15710","8674556","8674556","0","2024-09"
"272110","케이엔제이","126965564700","15860","8005395","8005395","0","2024-09"
"039420","케이엘넷","55675013430","2605","21372366","24154730","2782364","2024-09"
"083550","케이엠","37021687560","3210","11533236","12374226","840990","2024-09"
"032500","케이엠더블유","308213634420","7740","39820883","39820883","0","2024-09"
"225430","케이엠제약","18461201282","662","27887011","27887050","39","2024-09"
"102370","케이옥션","119603899800","4620","25888290","27229210","1340920","2024-09"
"068100","케이웨더","35286134250","3625","9734106","9939614","205508","2024-09"
"381970","케이카","622030562430","12910","48182073","48182073","0","2024-09"
"036030","케이티알파","201468669510","4110","49019141","49019283","142","2024-09"
"064820","케이프","136020924000","4875","27901728","30901728","3000000","2024-09"
"256940","케이피에스","105554944540","5630","18748658","18748658","0","2024-09"
"024880","케이피에프","77885303650","4025","19350386","20682798","1332412","2024-09"
"042040","케이피엠테크","55648348008","319","174446232","174460917","14685","2024-09"
"054410","케이피티유","22819879340","3985","5726444","5726444","0","2024-09"
"258610","케일럼","41172202512","1552","26528481","26787133","258652","2024-09"
"274090","켄코아에어로스페이스","103693204780","8030","12913226","12913226","0","2024-09"
"089010","켐트로닉스","289910632950","19450","14905431","15334346","428915","2024-09"
"220260","켐트로스","125753512620","4735","26558292","26558307","15","2024-09"
"052400","코나아이","203590688960","13940","14604784","14899999","295215","2024-09"
"402030","코난테크놀로지","163432711760","14270","11452888","11452888","0","2024-09"
"391710","코닉오토메이션","84245950040","2030","41500468","41503222","2754","2024-09"
"046070","코다코","145807623880","10280","14183621","14219097","35476","2024-09"
"047770","코데즈컴바인","53113207413","1407","37749259","37842602","93343","2024-09"
"080530","코디","60284623652","1397","43152916","43300427","147511","2024-09"
"104540","코렌텍","79271588000","6200","12785740","12785740","0","2024-09"
"027050","코리아나","78030000000","2550","30600000","40000000","9400000","2024-09"
"007810","코리아써키트","237624755060","10060","23620751","23620751","0","2024-09"
"190650","코리아에셋투자증권","35453400000","5550","6388000","6388000","0","2024-09"
"123410","코리아에프티","142824632670","5130","27841059","27841064","5","2024-09"
"003690","코리안리","1350443213420","9170","147267526","165367526","18100000","2024-09"
"036690","코맥스","45885746130","2885","15904938","15904938","0","2024-09"
"049430","코메론","102331974300","11390","8984370","9048000","63630","2024-09"
"183300","코미코","511612467000","49650","10304380","10460684","156304","2024-09"
"041960","코미팜","303113387500","4375","69283060","70622233","1339173","2024-09"
"089890","코세스","142677355200","8700","16399696","16584962","185266","2024-09"
"360350","코셈","41178502200","7260","5671970","5671970","0","2024-09"
"082660","코스나인","47827116000","480","99639825","99640869","1044","2024-09"
"192820","코스맥스","1565701356000","138000","11345662","11349509","3847","2024-09"
"044820","코스맥스비티아이","83509292860","8740","9554839","9603921","49082","2024-09"
"222040","코스맥스엔비티","79136118600","3850","20554836","20628000","73164","2024-09"
"241710","코스메카코리아","784980000000","73500","10680000","10680000","0","2024-09"
"005070","코스모신소재","3464392973600","106600","32498996","32510756","11760","2024-09"
"005420","코스모화학","849770551850","22150","38364359","38408228","43869","2024-09"
"355150","코스텍시스","56266802950","7450","7552591","7797350","244759","2024-09"
"071950","코아스","32907200000","10000","3290720","3290720","0","2024-09"
"166480","코아스템켐온","335438976330","13770","24360129","32870376","8510247","2024-09"
"045970","코아시아","111362385370","4490","24802313","26314876","1512563","2024-09"
"196450","코아시아씨엠","37741789743","833","45308271","45319582","11311","2024-09"
"384470","코어라인소프트","97649275050","7610","12831705","12832064","359","2024-09"
"029960","코엔텍","358525713600","7380","48580720","50000000","1419280","2024-09"
"002020","코오롱","181694270140","14390","12626426","12626426","0","2024-09"
"138490","코오롱ENP","214700000000","5650","38000000","38000000","0","2024-09"
"003070","코오롱글로벌","171421247070","9090","18858223","18932713","74490","2024-09"
"450140","코오롱모빌리티그룹","145661794750","2375","61331282","62777250","1445968","2024-09"
"102940","코오롱생명과학","232193103030","18690","12423387","12423387","0","2024-09"
"120110","코오롱인더","868007733050","31550","27512131","27519091","6960","2024-09"
"021240","코웨이","4666902731700","64900","71909133","73799619","1890486","2024-09"
"033290","코웰패션","122406493440","2310","52989824","56156301","3166477","2024-09"
"056360","코위버","47863177560","5170","9257868","9796800","538932","2024-09"
"282880","코윈테크","152919466000","14000","10922819","11141807","218988","2024-09"
"121850","코이즈","27300306984","899","30367416","30614175","246759","2024-09"
"448710","코츠테크놀로지","97864933950","22050","4438319","5166069","727750","2024-09"
"126730","코칩","99741861660","12180","8188987","8503460","314473","2024-09"
"015710","코콤","83819581850","5050","16597937","17530500","932563","2024-09"
"052330","코텍","102087376440","8120","12572337","15574552","3002215","2024-09"
"322780","코퍼스코리아","39920119500","1082","36894750","37932613","1037863","2024-09"
"036420","콘텐트리중앙","181493291500","9500","19104557","19262308","157751","2024-09"
"200130","콜마비앤에이치","414333373160","14230","29116892","29415558","298666","2024-09"
"024720","콜마홀딩스","235615299330","6870","34296259","34296259","0","2024-09"
"031820","콤텍시스템","67062512164","554","121051466","121051466","0","2024-09"
"294570","쿠콘","136038425220","13340","10197783","10254685","56902","2024-09"
"192400","쿠쿠홀딩스","761420432500","24500","31078385","35562185","4483800","2024-09"
"284740","쿠쿠홈시스","510109145000","22750","22422380","22437330","14950","2024-09"
"317690","퀀타매트릭스","124030582500","7500","16537411","16537411","0","2024-09"
"078940","퀀타피아","151577916950","2855","53092090","53094278","2188","2024-09"
"227100","퀀텀온","16025587508","1022","15680614","15680614","0","2024-09"
"432720","퀄리타스반도체","138798459600","10050","13810792","13810792","0","2024-09"
"365270","큐라클","78110439840","5630","13873968","13873968","0","2024-09"
"348080","큐라티스","37557440910","891","42152010","42152010","0","2024-09"
"060280","큐렉소","274481133200","6680","41089990","41089990","0","2024-09"
"372320","큐로셀","426216344800","30200","14113124","14113124","0","2024-09"
"051780","큐로홀딩스","18463947248","136","135764318","136422450","658132","2024-09"
"115180","큐리언트","155947572060","4830","32287282","32292671","5389","2024-09"
"445680","큐리옥스바이오시스템즈","377468506100","23450","16096738","16096738","0","2024-09"
"182360","큐브엔터","184722343400","13300","13888898","14571557","682659","2024-09"
"405100","큐알티","162254136000","13760","11791725","12289301","497576","2024-09"
"066310","큐에스아이","60344966250","6750","8939995","9271621","331626","2024-09"
"016600","큐캐피탈","47643966006","273","174520022","178247112","3727090","2024-09"
"355390","크라우드웍스","42721691320","10120","4221511","4224606","3095","2024-09"
"264900","크라운제과","101176142980","8420","12016169","12523850","507681","2024-09"
"005740","크라운해태홀딩스","84426654450","5870","14382735","14847347","464612","2024-09"
"259960","크래프톤","15682161645000","345000","45455541","47900115","2444574","2024-09"
"096240","크레버스","132945166320","15760","8435607","11138180","2702573","2024-09"
"040350","크레오에스지","104657566770","690","151677633","152074086","396453","2024-09"
"110790","크리스에프앤씨","130633894650","6450","20253317","23430960","3177643","2024-09"
"045520","크린앤사이언스","31563720000","5160","6117000","6500000","383000","2024-09"
"036170","클라우드에어","52196165128","866","60272708","61365626","1092918","2024-09"
"214150","클래시스","3471799927000","53000","65505659","65505659","0","2024-09"
"466100","클로봇","231527901020","9670","23942906","23942906",,"자료 없음"
"352770","클리노믹스","22799151648","593","38447136","38886113","438977","2024-09"
"237880","클리오","375903163350","21450","17524623","18071353","546730","2024-09"
"139670","키네마스터","37909004850","2685","14118810","14118810","0","2024-09"
"020120","키다리스튜디오","130277119880","3515","37063192","37063766","574","2024-09"
"413600","키움제6호스팩","9381050000","2735","3430000","3430000","0","2024-09"
"433530","키움제7호스팩","9338875000","2275","4105000","4105000","0","2024-09"
"446840","키움제8호스팩","13788600000","2345","5880000","5880000","0","2024-09"
"039490","키움증권","3252907462800","134800","24131361","25526706","1395345","2024-09"
"054780","키이스트","86558943950","4430","19539265","19547793","8528","2024-09"
"219130","타이거일렉","118708652000","18800","6314290","6314290","0","2024-09"
"360070","탑머티리얼","280236040000","35000","8006744","8076743","69999","2024-09"
"065130","탑엔지니어링","60897144300","3925","15515196","17189982","1674786","2024-09"
"134580","탑코미디어","40910656500","1890","21645850","22025767","379917","2024-09"
"014580","태경비케이","121365640000","4400","27583100","27583100","0","2024-09"
"015890","태경산업","150235775000","5140","29228750","29228750","0","2024-09"
"006890","태경케미컬","123312821120","10880","11333899","11600000","266101","2024-09"
"023160","태광","321788490480","12440","25867242","26500000","632758","2024-09"
"003240","태광산업","545376888000","648000","841631","1113400","271769","2024-09"
"011280","태림포장","141808589260","2060","68839121","70805940","1966819","2024-09"
"323280","태성","706196965500","27350","25820730","25820730","0","2024-09"
"053620","태양","50632157160","6360","7961031","8600000","638969","2024-09"
"004100","태양금속","126026555600","3460","36423860","36700000","276140","2024-09"
"009410","태영건설","1330097939940","4620","287899987","287905337","5350","2024-09"
"044490","태웅","280303407810","14010","20007381","20007381","0","2024-09"
"124560","태웅로직스","103069064400","2850","36164584","38416584","2252000","2024-09"
"001420","태원물산","27682478925","3775","7333107","7600000","266893","2024-09"
"191420","테고사이언스","134270111820","16770","8006566","8108834","102268","2024-09"
"073640","테라사이언스","59577565530","654","91097195","95587404","4490209","2024-09"
"066700","테라젠이텍스","108178181020","3380","32005379","32474435","469056","2024-09"
"095610","테스","285746571540","16290","17541226","19768226","2227000","2024-09"
"055490","테이팩스","81942587000","17180","4769650","4769650","0","2024-09"
"064520","테크엘","46813868590","2095","22345522","22351062","5540","2024-09"
"089030","테크윙","1481442647300","41450","35740474","37353645","1613171","2024-09"
"054450","텔레칩스","187616072160","12710","14761296","15144233","382937","2024-09"
"078000","텔코웨어","51433469880","9960","5164003","9240077","4076074","2024-09"
"200230","텔콘RF제약","70105887005","583","120250235","120250235","0","2024-09"
"214420","토니모리","173294219750","7250","23902651","24054799","152148","2024-09"
"393210","토마토시스템","98588716550","6410","15380455","15614544","234089","2024-09"
"215480","토박스코리아","24282879120","2710","8960472","9400000","439528","2024-09"
"051360","토비스","313864383300","20550","15273206","16167058","893852","2024-09"
"045340","토탈소프트","44073906000","5150","8558040","8558040","0","2024-09"
"108230","톱텍","190558125240","5230","36435588","38023245","1587657","2024-09"
"079970","투비소프트","9311405859","1113","8366043","9290500","924457","2024-09"
"199800","툴젠","467920919200","58900","7944328","7946828","2500","2024-09"
"417790","트루엔","95262358100","9100","10468391","10999650","531259","2024-09"
"290090","트윔","59582433110","8510","7001461","7432268","430807","2024-09"
"026150","특수건설","111243738540","6340","17546331","17546331","0","2024-09"
"464280","티디에스팜","76524595000","14470","5288500","5530000","241500","2024-09"
"322180","티라유텍","96473734000","5840","16519475","16519475","0","2024-09"
"117730","티로보틱스","130210538000","7300","17837060","17837060","0","2024-09"
"033830","티비씨","78937267750","835","94535650","100000000","5464350","2024-09"
"057680","티사이언티픽","70037276483","983","71248501","71248501","0","2024-09"
"204610","티쓰리","81586599696","1392","58611063","63851720","5240657","2024-09"
"064760","티씨케이","974862500000","83500","11675000","11675000","0","2024-09"
"246710","티앤알바이오팹","153197947080","7110","21546828","21546828","0","2024-09"
"340570","티앤엘","565040770000","70000","8072011","8128000","55989","2024-09"
"043220","티에스넥스젠","77796618255","547","142224165","142224165","0","2024-09"
"277880","티에스아이","125400375040","6220","20160832","20160832","0","2024-09"
"131290","티에스이","578103872000","53600","10785520","11061429","275909","2024-09"
"019180","티에이치엔","57060000000","3170","18000000","18000000","0","2024-09"
"425420","티에프이","175886050000","15550","11311000","11381000","70000","2024-09"
"131100","티엔엔터테인먼트","43187010020","1540","28043513","28048252","4739","2024-09"
"356860","티엘비","141996313900","14530","9772630","9832630","60000","2024-09"
"062860","티엘아이","42843237000","5800","7386765","9872720","2485955","2024-09"
"363280","티와이홀딩스","123916572500","3500","35404735","50429268","15024533","2024-09"
"321550","티움바이오","154331173490","5930","26025493","26025493","0","2024-09"
"091810","티웨이항공","712224566350","3310","215173585","215378976","205391","2024-09"
"004870","티웨이홀딩스","78805675538","701","112418938","112419447","509","2024-09"
"425040","티이엠씨","189108651420","8940","21153093","21316062","162969","2024-09"
"241790","티이엠씨씨엔에스","54978053420","5660","9713437","10002634","289197","2024-09"
"104480","티케이케미칼","128707934544","1416","90895434","90895434","0","2024-09"
"081150","티플랙스","79479016550","3275","24268402","24268402","0","2024-09"
"130740","티피씨글로벌","22339101099","1981","11276679","11276679","0","2024-09"
"084730","팅크웨어","108879365940","10390","10479246","11109424","630178","2024-09"
"440110","파두","1113150253600","22600","49254436","49334436","80000","2024-09"
"034230","파라다이스","894692967000","10360","86360325","91771623","5411298","2024-09"
"033540","파라텍","49883514003","1333","37421991","37751063","329072","2024-09"
"388870","파로스아이바이오","119094160020","9210","12930962","12930962","0","2024-09"
"043200","파루","22191940692","531","41792732","41804315","11583","2024-09"
"214450","파마리서치","2433708067000","234500","10378286","10498238","119952","2024-09"
"208340","파멥신","233760977175","2915","80192445","80201108","8663","2024-09"
"005690","파미셀","299120009790","4985","60004014","60016964","12950","2024-09"
"177830","파버나인","37124496240","3120","11898877","14288753","2389876","2024-09"
"037070","파세코","115439229300","5780","19972185","20000000","27815","2024-09"
"150900","파수","54033889580","4780","11304161","11685422","381261","2024-09"
"037030","파워넷","53480318745","2445","21873341","21878974","5633","2024-09"
"047310","파워로직스","183785990100","5020","36610755","36610755","0","2024-09"
"368770","파이버프로","151537732875","4635","32694225","32854225","160000","2024-09"
"170790","파이오링크","54309286170","8130","6680109","6856330","176221","2024-09"
"049120","파인디앤씨","54724593036","1173","46653532","46653532","0","2024-09"
"038950","파인디지털","29195392680","3560","8200953","10210765","2009812","2024-09"
"441270","파인엠텍","215551149990","5830","36972753","36987901","15148","2024-09"
"106240","파인테크닉스","16665455100","1050","15871862","15923057","51195","2024-09"
"131760","파인텍","34701834817","799","43431583","43431583","0","2024-09"
"065690","파커스","14183861608","1064","13330697","14049331","718634","2024-09"
"140860","파크시스템스","1450046598000","209000","6938022","6983609","45587","2024-09"
"091700","파트론","356720352300","7020","50814865","58918214","8103349","2024-09"
"032800","판타지오","37249153971","163","228522417","229785294","1262877","2024-09"
"318010","팜스빌","43895710240","5680","7728118","7929338","201220","2024-09"
"036580","팜스코","74590120680","2130","35018836","36727943","1709107","2024-09"
"027710","팜스토리","143008723473","1293","110602261","111416600","814339","2024-09"
"004720","팜젠사이언스","86148921250","4750","18136615","18178525","41910","2024-09"
"225590","패션플랫폼","22277987340","870","25606882","26636713","1029831","2024-09"
"054300","팬스타엔터프라이즈","33147070110","495","66963778","66985895","22117","2024-09"
"068050","팬엔터테인먼트","57058681190","2110","27042029","27694076","652047","2024-09"
"028670","팬오션","1870993292000","3500","534569512","534569512","0","2024-09"
"222110","팬젠","56230420400","4900","11475596","11475596","0","2024-09"
"271830","팸텍","60120426595","2095","28697101","29490202","793101","2024-09"
"010820","퍼스텍","170324903685","3505","48594837","48771938","177101","2024-09"
"016800","퍼시스","376750879200","42100","8948952","11500000","2551048","2024-09"
"263750","펄어비스","2361576314500","38450","61419410","64247855","2828445","2024-09"
"251970","펌텍코리아","454400846900","36650","12398386","12400000","1614","2024-09"
"001020","페이퍼코리아","141981342636","798","177921482","177983313","61831","2024-09"
"168360","펨트론","159449247160","7490","21288284","21288284","0","2024-09"
"087010","펩트론","1838096637700","89300","20583389","20657350","73961","2024-09"
"090080","평화산업","53804213820","980","54902259","54902259","0","2024-09"
"010770","평화홀딩스","40504925215","2815","14388961","14625466","236505","2024-09"
"064800","포니링크","168527726920","1337","126049160","127807298","1758138","2024-09"
"119500","포메탈","33468430400","2825","11847232","11847232","0","2024-09"
"389140","포바이포","60917604960","5520","11035798","11112735","76937","2024-09"
"105760","포스뱅크","62435901000","6600","9459985","9459985","0","2024-09"
"022100","포스코DX","4281395035800","28200","151822519","152034729","212210","2024-09"
"058430","포스코스틸리온","224946654500","37550","5990590","6000000","9410","2024-09"
"009520","포스코엠텍","677475624930","16270","41639559","41642703","3144","2024-09"
"047050","포스코인터내셔널","8863113324000","52000","170444487","175922788","5478301","2024-09"
"003670","포스코퓨처엠","18468310464000","238500","77435264","77463220","27956","2024-09"
"189690","포시에스","61185986565","2245","27254337","27321969","67632","2024-09"
"318020","포인트모바일","50975191480","4090","12463372","12662272","198900","2024-09"
"256630","포인트엔지니어링","72569266800","1275","56917072","57997072","1080000","2024-09"
"331380","포커스에이치엔에스","86338999000","3875","22281032","22725452","444420","2024-09"
"472850","폰드그룹","203716655100","6300","32335977","32343933","7956","2024-09"
"039980","폴라리스AI","170810123465","2395","71319467","72152777","833310","2024-09"
"041910","폴라리스AI파마","85279107000","6420","13283350","13501607","218257","2024-09"
"234100","폴라리스세원","68615061593","1261","54413213","54413213","0","2024-09"
"041020","폴라리스오피스","254381020160","5120","49683793","49725498","41705","2024-09"
"114630","폴라리스우노","39212280156","516","75992791","77757548","1764757","2024-09"
"290720","푸드나무","41527923325","3325","12489601","13403058","913457","2024-09"
"005670","푸드웰","48649806120","5160","9428257","10000000","571743","2024-09"
"094940","푸른기술","49642539640","6280","7904863","8361386","456523","2024-09"
"057880","푸른소나무","215672327790","8790","24536101","24580368","44267","2024-09"
"007330","푸른저축은행","103236637200","8810","11718120","15082800","3364680","2024-09"
"017810","풀무원","378955289400","10280","36863355","38120542","1257187","2024-09"
"093380","풍강","26127904950","2725","9588222","9879313","291091","2024-08"
"023900","풍국주정","127386000000","10110","12600000","12600000","0","2024-09"
"103140","풍산","1906536604400","69800","27314278","28024278","710000","2024-09"
"005810","풍산홀딩스","387905703200","27700","14003816","14417292","413476","2024-09"
"371950","풍원정밀","219873099600","10450","21040488","21040488","0","2024-09"
"370090","퓨런티어","130091097000","15900","8181830","8181830","0","2024-09"
"445180","퓨릿","109335105760","6520","16769188","16769188","0","2024-09"
"151910","퓨처코어","121645902080","640","190071722","190071722","0","2024-09"
"220100","퓨쳐켐","525906886400","23800","22096928","22102155","5227","2024-09"
"035200","프럼파스트","23277397000","2750","8464508","9730590","1266082","2024-09"
"334970","프레스티지바이오로직스","539600929890","6970","77417637","77417637","0","2024-09"
"321260","프로이천","58921390770","2090","28192053","28192084","31","2024-09"
"053610","프로텍","302400000000","33600","9000000","11000000","2000000","2024-09"
"303360","프로티아","35927429850","2790","12877215","12877215","0","2024-09"
"377220","프롬바이오","61715800000","2180","28310000","28310000","0","2024-09"
"335810","프리시젼바이오","39082879990","3365","11614526","11614526","0","2024-09"
"053160","프리엠스","73695655000","13750","5359684","6000000","640316","2024-09"
"405000","플라즈맵","45217247496","1734","26076844","26076844","0","2024-09"
"041590","플래스크","103917099150","789","131707350","131707350","0","2024-09"
"367000","플래티어","38084095300","4700","8102999","8388207","285208","2024-09"
"075130","플랜티넷","31528727550","2025","15569742","16622320","1052578","2024-09"
"009810","플레이그램","54979794370","362","151877885","151887500","9615","2024-09"
"237820","플레이디","84659124000","6600","12827140","12827140","0","2024-09"
"023770","플레이위드","35724791500","4075","8766820","8766820","0","2024-09"
"019570","플루토스","20776052088","396","52464778","52470042","5264","2024-09"
"300080","플리토","83332473400","15160","5496865","5501817","4952","2024-09"
"033790","피노","181622400000","8000","22702800","22822800","120000","2024-09"
"032580","피델릭스","47750960474","1442","33114397","33132064","17667","2024-09"
"051380","피씨디렉트","41837002190","2830","14783393","15340072","556679","2024-09"
"241820","피씨엘","52130502927","881","59171967","59171967","0","2024-09"
"237750","피앤씨테크","28779938000","4430","6496600","6496600","0","2024-09"
"460940","피앤에스미캐닉스","74425010000","11500","6471740","6471740","0","2024-09"
"319660","피에스케이","596714308400","20600","28966714","28966714","0","2024-09"
"031980","피에스케이홀딩스","1108307103000","51400","21562395","21562395","0","2024-09"
"002230","피에스텍","61485852600","3720","16528455","19370673","2842218","2024-09"
"043370","피에이치에이","197090119170","10090","19533213","21000000","1466787","2024-09"
"239890","피엔에이치테크","69252212350","6970","9935755","9935755","0","2024-09"
"347740","피엔케이피부임상연구센타","69749525265","2415","28881791","30010576","1128785","2024-09"
"137400","피엔티","1239083008800","53300","23247336","23743086","495750","2024-09"
"257370","피엔티엠에스","55651724970","4530","12285149","12504861","219712","2024-09"
"147760","피엠티","43712258640","4040","10819866","10819866","0","2024-09"
"128660","피제이메탈","80734966095","3255","24803369","24803369","0","2024-09"
"006140","피제이전자","77595300000","5220","14865000","15000000","135000","2024-09"
"376180","피코그램","61903811970","3365","18396378","18491378","95000","2024-09"
"304840","피플바이오","113991369560","5420","21031618","21089464","57846","2024-09"
"087600","픽셀플러스","45554969430","7030","6480081","8166558","1686477","2024-09"
"291810","핀텔","22715424000","2000","11357712","11357712","0","2024-09"
"378340","필에너지","341425547280","16040","21285882","21285882","0","2024-09"
"161580","필옵틱스","483133257000","21150","22843180","22843180","0","2024-09"
"347770","핌스","52342626180","2290","22857042","22857042","0","2024-09"
"163730","핑거","116027629470","12630","9186669","9360608","173939","2024-09"
"417180","핑거스토리","41701891920","2480","16815279","16816209","930","2024-09"
"446750","하나26호스팩","12904200000","2140","6030000","6030000","0","2024-09"
"448370","하나27호스팩","11970600000","2130","5620000","5620000","0","2024-09"
"454750","하나28호스팩","14908140000","2070","7202000","7202000","0","2024-09"
"454640","하나29호스팩","11585145000","2145","5401000","5401000","0","2024-09"
"469880","하나30호스팩","14938725000","2045","7305000","7305000","0","2024-09"
"469900","하나31호스팩","11630375000","2075","5605000","5605000","0","2024-09"
"475240","하나32호스팩","6960000000","2175","3200000","3200000","0","2024-09"
"475250","하나33호스팩","7918000000","2140","3700000","3700000","0","2024-09"
"406760","하나금융21호스팩","15523950000","2095","7410000","7410000","0","2024-09"
"418170","하나금융22호스팩","14093450000","2345","6010000","6010000","0","2024-09"
"435620","하나금융25호스팩","44654760000","10380","4302000","4302000","0","2024-09"
"086790","하나금융지주","18056035530000","65000","277785162","287240880","9455718","2024-09"
"299030","하나기술","228254680500","28550","7994910","7994910","0","2024-09"
"067310","하나마이크론","721221509120","10970","65744896","65744896","0","2024-09"
"166090","하나머티리얼즈","563201870600","28900","19487954","19777674","289720","2024-09"
"293480","하나제약","192197289460","11110","17299486","17772946","473460","2024-09"
"039130","하나투어","730350293800","47150","15489932","16039185","549253","2024-09"
"136480","하림","302102532790","2845","106187182","106209702","22520","2024-09"
"003380","하림지주","513539035680","5280","97261181","112005621","14744440","2024-09"
"450330","하스","63079872450","8050","7836009","7836009","0","2024-09"
"101670","하이드로리튬","78158691640","1565","49941656","51691656","1750000","2024-09"
"365590","하이딥","125533457970","870","144291331","144447309","155978","2024-09"
"149980","하이로닉","116299686000","6960","16709725","18594363","1884638","2024-09"
"013030","하이록코리아","274733900500","22700","12102815","12856050","753235","2024-09"
"352820","하이브","8155162060500","196500","41502097","41652097","150000","2024-09"
"126700","하이비젼시스템","226958622730","17830","12729031","14942112","2213081","2024-09"
"106080","하이소닉","98339743750","6250","15734359","15735465","1106","2024-09"
"071090","하이스틸","62770843610","3110","20183551","20191471","7920","2024-09"
"450050","하이제8호스팩","10479260000","2090","5014000","5014000","0","2024-09"
"160190","하이젠알앤엠","199399200000","7150","27888000","30888000","3000000","2024-09"
"221840","하이즈항공","34053721581","1821","18700561","18700561","0","2024-09"
"106190","하이텍팜","160764881760","15120","10632598","10633173","575","2024-09"
"019490","하이트론","83633452525","2785","30029965","30044269","14304","2024-09"
"000080","하이트진로","1455367852400","21200","68649427","70133611","1484184","2024-09"
"000140","하이트진로홀딩스","204476668110","9570","21366423","23206765","1840342","2024-09"
"065650","하이퍼코퍼레이션","129198510150","1213","106511550","106681728","170178","2024-09"
"066130","하츠","61824776650","5150","12004811","12800000","795189","2024-09"
"004590","한국가구","55275000000","3685","15000000","15000000","0","2024-09"
"036460","한국가스공사","3447379643000","39500","87275434","92313000","5037566","2024-09"
"039340","한국경제TV","114832933200","5400","21265358","23000000","1734642","2024-09"
"005430","한국공항","175541311400","57400","3058211","3166355","108144","2024-09"
"071050","한국금융지주","4155794824400","78800","52738513","55725992","2987479","2024-09"
"034950","한국기업평가","378727947900","84900","4460871","4540514","79643","2024-09"
"010040","한국내화","79024737460","2230","35437102","41067062","5629960","2024-09"
"025540","한국단자","742680000000","72000","10315000","10415000","100000","2024-09"
"222980","한국맥널티","41437065040","3815","10861616","11031483","169867","2024-09"
"010100","한국무브넥스","109621512000","3600","30450420","30450420","0","2024-09"
"256840","한국비엔씨","326905227840","4920","66444152","67912443","1468291","2024-09"
"219750","한국비티비","63245329550","967","65403650","65426885","23235","2024-09"
"004090","한국석유","199371091220","15820","12602471","12694120","91649","2024-09"
"025550","한국선재","63160776720","2855","22122864","23300000","1177136","2024-09"
"002200","한국수출포장","97936934295","2635","37167717","40000000","2832283","2024-09"
"002960","한국쉘석유","418600000000","322000","1300000","1300000","0","2024-09"
"017890","한국알콜","185842754790","9030","20580593","21605760","1025167","2024-09"
"000240","한국앤컴퍼니","1565690920320","16530","94718144","94935240","217096","2024-09"
"080720","한국유니온제약","15410411825","2725","5655197","7912828","2257631","2024-09"
"123890","한국자산신탁","357923635875","2925","122367055","123977752","1610697","2024-09"
"015760","한국전력","14797271974850","23050","641964077","641964077","0","2024-09"
"063570","한국전자금융","154684876800","5100","30330368","34147728","3817360","2024-09"
"041460","한국전자인증","65299443750","3450","18927375","19000000","72625","2024-09"
"006200","한국전자홀딩스","32014797510","730","43855887","46803136","2947249","2024-09"
"101680","한국정밀기계","20376714825","2425","8402769","8404000","1231","2024-09"
"039740","한국정보공학","21369028005","2665","8018397","8018397","0","2024-09"
"053300","한국정보인증","163056804710","3970","41072243","42441361","1369118","2024-09"
"025770","한국정보통신","292806346200","8200","35708091","37444271","1736180","2024-09"
"458610","한국제12호스팩","9263700000","2190","4230000","4230000","0","2024-09"
"464440","한국제13호스팩","9266400000","2145","4320000","4320000","0","2024-09"
"477530","한국제14호스팩","10942750000","2275","4810000","4810000","0","2024-09"
"479880","한국제15호스팩","14083500000","2050","6870000","6870000","0","2024-09"
"027970","한국제지","180833334720","951","190150720","190178237","27517","2024-09"
"023350","한국종합기술","45933284725","4415","10403915","10950000","546085","2024-09"
"025890","한국주강","22055195064","1979","11144616","11309259","164643","2024-09"
"000970","한국주철관","137024878900","6370","21510970","22800500","1289530","2024-09"
"104700","한국철강","276042493650","8050","34290993","42450000","8159007","2024-09"
"062970","한국첨단소재","19707212773","1997","9868409","9868409","0","2024-09"
"017960","한국카본","527122059660","10710","49217746","51908452","2690706","2024-09"
"023760","한국캐피탈","175134722000","560","312740575","315609576","2869001","2024-09"
"054040","한국컴퓨터","67907728720","5020","13527436","16071290","2543854","2024-09"
"161890","한국콜마","1588621682100","67300","23605077","23605077","0","2024-09"
"021650","한국큐빅","39487716270","2430","16250089","16350563","100474","2024-09"
"161390","한국타이어앤테크놀로지","4257407479700","34900","121988753","123875069","1886316","2024-09"
"034830","한국토지신탁","224280559143","1041","215447223","252489230","37042007","2024-09"
"007280","한국특강","94868765160","1560","60813311","60813311","0","2024-09"
"032300","한국파마","241038092100","22100","10906701","10906701","0","2024-09"
"037230","한국팩키지","59362251384","1992","29800327","29800327","0","2024-09"
"047810","한국항공우주","5634061184600","57800","97475107","97475107","0","2024-09"
"123690","한국화장품","105078644340","6540","16067071","16068000","929","2024-09"
"003350","한국화장품제조","270425522200","74600","3625007","4532000","906993","2024-09"
"030520","한글과컴퓨터","424581658200","17640","24069255","24179744","110489","2024-09"
"052600","한네트","46139163000","3990","11563700","11563700","0","2024-09"
"011500","한농화성","282021728800","18440","15294020","15637042","343022","2024-09"
"002390","한독","203700288400","14800","13763533","13763533","0","2024-09"
"256150","한독크린텍","52314521280","6720","7784899","8395000","610101","2024-09"
"092460","한라IMS","103618931200","6340","16343680","17109680","766000","2024-09"
"053690","한미글로벌","145249734000","14280","10171550","10957550","786000","2024-09"
"042700","한미반도체","8859634825200","92600","95676402","96993634","1317232","2024-09"
"008930","한미사이언스","2810118799000","41500","67713706","68391550","677844","2024-09"
"128940","한미약품","4209831048000","332000","12680214","12810991","130777","2024-09"
"452190","한빛레이저","96465102685","4165","23160889","23162757","1868","2024-09"
"047080","한빛소프트","33882524130","1365","24822362","24822362","0","2024-09"
"009240","한샘","849936486400","51200","16600322","23533928","6933606","2024-09"
"452280","한선엔지니어링","151832325000","8930","17002500","17002500","0","2024-09"
"020000","한섬","335470646280","15620","21476994","23398500","1921506","2024-09"
"003680","한성기업","29087483250","5150","5648055","6209515","561460","2024-09"
"066980","한성크린텍","107240096250","2065","51932250","51935125","2875","2024-09"
"105630","한세실업","600982123140","15260","39382839","40000000","617161","2024-09"
"069640","한세엠케이","46889944085","1709","27437065","30106502","2669437","2024-09"
"016450","한세예스24홀딩스","195025830555","4965","39280127","40000000","719873","2024-09"
"010420","한솔PNS","21599634648","1054","20493012","20493012","0","2024-09"
"009180","한솔로지스틱스","63113251500","2250","28050334","28057025","6691","2024-09"
"114810","한솔아이원스","187632979170","6790","27633723","29113174","1479451","2024-09"
"070590","한솔인티큐브","15643535020","1145","13662476","13879521","217045","2024-09"
"213500","한솔제지","223027021840","9380","23776868","23800576","23708","2024-09"
"014680","한솔케미칼","1391961946000","122800","11335195","11335195","0","2024-09"
"004710","한솔테크닉스","136037848610","4330","31417517","32109878","692361","2024-09"
"004150","한솔홀딩스","94156090605","2295","41026619","42008577","981958","2024-09"
"025750","한솔홈데코","56073343704","696","80565149","80565149","0","2024-09"
"226440","한송네오텍","100580954580","1530","65739186","65739186","0","2024-09"
"042520","한스바이오메드","103636092420","7980","12986979","13526367","539388","2024-09"
"004960","한신공영","79143601680","6840","11570702","11570702","0","2024-09"
"011700","한신기계","118225181905","3655","32346151","32446151","100000","2024-09"
"430690","한싹","51970600080","4770","10895304","10895327","23","2024-09"
"078350","한양디지텍","177457779720","11960","14837607","15244382","406775","2024-09"
"045100","한양이엔지","284052655440","16920","16787982","18000000","1212018","2024-09"
"001750","한양증권","158979389660","12490","12728534","12728534","0","2024-09"
"018880","한온시스템","2078638534850","3895","533668430","533800000","131570","2024-09"
"009420","한올바이오파마","2317459796000","45700","50710280","52240638","1530358","2024-09"
"214870","한울BnC","64715071880","6920","9351889","9359221","7332","2024-09"
"320000","한울반도체","78863056860","2820","27965623","27965627","4","2024-09"
"091440","한울소재과학","71805668900","5110","14051990","14606671","554681","2024-09"
"014130","한익스프레스","41005000000","3475","11800000","12000000","200000","2024-09"
"024740","한일단조","110095450800","3525","31232752","31532546","299794","2024-09"
"005860","한일사료","161358090075","4095","39403685","39403685","0","2024-09"
"300720","한일시멘트","988362175800","14270","69261540","69261540","0","2024-09"
"002220","한일철강","48951017400","2010","24353740","26697460","2343720","2024-09"
"006390","한일현대시멘트","267881533920","13860","19327672","19327672","0","2024-09"
"003300","한일홀딩스","445514365800","14450","30831444","30832884","1440","2024-09"
"007770","한일화학","40821300000","11630","3510000","3510000","0","2024-09"
"051600","한전KPS","2016000000000","44800","45000000","45000000","0","2024-09"
"052690","한전기술","2739132360000","72000","38043505","38220000","176495","2024-09"
"130660","한전산업","439122000000","13470","32600000","32600000","0","2024-09"
"198940","한주라이트메탈","38374082728","986","38918948","38922978","4030","2024-09"
"058450","한주에이알티","32271464490","2235","14439134","14452469","13335","2024-09"
"107640","한중엔시에스","337375264200","37700","8948946","8948946","0","2024-09"
"002320","한진","275638774350","19050","14469227","14947628","478401","2024-09"
"003480","한진중공업홀딩스","88965208640","3410","26089504","29529812","3440308","2024-09"
"180640","한진칼","5683815882300","85700","66322239","66762279","440040","2024-09"
"005110","한창","22551214950","1254","17983425","18606407","622982","2024-09"
"079170","한창산업","42134253050","8150","5169847","5200000","30153","2024-09"
"009460","한창제지","43020257406","721","59667486","59667486","0","2024-09"
"372910","한컴라이프케어","111666228210","4035","27674406","27674406","0","2024-09"
"054920","한컴위드","62320925565","2505","24878613","28217081","3338468","2024-09"
"457370","한켐","112781162450","14050","8027129","8027134","5","2024-09"
"002680","한탑","22177011285","715","31016799","32316799","1300000","2024-09"
"000880","한화","1935591292800","27900","69376032","74958735","5582703","2024-09"
"452260","한화갤러리아","249003739265","1285","193777229","193859610","82381","2024-09"
"088350","한화생명","2197816481250","2925","751390250","868530000","117139750","2024-09"
"000370","한화손해보험","549775125630","4755","115620426","116738915","1118489","2024-09"
"009830","한화솔루션","3708727310100","21900","169348279","171892536","2544257","2024-09"
"272210","한화시스템","3612709802520","19320","186993261","188919389","1926128","2024-09"
"012450","한화에어로스페이스","17322754788000","381000","45466548","45581161","114613","2024-09"
"082740","한화엔진","1207167491450","14470","83425535","83447142","21607","2024-09"
"042660","한화오션","8716999970150","28450","306397187","306413394","16207","2024-09"
"489790","한화인더스트리얼솔루션즈","2428197524400","48200","50377542","50488390","110848","2024-09"
"003530","한화투자증권","778488212320","3640","213870388","214547775","677387","2024-09"
"430460","한화플러스제3호스팩","12639200000","2135","5920000","5920000","0","2024-09"
"455310","한화플러스제4호스팩","10904300000","2155","5060000","5060000","0","2024-09"
"195870","해성디에스","443700000000","26100","17000000","17000000","0","2024-09"
"034810","해성산업","199437627600","6730","29634120","32556857","2922737","2024-09"
"059270","해성에어로보틱스","63056922340","5660","11140799","11140799","0","2024-09"
"076610","해성옵틱스","28598779125","1125","25421137","25453198","32061","2024-09"
"101530","해태제과식품","152476556500","5750","26517662","29116822","2599160","2024-09"
"220180","핸디소프트","59485520000","3065","19408000","19408000","0","2024-09"
"143210","핸즈코퍼레이션","41654800290","1938","21493705","21875747","382042","2024-09"
"214180","헥토이노베이션","153966620720","12440","12376738","13257185","880447","2024-09"
"234340","헥토파이낸셜","137529738700","16550","8309954","9453000","1143046","2024-09"
"084990","헬릭스미스","166919969000","3625","46046888","46092797","45909","2024-09"
"187660","현대ADM","76785132270","3630","21152929","21836250","683321","2024-09"
"000720","현대건설","3173639302500","28500","111355765","111355765","0","2024-09"
"170030","현대공업","79187449440","5280","14997623","15340000","342377","2024-09"
"453340","현대그린푸드","393682303550","11630","33850585","33880914","30329","2024-09"
"086280","현대글로비스","9300000000000","124000","75000000","75000000","0","2024-09"
"064350","현대로템","7039677898500","64500","109142293","109142293","0","2024-09"
"079430","현대리바트","158499911760","7880","20114202","20535282","421080","2024-09"
"012330","현대모비스","22277139142500","247500","90008643","92995094","2986451","2024-09"
"319400","현대무벡스","366115823440","3140","116597396","117741058","1143662","2024-09"
"048410","현대바이오","687282015520","17260","39819352","39821608","2256","2024-09"
"052260","현대바이오랜드","156300000000","5210","30000000","30000000","0","2024-09"
"069960","현대백화점","1000967518800","45800","21855186","23402441","1547255","2024-09"
"004560","현대비앤지스틸","196476907330","13030","15078811","15078811","0","2024-09"
"016790","현대사료","187340898626","994","188471729","188471729","0","2024-09"
"004310","현대약품","101667865220","3890","26135698","32000000","5864302","2024-08"
"041440","현대에버다임","140949524800","7900","17841712","17915944","74232","2024-09"
"039010","현대에이치티","47546280000","6120","7769000","8625000","856000","2024-09"
"017800","현대엘리베이","1686106395400","46700","36105062","39092385","2987323","2024-09"
"307950","현대오토에버","3841978551600","140100","27423116","27423982","866","2024-09"
"011210","현대위아","1131112639350","42450","26645763","27195083","549320","2024-09"
"090850","현대이지웰","128942740230","5430","23746361","23746361","0","2024-09"
"004020","현대제철","3380725492300","25700","131545739","133445785","1900046","2024-09"
"005440","현대지에프홀딩스","708585048045","4545","155904301","155904301","0","2024-09"
"005380","현대차","45659237344000","224000","203835881","209416191","5580310","2024-09"
"001500","현대차증권","281607550560","8880","31712562","31712562","0","2024-09"
"011760","현대코퍼레이션","230009998900","19150","12010966","13228966","1218000","2024-09"
"227840","현대코퍼레이션홀딩스","92627860500","10500","8821701","9100836","279135","2024-09"
"126560","현대퓨처넷","432351918375","3925","110153355","110202945","49590","2024-09"
"001450","현대해상","2360276450000","30100","78414500","89400000","10985500","2024-09"
"057050","현대홈쇼핑","540906187500","47250","11447750","12000000","552250","2024-09"
"460930","현대힘스","356952628390","10090","35376871","35376871","0","2024-09"
"092300","현우산업","51233249200","2800","18297589","18672816","375227","2024-09"
"138360","협진","39619895720","820","48316946","48348248","31302","2024-09"
"011080","형지I&C","15578176367","611","25496197","25503364","7167","2024-09"
"093240","형지엘리트","46117201506","1362","33859913","34164255","304342","2024-09"
"003010","혜인","53042974005","4935","10748323","12712747","1964424","2024-09"
"111110","호전실업","75501598400","8200","9207512","9749984","542472","2024-09"
"008770","호텔신라","1608853795350","43350","37113121","39248121","2135000","2024-09"
"060560","홈센타홀딩스","99013206240","780","126940008","127669525","729517","2024-09"
"064240","홈캐스트","92602207775","2695","34360745","35038012","677267","2024-09"
"039610","화성밸브","101605504000","9760","10410400","10410400","0","2024-09"
"378850","화승알앤에이","72449848590","3815","18990786","18993623","2837","2024-09"
"241590","화승엔터프라이즈","541062234680","8930","60589276","60589276","0","2024-09"
"006060","화승인더","203561819945","4115","49468243","55320000","5851757","2024-09"
"013520","화승코퍼레이션","83437449718","1879","44405242","50051252","5646010","2024-09"
"010690","화신","311693515770","8970","34748441","34920410","171969","2024-09"
"126640","화신정공","47009975310","1341","35055910","36373887","1317977","2024-09"
"133820","화인베스틸","25863113002","839","30826118","30826118","0","2024-09"
"127980","화인써키트","80627907540","6810","11839634","11840684","1050","2024-09"
"061250","화일약품","103234648020","1385","74537652","76877652","2340000","2024-09"
"010660","화천기계","63250000000","2875","22000000","22000000","0","2024-09"
"000850","화천기공","58740000000","26700","2200000","2200000","0","2024-09"
"016580","환인제약","200303958400","13120","15267070","18600070","3333000","2024-09"
"032560","황금에스티","89870656780","5290","16988782","17000000","11218","2024-09"
"004800","효성","828392954200","49550","16718324","16740407","22083","2024-09"
"094280","효성ITX","137538027900","12460","11038365","11558200","519835","2024-09"
"097870","효성오앤비","48918000000","6200","7890000","8490000","600000","2024-09"
"298040","효성중공업","3771255105000","405000","9311741","9324548","12807","2024-09"
"298020","효성티앤씨","1299022690000","301000","4315690","4327682","11992","2024-09"
"298000","효성화학","150423304000","39800","3779480","3791811","12331","2024-09"
"093370","후성","657474596680","6130","107255236","107255330","94","2024-09"
"081660","휠라홀딩스","2270760561300","38150","59521902","60095839","573937","2024-09"
"290270","휴네시온","34220761110","3690","9273919","9607672","333753","2024-09"
"005870","휴니드","111792784600","8540","13090490","14116015","1025525","2024-09"
"353190","휴럼","31305119655","795","39377509","39378420","911","2024-09"
"192410","휴림네트웍스","35551450000","2500","14220580","14235530","14950","2024-09"
"090710","휴림로봇","135326863880","1235","109576408","109623165","46757","2024-09"
"078590","휴림에이텍","30662095882","571","53698942","54210339","511397","2024-09"
"205470","휴마시스","176067375040","1556","113153840","129375009","16221169","2024-09"
"115160","휴맥스","74298211829","1723","43121423","43970124","848701","2024-09"
"028080","휴맥스홀딩스","32863354580","3010","10918058","12577506","1659448","2024-09"
"175140","휴먼테크놀로지","101014295940","4695","21515292","21515292","0","2024-09"
"200670","휴메딕스","320601160900","31100","10308719","11229930","921211","2024-09"
"079980","휴비스","85566832000","2600","32910320","34500000","1589680","2024-09"
"065510","휴비츠","96269370750","8850","10877895","12159371","1281476","2024-09"
"215090","휴센텍","149904424845","1505","99604269","99649272","45003","2024-09"
"005010","휴스틸","225595121125","4015","56188075","56188075","0","2024-09"
"263920","휴엠앤씨","49437495072","1008","49045134","49045134","0","2024-09"
"243070","휴온스","327156445400","27700","11810702","11979665","168963","2024-09"
"084110","휴온스글로벌","429413662900","35300","12164693","12621492","456799","2024-09"
"145020","휴젤","3041284883000","276500","10999222","12604033","1604811","2024-09"
"024060","흥구석유","234107153700","16100","14540817","15000000","459183","2024-09"
"010240","흥국","53969643000","4875","11070696","12322696","1252000","2024-09"
"189980","흥국에프엔비","71195574480","1840","38693247","40137827","1444580","2024-09"
"000540","흥국화재","218424993000","3400","64242645","64242645","0","2024-09"
"003280","흥아해운","462509820850","1925","240264842","240424899","160057","2024-09"
"037440","희림","57820301600","4580","12624520","13922475","1297955","2024-09"
"238490","힘스","47396743800","4270","11099940","11312236","212296","2024-09"