종목코드,종목명,자기주식 제외 시가총액(A*B),종가,자기주식 제외 발행주식수(B=C-D),총발행주식수(C),자기주식수(D),자기주식수 반영시점
"060310","3S","105745208940","2070","51084642","51084642","0","2024-09"
"095570","AJ네트웍스","216818837250","4845","44751050","45252759","501709","2024-09"
"006840","AK홀딩스","163460052350","12530","13045495","13247561","202066","2024-09"
"054620","APS","108289886240","5960","18169444","19894221","1724777","2024-09"
"265520","AP시스템","270062009320","17980","15020134","15281421","261287","2024-09"
"211270","AP위성","151725496260","10660","14233161","15082304","849143","2024-09"
"109960","AP헬스케어","65846039263","577","114117919","114153169","35250","2024-09"
"139050","BF랩스","24234697905","2805","8639821","8644551","4730","2024-09"
"027410","BGF","346944276750","3625","95708766","95716791","8025","2024-09"
"282330","BGF리테일","1957259199500","113300","17275015","17283906","8891","2024-09"
"126600","BGF에코머티리얼즈","213948111000","3455","61924200","62766899","842699","2024-09"
"138930","BNK금융지주","3050114112020","9580","318383519","320436727","2053208","2024-09"
"001460","BYC","202275468000","32400","6243070","6246150","3080","2024-09"
"013720","CBI","48850499904","1096","44571624","44628136","56512","2024-09"
"083790","CG인바이츠","180701327700","2350","76894182","76894182","0","2024-09"
"001040","CJ","2903372221500","107300","27058455","29176998","2118543","2024-09"
"079160","CJ CGV","932215416890","5630","165580003","165580003","0","2024-09"
"035760","CJ ENM","1293528225600","62400","20729619","21929154","1199535","2024-09"
"311690","CJ 바이오사이언스","109623399060","12030","9112502","9112502","0","2024-09"
"000120","CJ대한통운","1761154890700","88300","19945129","22812344","2867215","2024-09"
"011150","CJ씨푸드","113900550410","3170","35930773","35930773","0","2024-09"
"097950","CJ제일제당","4107777680500","279500","14696879","15054186","357307","2024-09"
"051500","CJ프레시웨이","220692783740","18590","11871586","11871586","0","2024-09"
"058820","CMG제약","310424165340","2235","138892244","138892244","0","2024-09"
"023460","CNH","8865820091","269","32958439","37200000","4241561","2024-09"
"056730","CNT85","56467252078","811","69626698","74111186","4484488","2024-09"
"000480","CR홀딩스","234749780880","5690","41256552","46890490","5633938","2024-09"
"065770","CS","19915819380","1026","19411130","19411130","0","2024-09"
"083660","CSA 코스믹","49822937454","841","59242494","61247181","2004687","2024-09"
"000590","CS홀딩스","72572615800","69700","1041214","1154482","113268","2024-09"
"012030","DB","310424616125","1625","191030533","201173933","10143400","2024-09"
"456440","DB금융스팩11호","12065050000","2270","5315000","5315000","0","2024-09"
"477760","DB금융스팩12호","12030400000","2060","5840000","5840000","0","2024-09"
"016610","DB금융투자","226868266730","5570","40730389","42446389","1716000","2024-09"
"005830","DB손해보험","6712859834200","111800","60043469","70800000","10756531","2024-09"
"000990","DB하이텍","1574254134150","37850","41591919","44398588","2806669","2024-09"
"139130","DGB금융지주","1352773724160","8130","166392832","169145833","2753001","2024-09"
"099520","DGI","58000622016","1284","45171824","45281824","110000","2024-09"
"060900","DGP","29748726664","1178","25253588","25258229","4641","2024-09"
"290120","DH오토리드","42433902430","2735","15515138","15515138","0","2024-09"
"025440","DH오토웨어","32628096380","212","153906115","153906120","5","2024-09"
"001530","DI동일","730279876300","37700","19370819","25215672","5844853","2024-09"
"000210","DL","885369752100","42300","20930727","20955884","25157","2024-09"
"375500","DL이앤씨","1213443540400","31550","38460968","38693623","232655","2024-09"
"068790","DMS","131058178720","5570","23529296","24573061","1043765","2024-09"
"007340","DN오토모티브","915158259600","17680","51762345","60564965","8802620","2024-09"
"004840","DRB동일","88074703480","4570","19272364","19930000","657636","2024-09"
"241520","DSC인베스트먼트","75308544000","2880","26148800","27496125","1347325","2024-09"
"155660","DSR","63680000000","3980","16000000","16000000","0","2024-09"
"069730","DSR제강","53208000000","3695","14400000","14400000","0","2024-09"
"017860","DS단석","409712139600","69900","5861404","5861404","0","2024-09"
"180400","DXVX","121816272600","2475","49218696","49219432","736","2024-09"
"017940","E1","427271398900","73900","5781751","6860000","1078249","2024-09"
"245620","EDGC","57441040175","415","138412145","138493951","81806","2024-09"
"037370","EG","61151051480","7090","8624972","8624972","0","2024-09"
"050120","ES큐브","24296910098","1814","13394107","13564086","169979","2024-09"
"383220","F&F","2299479894400","60800","37820393","38307075","486682","2024-09"
"007700","F&F홀딩스","530569146940","13580","39069893","39114367","44474","2024-09"
"214270","FSN","67492453420","2030","33247514","33250463","2949","2024-09"
"130500","GH신소재","45962304280","3160","14545033","14545052","19","2024-09"
"114090","GKL","677938143200","10960","61855670","61855670","0","2024-09"
"078930","GS","3873742141500","41700","92895495","92915378","19883","2024-09"
"083450","GST","289804047400","15580","18601030","18618260","17230","2024-09"
"006360","GS건설","1580631224900","18620","84888895","85581490","692595","2024-09"
"001250","GS글로벌","285845874930","3465","82495202","82533764","38562","2024-09"
"007070","GS리테일","2161859550400","20900","103438256","104717922","1279666","2024-09"
"297890","HB솔루션","304997611380","4170","73140914","73140914","0","2024-09"
"440290","HB인베스트먼트","52099673220","1922","27107010","27107010","0","2024-09"
"078150","HB테크놀러지","221247998820","2490","88854618","92715916","3861298","2024-09"
"012630","HDC","551341465720","11020","50030986","59741721","9710735","2024-09"
"039570","HDC랩스","184024567530","8010","22974353","25957601","2983248","2024-09"
"089470","HDC현대EP","104716246520","4040","25919863","31900000","5980137","2024-09"
"294870","HDC현대산업개발","1402099860500","21850","64169330","65907330","1738000","2024-09"
"009540","HD한국조선해양","13916639184000","196800","70714630","70773116","58486","2024-09"
"267250","HD현대","5547471755000","78500","70668430","78993085","8324655","2024-09"
"267270","HD현대건설기계","953736606000","54000","17661789","18305586","643797","2024-09"
"443060","HD현대마린솔루션","5511800000000","124000","44450000","44450000","0","2024-09"
"071970","HD현대마린엔진","724223448550","21350","33921473","33921495","22","2024-09"
"010620","HD현대미포","4199816579400","105300","39884298","39942149","57851","2024-09"
"322000","HD현대에너지솔루션","252000000000","22500","11200000","11200000","0","2024-09"
"042670","HD현대인프라코어","1440580919360","7480","192591032","192655867","64835","2024-09"
"267260","HD현대일렉트릭","11481672576000","319000","35992704","36047135","54431","2024-09"
"329180","HD현대중공업","17106579453200","192700","88773116","88773116","0","2024-09"
"097230","HJ중공업","207754508300","2495","83268340","83274281","5941","2024-09"
"195940","HK이노엔","1390997648100","49100","28329891","28329891","0","2024-09"
"014790","HL D&I","93132158460","2460","37858601","37858601","0","2024-09"
"028300","HLB","9278769214400","70900","130871216","131127236","256020","2024-09"
"003580","HLB글로벌","209640672365","4415","47483731","47489591","5860","2024-09"
"278650","HLB바이오스텝","197438499090","2345","84195522","86730589","2535067","2024-09"
"067630","HLB생명과학","1107811338340","9340","118609351","118679271","69920","2024-09"
"024850","HLB이노베이션","363964783560","3990","91219244","91226268","7024","2024-09"
"047920","HLB제약","685277350150","21550","31799413","31799994","581","2024-09"
"115450","HLB테라퓨틱스","774089458900","9700","79803037","80139933","336896","2024-09"
"046210","HLB파나진","131356544900","3100","42373079","42373079","0","2024-09"
"204320","HL만도","1706891312000","36350","46957120","46957120","0","2024-09"
"060980","HL홀딩스","340514807850","35850","9498321","10169410","671089","2024-09"
"011200","HMM","13070739205200","17450","749039496","749039496","0","2024-09"
"403870","HPSP","2426490569100","30300","80082197","82934144","2851947","2024-09"
"036640","HRS","84223901550","5270","15981765","16354800","373035","2024-09"
"035000","HS애드","103566845160","6390","16207644","16567409","359765","2024-09"
"002460","HS화성","84330735390","8910","9464729","10150000","685271","2024-09"
"487570","HS효성","149360948100","40300","3706227","3725927","19700","2024-09"
"298050","HS효성첨단소재","1161685720000","260000","4468022","4479948","11926","2024-09"
"439730","IBKS제20호스팩","9482000000","2200","4310000","4310000","0","2024-09"
"442770","IBKS제21호스팩","9219900000","2190","4210000","4210000","0","2024-09"
"448760","IBKS제22호스팩","9723850000","2195","4430000","4430000","0","2024-09"
"467930","IBKS제23호스팩","9200250000","2175","4230000","4230000","0","2024-09"
"469480","IBKS제24호스팩","9284850000","2195","4230000","4230000","0","2024-09"
"003560","IHQ","61224765840","10760","5690034","5772083","82049","2024-09"
"095340","ISC","1195108812800","58400","20464192","21197058","732866","2024-09"
"175330","JB금융지주","3240854830200","16900","191766558","195083198","3316640","2024-09"
"234080","JW생명과학","172497931560","11140","15484554","15834554","350000","2024-09"
"067290","JW신약","84656463310","1670","50692493","50841502","149009","2024-09"
"001060","JW중외제약","670074518850","29150","22987119","23285930","298811","2024-09"
"096760","JW홀딩스","223419802400","3100","72070904","73924942","1854038","2024-09"
"035900","JYP Ent.","1683159397200","50800","33133059","35532492","2399433","2024-09"
"318000","KBG","50630281020","5820","8699361","8740223","40862","2024-09"
"024840","KBI메탈","102946529355","2955","34838081","34909199","71118","2024-09"
"105560","KB금융","35269667015000","93500","377215690","393528423","16312733","2024-09"
"024120","KB오토시스","42722500000","3715","11500000","11500000","0","2024-09"
"455250","KB제25호스팩","11365200000","2640","4305000","4305000","0","2024-09"
"458320","KB제26호스팩","12248625000","2225","5505000","5505000","0","2024-09"
"464680","KB제27호스팩","25732570000","1994","12905000","12905000","0","2024-09"
"476470","KB제28호스팩","11615550000","2110","5505000","5505000","0","2024-09"
"478390","KB제29호스팩","12688800000","2040","6220000","6220000","0","2024-09"
"486630","KB제30호스팩","10726200000","2020","5310000","5310000","0","2024-09"
"002380","KCC","1959886571500","266500","7354171","8886471","1532300","2024-09"
"021320","KCC건설","85366466080","4280","19945436","21400000","1454564","2024-09"
"344820","KCC글라스","628964486850","39450","15943333","15970512","27179","2024-09"
"036670","KCI","81992724000","7620","10760200","11270000","509800","2024-09"
"009070","KCTC","137566450000","4600","29905750","30000000","94250","2024-09"
"009440","KC그린홀딩스","19182357660","867","22124980","22434980","310000","2024-09"
"119650","KC코트렐","27676375799","431","64214329","64214329","0","2024-09"
"044180","KD","12367281433","463","26711191","26717799","6608","2024-09"
"092220","KEC","180686826900","900","200763141","200763141","0","2024-09"
"046440","KG모빌리언스","164922932790","4445","37103022","38825568","1722546","2024-09"
"003620","KG모빌리티","1005589780480","5120","196404254","196404254","0","2024-09"
"016380","KG스틸","664818923340","6670","99673002","100008897","335895","2024-09"
"151860","KG에코솔루션","226168377820","5390","41960738","49603002","7642264","2024-09"
"035600","KG이니시스","250746156960","9420","26618488","27904434","1285946","2024-09"
"001390","KG케미칼","281407754400","4110","68469040","68469040","0","2024-09"
"226360","KH 건설","60474013950","2555","23668890","23756732","87842","2024-09"
"111870","KH 미래물산","43747975260","8910","4909986","4930249","20263","2024-09"
"033180","KH 필룩스","125157155370","6630","18877399","18903579","26180","2024-09"
"060720","KH바텍","201862968720","9160","22037442","23677442","1640000","2024-09"
"015590","KIB플러그에너지","89816004039","379","236981541","236981544","3","2024-09"
"001940","KISCO홀딩스","239707112840","18980","12629458","16176380","3546922","2024-09"
"058400","KNN","102500603280","774","132429720","132429720","0","2024-09"
"025000","KPX케미칼","226824041700","47700","4755221","4840000","84779","2024-09"
"092230","KPX홀딩스","220540824900","56100","3931209","4224646","293437","2024-09"
"000040","KR모터스","32585722920","542","60121260","60132868","11608","2024-09"
"044450","KSS해운","204778151750","9070","22577525","23085880","508355","2024-09"
"101000","KS인더스트리","66291808000","2200","30132640","30149619","16979","2024-09"
"030200","KT","10558217036250","42950","245825775","252021685","6195910","2024-09"
"033780","KT&G","11695730183800","106600","109716043","130322497","20606454","2024-09"
"058850","KTcs","109263539520","2880","37938729","42685000","4746271","2024-09"
"058860","KTis","82520312490","2695","30619782","34802000","4182218","2024-09"
"122450","KX","149260251370","3595","41518846","45335964","3817118","2024-09"
"052900","KX하이텍","53692583360","988","54344720","55107517","762797","2024-09"
"376190","LB루셈","124722000000","5070","24600000","24600000","0","2024-09"
"061970","LB세미콘","207538966080","4740","43784592","43784592","0","2024-09"
"309960","LB인베스트먼트","92671635290","4030","22995443","23217239","221796","2024-09"
"093050","LF","421361073120","15220","27684696","29240000","1555304","2024-09"
"003550","LG","11762737911200","77800","151192004","157300993","6108989","2024-09"
"034220","LG디스플레이","5300000000000","10600","500000000","500000000","0","2024-09"
"051900","LG생활건강","5108935072500","348500","14659785","15618197","958412","2024-09"
"373220","LG에너지솔루션","91143000000000","389500","234000000","234000000","0","2024-09"
"032640","LG유플러스","4229510983680","9840","429828352","436611361","6783009","2024-09"
"011070","LG이노텍","4713969794400","199200","23664507","23667107","2600","2024-09"
"066570","LG전자","15832386813600","97200","162884638","163647814","763176","2024-09"
"037560","LG헬로비전","205234192250","2650","77446865","77446865","0","2024-09"
"051910","LG화학","23330769361500","330500","70592343","70592343","0","2024-09"
"079550","LIG넥스원","5546664620000","254500","21794360","22000000","205640","2024-09"
"225190","LK삼양","128647295400","2535","50748440","50748440","0","2024-09"
"006260","LS","3180518669400","116300","27347538","32200000","4852462","2024-09"
"010120","LS ELECTRIC","4522394515000","152500","29655046","30000000","344954","2024-09"
"000680","LS네트웍스","260049946200","3300","78803014","78803016","2","2024-09"
"060370","LS마린솔루션","459936829860","16810","27360906","28706781","1345875","2024-09"
"417200","LS머트리얼즈","1107474027830","16370","67652659","67652659","0","2024-09"
"229640","LS에코에너지","874950567600","28850","30327576","30624879","297303","2024-09"
"078020","LS증권","221533016340","4395","50405692","55481190","5075498","2024-09"
"108320","LX세미콘","1047420920000","64400","16264300","16264300","0","2024-09"
"001120","LX인터내셔널","1064649899200","29600","35967902","38760000","2792098","2024-09"
"108670","LX하우시스","375891390000","42000","8949795","8967670","17875","2024-09"
"383800","LX홀딩스","542792694480","7120","76234929","76280690","45761","2024-09"
"476080","M83","108678600000","13960","7785000","7785000","0","2024-09"
"086960","MDS테크","100433174616","1082","92821788","92821788","0","2024-09"
"023150","MH에탄올","38425304910","5990","6414909","7378526","963617","2024-09"
"038340","MIT","39924432729","1233","32379913","32424892","44979","2024-09"
"035420","NAVER","26740106099200","176800","151244944","160784508","9539564","2024-09"
"160550","NEW","66416532280","2380","27906106","27906106","0","2024-09"
"053290","NE능률","59081547525","3575","16526307","16526307","0","2024-09"
"181710","NHN","535251232800","16260","32918280","33766123","847843","2024-09"
"060250","NHN KCP","283810766780","7340","38666317","40160611","1494294","2024-09"
"104200","NHN벅스","47998037700","3550","13520574","14827550","1306976","2024-09"
"005940","NH투자증권","4519763325240","13830","326808628","327492299","683671","2024-09"
"034310","NICE","391903758400","11200","34991407","37503477","2512070","2024-09"
"030190","NICE평가정보","649191537520","11080","58591294","60107670","1516376","2024-09"
"008260","NI스틸","113828465660","3980","28600117","28600117","0","2024-09"
"004250","NPC","176657371650","5210","33907365","36720000","2812635","2024-09"
"222160","NPX","79551289560","8040","9894439","9894439","0","2024-09"
"456040","OCI","709037604000","79200","8952495","8952495","0","2024-09"
"010060","OCI홀딩스","1271650609800","66600","19093853","19563983","470130","2024-09"
"178920","PI첨단소재","607882865400","20700","29366322","29366322","0","2024-09"
"024940","PN풍년","56674040400","6030","9398680","10000000","601320","2024-09"
"005490","POSCO홀딩스","25975737586500","343500","75620779","82624377","7003598","2024-09"
"218410","RFHIC","334191690570","12990","25726843","26484442","757599","2024-09"
"327260","RF머트리얼즈","53907558810","6510","8280731","8433231","152500","2024-09"
"091340","S&K폴리텍","26559021840","2480","10709283","11703721","994438","2024-09"
"010950","S-Oil","6597351611200","58600","112582792","112582792","0","2024-09"
"419530","SAMG엔터","109393699500","13770","7944350","8590930","646580","2024-09"
"019550","SBI인베스트먼트","114894533339","713","161142403","162066575","924172","2024-09"
"034120","SBS","286387203360","15440","18548394","18551238","2844","2024-09"
"036120","SCI평가정보","79636660740","2340","34032761","35500000","1467239","2024-09"
"246960","SCL사이언스","64967936920","8920","7283401","7283401","0","2024-09"
"099220","SDN","69719120757","1287","54171811","56171811","2000000","2024-09"
"036540","SFA반도체","595192946370","3630","163964999","164460303","495304","2024-09"
"255220","SG","238322795175","2855","83475585","94073791","10598206","2024-09"
"040610","SG&G","52576401988","1558","33746086","34087196","341110","2024-09"
"049470","SGA","19475976195","333","58486415","58862249","375834","2024-09"
"184230","SGA솔루션즈","31928963584","512","62361257","62599161","237904","2024-09"
"016250","SGC E&C","49880338440","15420","3234782","3243585","8803","2024-09"
"005090","SGC에너지","417089655900","28950","14407242","14409333","2091","2024-09"
"001380","SG글로벌","135117249715","3005","44964143","44964143","0","2024-09"
"004060","SG세계물산","68776923656","346","198777236","202424960","3647724","2024-09"
"001770","SHD","21248216220","17490","1214878","1214878","0","2024-09"
"002360","SH에너지화학","55861778628","513","108892356","111133730","2241374","2024-09"
"009160","SIMPAC","223047710760","4110","54269516","65429516","11160000","2024-09"
"033530","SJG세종","126063713340","4660","27052299","27820961","768662","2024-09"
"123700","SJM","52276408300","3350","15604898","15604898","0","2024-09"
"025530","SJM홀딩스","48516127780","3580","13551991","14934008","1382017","2024-09"
"034730","SK","7987231128500","146500","54520349","72502703","17982354","2024-09"
"011790","SKC","5041954480000","148000","34067260","37868298","3801038","2024-09"
"018670","SK가스","1618200793800","180300","8975046","9230244","255198","2024-09"
"001740","SK네트웍스","990975094900","5110","193928590","221277902","27349312","2024-09"
"006120","SK디스커버리","589733609400","33300","17709718","18785855","1076137","2024-09"
"210980","SK디앤디","156105103490","8390","18606091","18617382","11291","2024-09"
"302440","SK바이오사이언스","4457960971700","56900","78347293","78347293","0","2024-09"
"326030","SK바이오팜","9734336975000","124300","78313250","78313250","0","2024-09"
"402340","SK스퀘어","11559635917800","86700","133329134","134749960","1420826","2024-09"
"361610","SK아이이테크놀로지","2317053050000","32500","71293940","71297592","3652","2024-09"
"100090","SK오션플랜트","851232267840","14380","59195568","59195568","0","2024-09"
"096770","SK이노베이션","10893098673600","114400","95219394","95735590","516196","2024-09"
"475150","SK이터닉스","531297956160","15780","33669072","33691895","22823","2024-09"
"001510","SK증권","207780913906","502","413906203","472590171","58683968","2024-09"
"285130","SK케미칼","862868592600","50100","17222926","17253783","30857","2024-09"
"017670","SK텔레콤","11985501054600","56300","212886342","214790053","1903711","2024-09"
"000660","SK하이닉스","131537493747900","190900","689038731","728002365","38963634","2024-09"
"048550","SM C&C","164402309151","1713","95973327","96714620","741293","2024-09"
"063440","SM Life Design","63151999288","1372","46029154","46029154","0","2024-09"
"003570","SNT다이내믹스","602394591900","26900","22393851","33252697","10858846","2024-09"
"064960","SNT모티브","539327607800","45050","11971756","14623136","2651380","2024-09"
"100840","SNT에너지","263020347480","13310","19761108","20680783","919675","2024-09"
"036530","SNT홀딩스","335464158400","23200","14459662","16303886","1844224","2024-09"
"067160","SOOP","979319484000","91900","10656360","11494767","838407","2024-09"
"005610","SPC삼립","408503239200","50400","8105223","8629009","523786","2024-09"
"011810","STX","157068853500","5070","30980050","31017927","37877","2024-09"
"465770","STX그린로지스","74089398300","10370","7144590","7171032","26442","2024-09"
"077970","STX엔진","493341570150","21450","22999607","23008904","9297","2024-09"
"002820","SUN&L","39446677080","3270","12063204","12607989","544785","2024-09"
"289080","SV인베스트먼트","87144058000","1637","53234000","53234000","0","2024-09"
"084870","TBH글로벌","29408114790","1410","20856819","20856819","0","2024-09"
"002710","TCC스틸","1146849243750","43750","26213697","26213697","0","2024-09"
"089230","THE E&M","29748967760","1360","21874241","21882953","8712","2024-09"
"032540","TJ미디어","72583682890","5210","13931609","13931609","0","2024-09"
"022220","TKG애강","52053551895","1005","51794579","51794579","0","2024-09"
"069260","TKG휴켐스","763580452300","19900","38370877","40878588","2507711","2024-09"
"007980","TP","67094299006","1379","48654314","51175130","2520816","2024-09"
"048770","TPC","41835146015","2665","15697991","15697991","0","2024-09"
"246690","TS인베스트먼트","40918708960","1003","40796320","41477862","681542","2024-09"
"317240","TS트릴리온","29786621715","279","106762085","107240922","478837","2024-09"
"002900","TYM","133502742970","3110","42926927","45050956","2124029","2024-09"
"024070","WISCOM","32108887610","2095","15326438","15326438","0","2024-09"
"057030","YBM넷","59234710020","3660","16184347","16312697","128350","2024-09"
"037270","YG PLUS","220734346800","3480","63429410","63429410","0","2024-09"
"040300","YTN","135870000000","3235","42000000","42000000","0","2024-09"
"051390","YW","30359037120","3760","8074212","11355368","3281156","2024-09"
"052220","iMBC","58190000000","2530","23000000","23000000","0","2024-09"
"079940","가비아","177850356880","13720","12962854","13535684","572830","2024-09"
"078890","가온그룹","59933684760","3730","16068012","17410157","1342145","2024-09"
"000500","가온전선","285858784800","40100","7128648","7357946","229298","2024-09"
"399720","가온칩스","445746816000","38800","11488320","11488320","0","2024-09"
"036620","감성코퍼레이션","321236917680","3540","90744892","90744892","0","2024-09"
"000860","강남제비스코","166725000000","25650","6500000","6500000","0","2024-09"
"198440","강동씨앤엘","94940701440","1560","60859424","60931896","72472","2024-09"
"217730","강스템바이오텍","112388568745","2005","56054149","56054149","0","2024-09"
"035250","강원랜드","3389796046560","16720","202738998","213940500","11201502","2024-09"
"114190","강원에너지","342211797800","13100","26123038","26123038","0","2024-09"
"094480","갤럭시아머니트리","340122695460","8670","39229838","39229838","0","2024-09"
"011420","갤럭시아에스엠","69838347540","2535","27549644","27549644","0","2024-09"
"039240","경남스틸","74463707040","2760","26979604","26979604","0","2024-09"
"053950","경남제약","24666028695","693","35593115","35593402","287","2024-09"
"002100","경농","164712073000","9220","17864650","19522575","1657925","2024-09"
"009450","경동나비엔","1283420361600","88800","14452932","14568592","115660","2024-09"
"267290","경동도시가스","111034548950","18850","5890427","5895406","4979","2024-09"
"012320","경동인베스트","167887104000","77000","2180352","2365023","184671","2024-09"
"011040","경동제약","173774416500","6450","26941770","30768766","3826996","2024-09"
"000050","경방","149242467300","5990","24915270","27415270","2500000","2024-09"
"214390","경보제약","177867038400","7440","23906860","23906860","0","2024-09"
"012610","경인양행","124924842840","3020","41365842","41616365","250523","2024-09"
"009140","경인전자","26832262200","20600","1302537","1570797","268260","2024-09"
"024910","경창산업","82910440400","2330","35583880","35819005","235125","2024-09"
"013580","계룡건설","122060442660","13780","8857797","8930907","73110","2024-09"
"012200","계양전기","41772524544","1536","27195654","27222829","27175","2024-09"
"002140","고려산업","78455115600","3180","24671420","24939425","268005","2024-09"
"049720","고려신용정보","138838391520","9970","13925616","14300000","374384","2024-09"
"010130","고려아연","18025313383000","877000","20553379","20703283","149904","2024-09"
"002240","고려제강","490763593320","19640","24987963","25000000","12037","2024-09"
"014570","고려제약","54918499010","5090","10789489","11000000","210511","2024-09"
"348150","고바이오랩","144141444000","7440","19373850","19373850","0","2024-09"
"098460","고영","658590612680","10010","65793268","68654755","2861487","2024-09"
"035290","골드앤에스","22360269120","469","47676480","47676480","0","2024-09"
"215000","골프존","402942210000","67100","6005100","6275415","270315","2024-09"
"121440","골프존뉴딘홀딩스","163557216130","4015","40736542","42836818","2100276","2024-09"
"366030","공구우먼","102621940500","4530","22653850","22653850","0","2024-09"
"009290","광동제약","238078835280","5940","40080612","52420851","12340239","2024-09"
"014200","광림","91136252176","1006","90592696","90706696","114000","2024-09"
"017040","광명전기","67303316095","1553","43337615","43337615","0","2024-09"
"029480","광무","218510925450","3975","54971302","55009083","37781","2024-09"
"017900","광전자","92367141342","1834","50363763","57943763","7580000","2024-09"
"037710","광주신세계","225001574000","29500","7627172","7957190","330018","2024-09"
"026910","광진실업","13835674800","2160","6405405","6405405","0","2024-09"
"421800","교보12호스팩","14591200000","2440","5980000","5980000","0","2024-06"
"440790","교보13호스팩","8788500000","2170","4050000","4050000","0","2024-09"
"456490","교보14호스팩","9135000000","2175","4200000","4200000","0","2024-09"
"465320","교보15호스팩","8286750000","2175","3810000","3810000","0","2024-09"
"482520","교보16호스팩","12535500000","2055","6100000","6100000","0","2024-09"
"030610","교보증권","642226675470","5690","112869363","113962961","1093598","2024-09"
"339770","교촌에프앤비","219346701200","8780","24982540","24982540","0","2024-09"
"053270","구영테크","64948203840","2490","26083616","27410405","1326789","2024-09"
"007690","국도화학","278156808900","33350","8340534","9010616","670082","2024-09"
"005320","국동","32842656864","496","66215034","67327897","1112863","2024-09"
"001140","국보","33448047050","2110","15852155","15856388","4233","2024-09"
"066620","국보디자인","109057806000","16500","6609564","7500000","890436","2024-09"
"043650","국순당","75554236800","4800","15740466","17858304","2117838","2024-09"
"006050","국영지앤엠","63994218784","1888","33895243","34895243","1000000","2024-09"
"060480","국일신동","21703130000","1957","11090000","11090000","0","2024-09"
"078130","국일제지","901924696800","800","1127405871","1127405871","0","2024-09"
"307750","국전약품","216149614560","4405","49069152","49069269","117","2024-09"
"002720","국제약품","114437261240","5620","20362502","21159832","797330","2024-09"
"035080","그래디언트","152817060420","11170","13681026","14527584","846558","2024-09"
"453450","그리드위즈","166400612500","20950","7942750","7942750","0","2024-09"
"204020","그리티","56060639600","2800","20021657","20147430","125773","2024-09"
"402490","그린리소스","150357521360","18190","8265944","8265944","0","2024-09"
"114450","그린생명과학","39892812300","2090","19087470","20000000","912530","2024-09"
"083420","그린케미칼","141357523440","6060","23326324","24000000","673676","2024-09"
"186230","그린플러스","101494776600","9450","10740188","10820188","80000","2024-09"
"014530","극동유화","126597019200","3760","33669420","34869420","1200000","2024-09"
"204620","글로벌텍스프리","233460457460","3820","61115303","61116035","732","2024-09"
"019660","글로본","19830725220","570","34790746","34790746","0","2024-09"
"014280","금강공업","113803415495","4235","26872117","29329357","2457240","2024-09"
"053260","금강철강","76702021400","4825","15896792","18720000","2823208","2024-09"
"008870","금비","45344900000","55400","818500","1000000","181500","2024-09"
"001570","금양","2696427882050","46550","57925411","58050037","124626","2024-09"
"282720","금양그린파워","130081182000","10780","12066900","12119500","52600","2024-09"
"002990","금호건설","108583476100","3025","35895364","36953595","1058231","2024-09"
"011780","금호석유","3136438859800","136600","22960753","27334587","4373834","2024-09"
"214330","금호에이치티","129990702754","638","203747183","213914131","10166948","2024-09"
"001210","금호전기","36160651716","868","41659737","42525621","865884","2024-09"
"073240","금호타이어","1197875396790","4170","287260287","287260287","0","2024-09"
"036190","금화피에스시","163295093500","27650","5905790","6000000","94210","2024-09"
"049080","기가레인","59076478608","696","84879998","84883347","3349","2024-09"
"420770","기가비스","502593804700","39650","12675758","12675758","0","2024-09"
"035460","기산텔레콤","27201316440","1866","14577340","14577340","0","2024-09"
"092440","기신정기","74314000000","2545","29200000","29200000","0","2024-09"
"000270","기아","37224348655000","95000","391835249","399858417","8023168","2024-09"
"024110","기업은행","11546726554160","14480","797425867","797425869","2","2024-09"
"013700","까뮤이앤씨","79767358050","1335","59750830","59750830","0","2024-09"
"308100","까스텔바작","20962054750","3250","6449863","6624733","174870","2024-09"
"004540","깨끗한나라","78388614935","2105","37239247","37240693","1446","2024-09"
"407400","꿈비","73598460000","6240","11794625","12259474","464849","2024-09"
"187790","나노","31435070025","1025","30668361","30840830","172469","2024-09"
"286750","나노브릭","42525500070","2055","20693674","20694559","885","2024-09"
"121600","나노신소재","1038524849600","86800","11964572","12196078","231506","2024-09"
"247660","나노씨엠에스","35664536700","8350","4271202","4343920","72718","2024-09"
"039860","나노엔텍","157018300980","4890","32110082","32110082","0","2024-09"
"091970","나노캠텍","23960595243","663","36139661","37417493","1277832","2024-09"
"417010","나노팀","208683390240","10580","19724328","19724328","0","2024-09"
"405920","나라셀라","47740389120","3840","12432393","12878076","445683","2024-09"
"051490","나라엠앤디","67357510500","5100","13207355","14200000","992645","2024-09"
"137080","나래나노텍","39371542320","3560","11059422","11059422","0","2024-09"
"190510","나무가","196303415760","12420","15805428","16264384","458956","2024-09"
"242040","나무기술","59613657292","1799","33137108","34606264","1469156","2024-09"
"089600","나스미디어","183046876110","16190","11306169","11568163","261994","2024-09"
"293580","나우IB","88761963150","937","94729950","94929950","200000","2024-09"
"138610","나이벡","226420106000","22000","10291823","10291823","0","2024-09"
"130580","나이스디앤비","78540000000","5100","15400000","15400000","0","2024-09"
"036800","나이스정보통신","164718441000","18780","8770950","10000000","1229050","2024-09"
"267320","나인테크","100910266125","2325","43402265","43664104","261839","2024-09"
"001260","남광토건","61201738220","6230","9823714","9832572","8858","2024-09"
"008350","남선알미늄","178000065110","1379","129079090","129079090","0","2024-09"
"004270","남성","42285357450","1350","31322487","36212160","4889673","2024-09"
"003920","남양유업","381127860000","580000","657117","679731","22614","2024-09"
"025860","남해화학","315502413100","6580","47948695","49678843","1730148","2024-09"
"111710","남화산업","101087080000","4910","20588000","20588000","0","2024-09"
"091590","남화토건","47018700000","4005","11740000","11740000","0","2024-09"
"168330","내츄럴엔도텍","50864652351","1611","31573341","31754900","181559","2024-09"
"094860","네오리진","30878602856","1444","21384074","21399569","15495","2024-09"
"253590","네오셈","445390169760","10480","42499062","43869164","1370102","2024-09"
"212560","네오오토","68351154760","8680","7874557","7874963","406","2024-09"
"095660","네오위즈","408134561500","20500","19909003","22033719","2124716","2024-09"
"042420","네오위즈홀딩스","128219223080","19720","6501989","8856866","2354877","2024-09"
"311390","네오크레마","76776763050","7050","10890321","10979147","88826","2024-09"
"085910","네오티스","47088004480","3520","13377274","13934818","557544","2024-09"
"092730","네오팜","199426014000","25500","7820628","8207361","386733","2024-09"
"290660","네오펙트","39433224168","936","42129513","42129513","0","2024-09"
"306620","네온테크","86883957000","2125","40886568","42608149","1721581","2024-09"
"153460","네이블","40334716800","6300","6402336","6530014","127678","2024-09"
"007390","네이처셀","601739408600","9350","64357156","64357156","0","2024-09"
"033640","네패스","182825467440","8040","22739486","23059202","319716","2024-09"
"330860","네패스아크","159610989500","13100","12184045","12184045","0","2024-09"
"005720","넥센","222124955850","4585","48446010","53543977","5097967","2024-09"
"002350","넥센타이어","691415032940","7190","96163426","97667877","1504451","2024-09"
"089140","넥스턴바이오","49615029200","4400","11276143","11282627","6484","2024-09"
"389650","넥스트바이오메디컬","323871774300","40050","8086686","8086686","0","2024-09"
"137940","넥스트아이","33380936952","436","76561782","78320992","1759210","2024-09"
"396270","넥스트칩","224302856000","12400","18088940","18088940","0","2024-09"
"348210","넥스틴","660510401400","63900","10336626","10437250","100624","2024-09"
"092790","넥스틸","247019000000","9500","26002000","26002000","0","2024-09"
"225570","넥슨게임즈","964656546360","15080","63969267","65860174","1890907","2024-09"
"217270","넵튠","241834482890","5390","44867251","46676150","1808899","2024-09"
"251270","넷마블","4875106974500","59500","81934571","85953502","4018931","2024-09"
"104620","노랑풍선","75883783540","4790","15842126","15842126","0","2024-09"
"090350","노루페인트","175600000000","8780","20000000","20000000","0","2024-09"
"000320","노루홀딩스","139074764010","13570","10248693","13291151","3042458","2024-09"
"194700","노바렉스","190652866320","10770","17702216","18754848","1052632","2024-09"
"285490","노바텍","119321494260","12020","9926913","10575831","648918","2024-09"
"145170","노브랜드","111202478640","13410","8292504","9079834","787330","2024-09"
"106520","노블엠앤비","15902299386","411","38691726","38695952","4226","2024-09"
"376930","노을","118230592000","3200","36947060","36947060","0","2024-09"
"006280","녹십자","1993882196600","174700","11413178","11686538","273360","2024-09"
"142280","녹십자엠에스","91169089200","4200","21706926","21741926","35000","2024-09"
"234690","녹십자웰빙","206731183900","11650","17745166","17752276","7110","2024-09"
"005250","녹십자홀딩스","741414135000","16500","44934190","47028210","2094020","2024-09"
"004370","농심","2156918379000","373000","5782623","6082642","300019","2024-09"
"072710","농심홀딩스","308876814000","66600","4637790","4637790","0","2024-09"
"054050","농우바이오","118786457010","7410","16030561","16030561","0","2024-09"
"069140","누리플랜","18397001973","1407","13075339","13102743","27404","2024-09"
"040160","누리플렉스","29939660250","2650","11297985","12055535","757550","2024-09"
"332290","누보","38203158951","1161","32905391","33384803","479412","2024-09"
"348340","뉴로메카","236301408000","22400","10549170","10549170","0","2024-09"
"060260","뉴보텍","14850042228","1113","13342356","13512009","169653","2024-09"
"123840","뉴온","65240248057","251","259921307","292370108","32448801","2024-09"
"012340","뉴인텍","27335229441","537","50903593","50907162","3569","2024-09"
"214870","뉴지랩파마","64715071880","6920","9351889","9359221","7332","2024-09"
"270870","뉴트리","78794850960","8760","8994846","9200224","205378","2024-09"
"144960","뉴파워프라즈마","198889323445","4915","40465783","43692624","3226841","2024-09"
"085670","뉴프렉스","143523167080","5870","24450284","24450761","477","2024-09"
"064260","다날","214405513950","3210","66792995","68949040","2156045","2024-09"
"340360","다보링크","116497349220","2685","43388212","43388212","0","2024-09"
"039560","다산네트웍스","130749445840","3380","38683268","39505981","822713","2024-09"
"154040","다산솔루에타","28899651340","1610","17950094","17950094","0","2024-09"
"058730","다스코","58725405200","3230","18181240","18796941","615701","2024-09"
"030210","다올투자증권","175053937005","2955","59239911","60911106","1671195","2024-09"
"023590","다우기술","789660536700","18300","43150849","44866617","1715768","2024-09"
"032190","다우데이타","424747000000","11090","38300000","38300000","0","2024-09"
"323350","다원넥스뷰","50408489600","6640","7591640","7596111","4471","2024-09"
"068240","다원시스","407203872790","10670","38163437","38163437","0","2024-09"
"145210","다이나믹디자인","88303835340","2555","34561188","34581687","20499","2024-09"
"019680","대교","146558194650","2175","67383078","84702850","17319772","2024-09"
"006370","대구백화점","62994595270","7570","8321611","10821611","2500000","2024-09"
"008060","대덕","208085521000","6140","33890150","33890150","0","2024-09"
"353200","대덕전자","850959448500","17220","49416925","49416925","0","2024-09"
"000490","대동","197976970800","8400","23568687","25640788","2072101","2024-09"
"020400","대동금속","20665795680","6480","3189166","3189166","0","2024-09"
"008830","대동기어","65698771200","7310","8987520","8987520","0","2024-09"
"048470","대동스틸","35926057140","3820","9404727","10000000","595273","2024-09"
"008110","대동전자","105136322880","15040","6990447","10490447","3500000","2024-09"
"004780","대륙제관","66077791845","4155","15903199","15903199","0","2024-09"
"005750","대림B&Co","58519562400","3510","16672240","16672240","0","2024-09"
"017650","대림제지","58345000000","7000","8335000","9000000","665000","2024-09"
"006570","대림통상","40071495520","2660","15064472","15225000","160528","2024-09"
"007720","대명소노시즌","90418003650","897","100800450","100800450","0","2024-09"
"389260","대명에너지","221650000000","13000","17050000","17050000","0","2024-09"
"317850","대모","79831187800","9590","8324420","8324420","0","2024-09"
"290670","대보마그네틱","126193162080","16890","7471472","7857660","386188","2024-09"
"078140","대봉엘에스","217321154650","19850","10948169","11086579","138410","2024-09"
"065150","대산F&B","18113400725","145","124920005","125282405","362400","2024-09"
"001680","대상","694692901250","20050","34648025","34648025","0","2024-09"
"084690","대상홀딩스","303461068440","8380","36212538","36212538","0","2024-09"
"036480","대성미생물","39216000000","10320","3800000","3800000","0","2024-09"
"128820","대성산업","130550239790","3485","37460614","45235478","7774864","2024-09"
"117580","대성에너지","254269005100","9350","27194546","27500000","305454","2024-09"
"027830","대성창투","81486000000","1509","54000000","54000000","0","2024-09"
"104040","대성파인텍","45613018781","979","46591439","47224987","633548","2024-09"
"129920","대성하이텍","58288975250","4250","13715053","13715053","0","2024-09"
"016710","대성홀딩스","126775914320","7880","16088314","16089459","1145","2024-09"
"438220","대신밸런스제13호스팩","14382000000","2550","5640000","5640000","0","2024-09"
"442310","대신밸런스제14호스팩","15198150000","2265","6710000","6710000","0","2024-09"
"457390","대신밸런스제15호스팩","16778475000","2385","7035000","7035000","0","2024-09"
"457630","대신밸런스제16호스팩","15679950000","2145","7310000","7310000","0","2024-09"
"471050","대신밸런스제17호스팩","12998700000","2145","6060000","6060000","0","2024-09"
"478780","대신밸런스제18호스팩","16334150000","2065","7910000","7910000","0","2024-09"
"020180","대신정보통신","34470736755","897","38428915","38428915","0","2024-09"
"003540","대신증권","637331853660","16980","37534267","50773400","13239133","2024-09"
"045390","대아티아이","179354744465","2545","70473377","70473377","0","2024-09"
"009190","대양금속","72173470392","1704","42355323","42359986","4663","2024-09"
"108380","대양전기공업","111294292480","12040","9243712","9567333","323621","2024-09"
"014160","대영포장","99926788557","1049","95259093","108394549","13135456","2024-09"
"047040","대우건설","1559311307400","3795","410885720","415622638","4736918","2024-09"
"009320","대우부품","55955238950","1135","49299770","49299770","0","2024-09"
"003090","대웅","1075425673000","26300","40890710","58141980","17251270","2024-09"
"069620","대웅제약","1821442541000","158300","11506270","11586575","80305","2024-09"
"007680","대원","56878585020","4230","13446474","13446474","0","2024-09"
"000430","대원강업","243350000000","3925","62000000","62000000","0","2024-09"
"048910","대원미디어","98971350660","8190","12084414","12578946","494532","2024-09"
"005710","대원산업","117420336000","5860","20037600","20037600","0","2024-09"
"006340","대원전선","219688982750","2930","74979175","74979175","0","2024-09"
"003220","대원제약","325573938410","15190","21433439","22427583","994144","2024-09"
"024890","대원화성","46792011616","1148","40759592","41249152","489560","2024-09"
"290380","대유","56838037000","2300","24712190","24713612","1422","2024-09"
"002880","대유에이텍","49676277576","1063","46732152","46744020","11868","2024-09"
"000300","대유플러스","30475633069","241","126454909","126454909","0","2024-09"
"120240","대정화금","100711601640","14040","7173191","7190391","17200","2024-09"
"003310","대주산업","50080175250","1415","35392350","35392350","0","2024-09"
"078600","대주전자재료","1516929006000","101300","14974620","15480593","505973","2024-09"
"012800","대창","98758243044","1294","76320126","91140499","14820373","2024-09"
"015230","대창단조","127330397000","5050","25213940","28572230","3358290","2024-09"
"096350","대창솔루션","57295900440","360","159155279","163761009","4605730","2024-09"
"140520","대창스틸","47598170180","2255","21107836","21109243","1407","2024-09"
"131220","대한과학","36516745300","4900","7452397","7454490","2093","2024-09"
"010170","대한광통신","77715146138","1043","74511166","74511166","0","2024-09"
"054670","대한뉴팜","114106899570","8130","14035289","14354920","319631","2024-09"
"001070","대한방직","21421027950","5930","3612315","5300000","1687685","2024-09"
"023910","대한약품","150234000000","25550","5880000","6000000","120000","2024-09"
"006650","대한유화","642314400000","104000","6176100","6500000","323900","2024-09"
"001440","대한전선","2282954685260","12290","185757094","186447300","690206","2024-09"
"084010","대한제강","240237988290","13770","17446477","23414397","5967920","2024-09"
"001790","대한제당","262311118700","2965","88469180","89696580","1227400","2024-09"
"001130","대한제분","226214587500","137500","1645197","1690000","44803","2024-09"
"003490","대한항공","8690006466800","23600","368220613","368220661","48","2024-09"
"005880","대한해운","587924881320","1842","319177460","319177460","0","2024-09"
"003830","대한화섬","135937271000","121300","1120670","1328000","207330","2024-09"
"016090","대현","95871201150","2165","44282310","44282310","0","2024-09"
"069460","대호에이엘","71454394140","1059","67473460","67544896","71436","2024-09"
"021040","대호특수강","28189441314","1539","18316726","21704774","3388048","2024-09"
"067080","대화제약","340173343000","19420","17516650","18616650","1100000","2024-09"
"298540","더네이쳐홀딩스","147202140960","10080","14603387","14765856","162469","2024-09"
"032860","더라미","146652924600","3640","40289265","40395863","106598","2024-09"
"192080","더블유게임즈","1007138295600","50800","19825557","21495906","1670349","2024-09"
"393890","더블유씨피","571492945280","16960","33696518","33696518","0","2024-09"
"299170","더블유에스아이","46483263504","1548","30027948","30027963","15","2024-09"
"012510","더존비즈온","1341180616050","47850","28028853","30382784","2353931","2024-09"
"224060","더코디","21622734180","4580","4721121","4748398","27277","2024-09"
"043090","더테크놀로지","33634563452","452","74412751","74412751","0","2024-09"
"213420","덕산네오룩스","746712616000","30400","24562915","24831179","268264","2024-09"
"317330","덕산테코피아","799610605200","39050","20476584","20476584","0","2024-09"
"077360","덕산하이메탈","219233534650","4825","45437002","45437002","0","2024-09"
"004830","덕성","91760360250","6630","13840175","15680000","1839825","2024-09"
"090410","덕신이피씨","64978489350","1410","46084035","46084095","60","2024-09"
"024900","덕양산업","109443082500","3375","32427580","32564980","137400","2024-09"
"263600","덕우전자","96059769300","6030","15930310","15930310","0","2024-09"
"194480","데브시스터즈","390855164800","36200","10797104","12035480","1238376","2024-09"
"263800","데이타솔루션","73068306900","4505","16219380","16219380","0","2024-09"
"206560","덱스터","198977102030","7910","25155133","25411736","256603","2024-09"
"261200","덴티스","110305896500","7220","15277825","15809700","531875","2024-09"
"145720","덴티움","683012167200","79200","8623891","11068830","2444939","2024-09"
"067990","도이치모터스","140827130210","4745","29679058","30181550","502492","2024-09"
"002150","도화엔지니어링","221417236250","6650","33295825","33720000","424175","2024-09"
"006620","동구바이오제약","160531444160","5920","27116798","28464992","1348194","2024-09"
"100130","동국S&C","145186348415","2605","55733723","57143000","1409277","2024-09"
"005160","동국산업","345213553700","6700","51524411","54244482","2720071","2024-09"
"460850","동국씨엠","196104093120","6570","29848416","29898656","50240","2024-09"
"075970","동국알앤에스","46828000000","2545","18400000","18400000","0","2024-09"
"460860","동국제강","438517871700","8850","49550042","49608017","57975","2024-09"
"086450","동국제약","799344057600","18180","43968320","44460000","491680","2024-09"
"001230","동국홀딩스","249434374860","8020","31101543","31800483","698940","2024-09"
"023450","동남합성","113508225000","32750","3465900","3500000","34100","2024-09"
"004140","동방","116619326640","2440","47794806","47971766","176960","2024-09"
"099410","동방선기","40583020050","2910","13946055","14000000","53945","2024-09"
"007590","동방아그로","77287454930","6230","12405691","13617577","1211886","2024-09"
"005960","동부건설","95783075450","4175","22942054","22946345","4291","2024-09"
"026960","동서","1921154022810","19470","98672523","99700000","1027477","2024-09"
"002210","동성제약","104154575340","4555","22865988","26100970","3234982","2024-09"
"102260","동성케미컬","211385506920","4340","48706338","49689728","983390","2024-09"
"033500","동성화인텍","326913032540","11260","29033129","29989494","956365","2024-09"
"025950","동신건설","173040000000","20600","8400000","8400000","0","2024-09"
"000640","동아쏘시오홀딩스","765713567500","122500","6250723","6348913","98190","2024-09"
"170900","동아에스티","710146985800","79100","8977838","9167274","189436","2024-09"
"088130","동아엘텍","84191786910","9630","8742657","8742657","0","2024-09"
"028100","동아지질","165878481600","12520","13249080","14052646","803566","2024-09"
"041930","동아화성","103930834000","7000","14847262","15800000","952738","2024-09"
"001520","동양","148996189455","785","189804063","238684063","48880000","2024-09"
"084670","동양고속","22124320000","8480","2609000","2895569","286569","2024-09"
"082640","동양생명","856139493870","5490","155945263","161358585","5413322","2024-09"
"060380","동양에스텍","28834200000","1494","19300000","19700000","400000","2024-09"
"079960","동양이엔피","151710556350","19650","7720639","7860000","139361","2024-09"
"008970","동양철관","126415251095","805","157037579","157052160","14581","2024-09"
"228340","동양파일","40300000000","2015","20000000","20000000","0","2024-09"
"092780","동양피스톤","74715917440","5920","12620932","13168460","547528","2024-09"
"088910","동우팜투테이블","51417806236","1999","25721764","25831764","110000","2024-09"
"094170","동운아나텍","361485766880","19180","18847016","19067208","220192","2024-09"
"049770","동원F&B","630001993000","32650","19295620","19295620","0","2024-09"
"013120","동원개발","231106614500","2545","90808100","90808100","0","2024-09"
"018500","동원금속","59646371180","1276","46744805","46754933","10128","2024-09"
"006040","동원산업","1221142240500","33900","36021895","36021895","0","2024-09"
"030720","동원수산","26759378750","5750","4653805","4653805","0","2024-09"
"014820","동원시스템즈","1414774561600","48800","28991282","28991282","0","2024-09"
"111380","동인기연","118655622510","19990","5935749","6128000","192251","2024-09"
"163560","동일고무벨트","102304000000","7360","13900000","13900000","0","2024-09"
"109860","동일금속","74525772250","8810","8459225","9100000","640775","2024-09"
"032960","동일기연","41760292600","11050","3779212","3986323","207111","2024-09"
"004890","동일산업","88159089700","40700","2166071","2425215","259144","2024-09"
"002690","동일제강","28535933440","1504","18973360","20300360","1327000","2024-09"
"023790","동일철강","26821375112","1288","20824049","20841335","17286","2024-09"
"005290","동진쎄미켐","1401044961500","27250","51414494","51414494","0","2024-09"
"025900","동화기업","533340969480","11660","45741078","50557285","4816207","2024-09"
"000020","동화약품","218140109100","7870","27717930","27931470","213540","2024-09"
"000150","두산","2799254583000","207000","13522969","16523835","3000866","2024-09"
"454910","두산로보틱스","4641110568000","71600","64819980","64819980","0","2024-09"
"241560","두산밥캣","4359015701950","43550","100092209","100249166","156957","2024-09"
"034020","두산에너빌리티","13225605719200","20650","640465168","640561146","95978","2024-09"
"131970","두산테스나","493155648150","29150","16917861","17006566","88705","2024-09"
"336260","두산퓨얼셀","1159698245090","17710","65482679","65493726","11047","2024-09"
"016740","두올","113857774890","3655","31151238","32066680","915442","2024-09"
"073190","듀오백","28488352850","2575","11063438","11968040","904602","2024-09"
"030350","드래곤플라이","16792131466","242","69388973","69388973","0","2024-09"
"203650","드림시큐리티","162578578665","3335","48749199","50605754","1856555","2024-09"
"223250","드림씨아이에스","117092674080","4920","23799324","23799324","0","2024-09"
"060570","드림어스컴퍼니","131354672301","1737","75621573","75621573","0","2024-09"
"362990","드림인사이트","38041244160","2320","16397088","16800574","403486","2024-09"
"192650","드림텍","596178615510","8830","67517397","68883113","1365716","2024-09"
"217620","디딤이앤에프","21715711458","381","56996618","57747210","750592","2024-09"
"016670","디모아","19988216100","4050","4935362","4941846","6484","2024-09"
"187870","디바이스이엔지","93634478980","13930","6721786","7036609","314823","2024-09"
"024090","디씨엠","107191133400","12350","8679444","11400000","2720556","2024-09"
"003160","디아이","477407711150","18350","26016769","28300000","2283231","2024-09"
"092200","디아이씨","147234325000","3800","38745875","38888569","142694","2024-09"
"110990","디아이티","254235322110","13790","18436209","18900000","463791","2024-09"
"263690","디알젬","81545762880","7440","10960452","11325610","365158","2024-09"
"214680","디알텍","221918221840","3010","73726984","73727108","124","2024-09"
"347850","디앤디파마텍","525882577100","49900","10538729","10538729","0","2024-09"
"263720","디앤씨미디어","224295519370","18070","12412591","12524473","111882","2024-09"
"376300","디어유","575656345500","24250","23738406","23738406","0","2024-09"
"109740","디에스케이","130804763700","5190","25203230","25710390","507160","2024-09"
"196490","디에이테크놀로지","36209568780","203","178372260","178549360","177100","2024-09"
"066900","디에이피","42329185665","2405","17600493","22744503","5144010","2024-09"
"127120","디엔에이링크","82965380670","3690","22483843","22483843","0","2024-09"
"092070","디엔에프","119768730300","10350","11571858","11571858","0","2024-09"
"039840","디오","238024242360","16470","14451988","14981755","529767","2024-09"
"013570","디와이","115945197700","4700","24669191","26319633","1650442","2024-09"
"219550","디와이디","41369916857","527","78500791","78500791","0","2024-09"
"310870","디와이씨","24885603261","1203","20686287","20687271","984","2024-09"
"210540","디와이파워","137837778990","12490","11035851","11041708","5857","2024-09"
"104460","디와이피엔에프","109999330360","11380","9666022","10713625","1047603","2024-09"
"079810","디이엔티","166298734990","7610","21852659","22028094","175435","2024-09"
"113810","디젠스","28908453186","886","32628051","32628051","0","2024-09"
"043360","디지아이","18727734900","2100","8917969","9000000","82031","2024-09"
"197140","디지캡","34576636650","2725","12688674","13013154","324480","2024-09"
"068930","디지털대성","193644604000","7390","26203600","27675342","1471742","2024-09"
"033130","디지틀조선","59681349336","1608","37115267","37115267","0","2024-09"
"105740","디케이락","76568902890","7530","10168513","10168513","0","2024-09"
"263020","디케이앤디","50219429625","3375","14879831","15069831","190000","2024-09"
"290550","디케이티","176610860900","8830","20001230","20001230","0","2024-09"
"066670","디티씨","52116144880","3320","15697634","18691918","2994284","2024-09"
"187220","디티앤씨","36245914285","3145","11524933","11698021","173088","2024-09"
"383930","디티앤씨알오","91947686400","7200","12770512","12770512","0","2024-09"
"131180","딜리","28203663915","1015","27786861","29350000","1563139","2024-09"
"315640","딥노이드","143496115200","6400","22421268","22421268","0","2024-09"
"223310","딥마인드","53660153800","2350","22834108","22839375","5267","2024-09"
"317120","라닉스","34635272550","3595","9634290","9660000","25710","2024-09"
"462510","라메디텍","94725548250","10950","8650735","8650735","0","2024-09"
"042510","라온시큐어","106765616500","1975","54058540","56025871","1967331","2024-09"
"232680","라온테크","77207693640","6330","12197108","12534234","337126","2024-09"
"418420","라온텍","108114494400","3600","30031804","30108433","76629","2024-09"
"300120","라온피플","100128057600","4800","20860012","20860012","0","2024-09"
"171120","라이온켐텍","87709814500","2485","35295700","35901760","606060","2024-09"
"388790","라이콤","91532120610","3070","29815023","29913930","98907","2024-09"
"347700","라이프시맨틱스","73179566220","3660","19994417","19994417","0","2024-09"
"214260","라파스","166372997350","19810","8398435","8912435","514000","2024-09"
"115390","락앤락","375533004240","8670","43314072","43326411","12339","2024-09"
"200350","래몽래인","143342998500","14340","9996025","9996025","0","2024-09"
"171010","램테크놀러지","55407664000","3875","14298752","14298752","0","2024-09"
"084650","랩지노믹스","272460763300","3670","74239990","74239990","0","2024-09"
"217500","러셀","53664566900","1850","29007874","31812000","2804126","2024-09"
"038390","레드캡투어","131007640370","15670","8360411","8589480","229069","2024-09"
"294140","레몬","93844445010","4470","20994283","21000000","5717","2024-09"
"443250","레뷰코퍼레이션","86098322400","7990","10775760","11279386","503626","2024-09"
"228670","레이","140696906320","9080","15495254","15495254","0","2024-09"
"228850","레이언스","110627173200","7030","15736440","16591014","854574","2024-09"
"412350","레이저쎌","48434694600","5550","8726972","8726972","0","2024-09"
"199550","레이저옵텍","82753077300","7100","11655363","11656947","1584","2024-09"
"281740","레이크머티리얼즈","992530701000","15100","65730510","65730548","38","2024-09"
"277810","레인보우로보틱스","2587941057200","133400","19399858","19399858","0","2024-09"
"215100","로보로보","68336949375","3375","20247985","20348454","100469","2024-09"
"090360","로보스타","213525000000","21900","9750000","9750000","0","2024-09"
"108490","로보티즈","241281203820","18710","12895842","13051842","156000","2024-09"
"067730","로지시스","25152197200","2600","9673922","9673922","0","2024-09"
"071280","로체시스템즈","273113223390","18310","14916069","15296603","380534","2024-09"
"032350","롯데관광개발","736817089610","9670","76196183","76196183","0","2024-09"
"089860","롯데렌탈","1069743655350","29450","36324063","36634063","310000","2024-09"
"000400","롯데손해보험","706316418550","2285","309110030","310336320","1226290","2024-09"
"023530","롯데쇼핑","1814975088000","64200","28270640","28288755","18115","2024-09"
"020150","롯데에너지머티리얼즈","1726850770750","37450","46110835","46110835","0","2024-09"
"280360","롯데웰푸드","1159974230400","131200","8841267","9434574","593307","2024-09"
"286940","롯데이노베이트","356296592850","23550","15129367","15129367","0","2024-09"
"004000","롯데정밀화학","1184355000000","46500","25470000","25800000","330000","2024-09"
"004990","롯데지주","1692246670000","23900","70805300","104909237","34103937","2024-09"
"005300","롯데칠성","1119961298800","120700","9278884","9278884","0","2024-09"
"011170","롯데케미칼","3887810953400","92200","42167147","42775419","608272","2024-09"
"071840","롯데하이마트","186011124480","8040","23135712","23607712","472000","2024-09"
"328130","루닛","1163588025600","40300","28873152","28873152","0","2024-09"
"038060","루멘스","58926259525","1225","48103069","48103069","0","2024-09"
"474170","루미르","255776517360","14910","17154696","17154696",,"자료 없음"
"141080","리가켐바이오","4761054383600","130700","36427348","36567348","140000","2024-09"
"058470","리노공업","2830905880000","186500","15179120","15242370","63250","2024-09"
"016100","리더스코스메틱","51431994735","2805","18335827","19100894","765067","2024-09"
"012700","리드코프","112873297320","4410","25594852","26446135","851283","2024-09"
"302550","리메드","105854566400","3455","30638080","30638080","0","2024-09"
"073570","리튬포어스","63902934282","1766","36185127","36189497","4370","2024-09"
"377450","리파인","221386838400","14560","15205140","17330000","2124860","2024-09"
"277070","린드먼아시아","54098551500","4270","12669450","13692000","1022550","2024-09"
"042500","링네트","75034462560","4660","16101816","19070134","2968318","2024-09"
"193250","링크드","29255400174","462","63323377","63323377","0","2024-09"
"219420","링크제니시스","51209144350","4550","11254757","11469507","214750","2024-09"
"439090","마녀공장","330021939000","20150","16378260","16378260","0","2024-09"
"027740","마니커","60262655882","949","63501218","63511228","10010","2024-09"
"195500","마니커에프앤지","47374770000","2965","15978000","15978000","0","2024-09"
"377480","마음AI","66884717120","10720","6239246","6239246","0","2024-09"
"305090","마이크로디지탈","246730398800","14920","16536890","16536890","0","2024-09"
"098120","마이크로컨텍솔","45138319380","5430","8312766","8312766","0","2024-09"
"424980","마이크로투나노","49067598100","8290","5918890","5918890","0","2024-09"
"038290","마크로젠","183514858230","18390","9979057","10841400","862343","2024-09"
"001080","만호제강","95188738400","32200","2956172","4150000","1193828","2024-09"
"267980","매일유업","273512626800","37900","7216692","7843638","626946","2024-09"
"005990","매일홀딩스","104830742750","8390","12494725","13718304","1223579","2024-09"
"093520","매커스","87838718900","8950","9814382","16163092","6348710","2024-09"
"377030","맥스트","51471419660","2630","19570882","19570882","0","2024-09"
"100590","머큐리","56750632455","3585","15830023","15830023","0","2024-09"
"067280","멀티캠퍼스","183433810050","30950","5926779","5926779","0","2024-09"
"072870","메가스터디","128328772500","11250","11407002","11920959","513957","2024-09"
"215200","메가스터디교육","472854841650","43950","10758927","11461955","703028","2024-09"
"133750","메가엠디","45584844025","2065","22074985","23407077","1332092","2024-09"
"446540","메가터치","87861330000","4230","20771000","20771000","0","2024-09"
"235980","메드팩토","216259675800","6440","33580695","33580695","0","2024-09"
"041920","메디아나","88530484500","4770","18559850","18598223","38373","2024-09"
"014100","메디앙스","25596114945","2265","11300713","11800000","499287","2024-09"
"054180","메디콕스","20369444888","346","58871228","58878283","7055","2024-09"
"086900","메디톡스","1172591763200","174200","6731296","7298497","567201","2024-09"
"078160","메디포스트","216527284750","6350","34098785","34217785","119000","2024-09"
"138040","메리츠금융지주","19592667123900","105900","185011021","190720114","5709093","2024-09"
"408920","메쎄이상","95760257550","2225","43038318","43232455","194137","2024-09"
"021880","메이슨캐피탈","47938088520","315","152184408","152184408","0","2024-09"
"140410","메지온","922734674400","30800","29958918","29958918","0","2024-09"
"241770","메카로","75823055000","7700","9847150","10192640","345490","2024-09"
"090370","메타랩스","40340638980","1620","24901629","24904689","3060","2024-09"
"059210","메타바이오메드","92856698480","4060","22871108","23862351","991243","2024-09"
"118000","메타케어","58000873920","352","164775210","164777364","2154","2024-09"
"058110","멕아이씨에스","40758503900","2630","15497530","16050530","553000","2024-09"
"017180","명문제약","81063702675","2425","33428331","33953454","525123","2024-09"
"009900","명신산업","635413310630","12110","52470133","52470133","0","2024-09"
"012690","모나리자","113704010250","3110","36560775","36571255","10480","2024-09"
"005360","모나미","43085859960","2280","18897307","18897307","0","2024-09"
"070960","모나용평","187325752680","3960","47304483","48133333","828850","2024-09"
"434480","모니터랩","45351376500","3855","11764300","12253300","489000","2024-09"
"080420","모다이노칩","153543843972","1926","79721622","79721622","0","2024-09"
"417970","모델솔루션","61728155000","9650","6396700","6396700","0","2024-09"
"080160","모두투어","175546610460","10140","17312289","18900000","1587711","2024-09"
"087260","모바일어플라이언스","72592880030","2230","32552861","32552861","0","2024-09"
"101330","모베이스","74764903670","3230","23147029","23147029","0","2024-09"
"012860","모베이스전자","131114979776","1804","72680144","73233457","553313","2024-09"
"363260","모비데이즈","57425037400","1810","31726540","32163769","437229","2024-09"
"348030","모비릭스","50708064000","5280","9603800","9603800","0","2024-09"
"250060","모비스","114868372395","3585","32041387","32171314","129927","2024-09"
"288980","모아데이타","54599367960","1580","34556562","34556562","0","2024-09"
"142760","모아라이프플러스","48149618836","1276","37734811","37734811","0","2024-09"
"033200","모아텍","30282900410","3290","9204529","14331185","5126656","2024-09"
"333050","모코엠시스","29857546176","1299","22985024","24444326","1459302","2024-09"
"009680","모토닉","187295223840","8660","21627624","33000000","11372376","2024-09"
"118990","모트렉스","252165373740","10170","24795022","24861990","66968","2024-09"
"006920","모헨즈","28119000000","2575","10920000","10920000","0","2024-09"
"009580","무림P&P","176489491740","2830","62363778","62368324","4546","2024-09"
"001810","무림SP","35840612500","1619","22137500","22137500","0","2024-09"
"009200","무림페이퍼","85507132050","2055","41609310","41609310","0","2024-09"
"033920","무학","147002117400","5550","26486868","28500000","2013132","2024-09"
"008420","문배철강","44808905700","2340","19149105","20503505","1354400","2024-09"
"279600","미디어젠","52938025300","11300","4684781","4684781","0","2024-09"
"095500","미래나노텍","297910021500","10500","28372383","31009999","2637616","2024-09"
"254490","미래반도체","241692120000","16740","14438000","14438000","0","2024-09"
"025560","미래산업","32920967905","1057","31145665","31166865","21200","2024-09"
"218150","미래생명자원","94943421030","4870","19495569","20415802","920233","2024-09"
"007120","미래아이앤지","28033514964","1026","27323114","28878608","1555494","2024-09"
"442900","미래에셋드림스팩1호","76800000000","10000","7680000","7680000","0","2024-09"
"100790","미래에셋벤처투자","262150052430","4935","53120578","53124634","4056","2024-09"
"412930","미래에셋비전스팩1호","16644320000","2695","6176000","6176000","0","2024-09"
"446190","미래에셋비전스팩2호","10865250000","2195","4950000","4950000","0","2024-09"
"448830","미래에셋비전스팩3호","10701000000","2175","4920000","4920000","0","2024-09"
"477380","미래에셋비전스팩4호","16362000000","2020","8100000","8100000","0","2024-09"
"477470","미래에셋비전스팩5호","11398400000","2080","5480000","5480000","0","2024-09"
"478440","미래에셋비전스팩6호","14033250000","2025","6930000","6930000","0","2024-09"
"482680","미래에셋비전스팩7호","16323205000","1987","8215000","8215000","0","2024-09"
"085620","미래에셋생명","685020000000","5250","130480000","177016189","46536189","2024-09"
"006800","미래에셋증권","3997455656900","8900","449152321","595316408","146164087","2024-09"
"049950","미래컴퍼니","149416956650","18850","7926629","8817884","891255","2024-09"
"207760","미스터블루","121021677335","1469","82383715","83079783","696068","2024-09"
"002840","미원상사","933483195000","201000","4644195","4750000","105805","2024-09"
"268280","미원에스씨","722211821100","147900","4883109","5000000","116891","2024-09"
"107590","미원홀딩스","185236000000","80000","2315450","2320000","4550","2024-09"
"134380","미원화학","160203360000","80000","2002542","2199268","196726","2024-09"
"003650","미창석유","146607665100","96900","1512979","1739672","226693","2024-09"
"059090","미코","341732652450","10850","31496097","33416778","1920681","2024-09"
"214610","미코바이오메드","87990357660","2020","43559583","43568945","9362","2024-09"
"201490","미투온","69468133540","2270","30602702","31257770","655068","2024-09"
"452200","민테크","158225613000","7210","21945300","21945300","0","2024-09"
"418470","밀리의서재","122984711830","14470","8499289","8499289","0","2024-09"
"206640","바디텍메드","301516153120","13720","21976396","23486560","1510164","2024-09"
"018700","바른손","40727812944","1183","34427568","35119757","692189","2024-09"
"035620","바른손이앤에이","36613744883","493","74267231","74439675","172444","2024-09"
"053030","바이넥스","722087915600","23350","30924536","31761048","836512","2024-09"
"301300","바이브컴퍼니","54314506750","4390","12372325","12394861","22536","2024-09"
"377740","바이오노트","469393772900","4615","101710460","102056048","345588","2024-09"
"064550","바이오니아","674939109650","26150","25810291","25810291","0","2024-09"
"314930","바이오다인","620485798000","21050","29476760","29764103","287343","2024-09"
"208710","바이오로그디바이스","30446106768","462","65900664","65900664","0","2024-09"
"086820","바이오솔루션","131266390480","16360","8023618","8143426","119808","2024-09"
"038460","바이오스마트","86758099800","3765","23043320","23933216","889896","2024-09"
"251120","바이오에프디엔씨","148489002090","17410","8528949","8695700","166751","2024-09"
"199730","바이오인프라","46746566870","9610","4864367","4864367","0","2024-09"
"086040","바이오톡스텍","75459787200","4800","15720789","15958247","237458","2024-09"
"099430","바이오플러스","325425427060","5780","56301977","57930864","1628887","2024-09"
"032980","바이온","30710168860","686","44767010","44777990","10980","2024-09"
"308080","바이젠셀","68386277000","3550","19263740","19263740","0","2024-09"
"043150","바텍","343876026400","23150","14854256","14854256","0","2024-09"
"323990","박셀바이오","310710293850","13530","22964545","22993200","28655","2024-09"
"003610","방림","114323295070","3230","35394209","42314090","6919881","2024-09"
"267790","배럴","37707030000","4780","7888500","7888500","0","2024-09"
"001340","백광산업","430453793250","9750","44149107","44918407","769300","2024-09"
"046310","백금T&A","38998954275","2425","16082043","16418641","336598","2024-09"
"035150","백산","301215000000","14010","21500000","21500000","0","2024-09"
"331520","밸로프","34684334048","707","49058464","50864390","1805926","2024-09"
"199480","뱅크웨어글로벌","82608160880","8260","10000988","10000988","0","2024-09"
"438700","버넥트","40734572950","3655","11144890","11144890","0","2024-09"
"066410","버킷스튜디오","96977294204","1153","84108668","84109926","1258","2024-09"
"002410","범양건영","26419068928","1064","24829952","24831982","2030","2024-09"
"382900","범한퓨얼셀","128823325000","15010","8582500","8761000","178500","2024-09"
"206400","베노티앤알","129353525700","3990","32419430","32420452","1022","2024-09"
"019010","베뉴지","88440000000","2200","40200000","48200000","8000000","2024-09"
"177350","베셀","23906447148","268","89203161","89372043","168882","2024-09"
"424760","벨로크","20227520628","1043","19393596","19665002","271406","2024-09"
"007210","벽산","111907788115","1999","55981885","67560000","11578115","2024-09"
"225530","보광산업","146262667775","4025","36338551","36338727","176","2024-09"
"250000","보라티알","65361075880","9980","6549206","6750733","201527","2024-09"
"002760","보락","80625400000","1346","59900000","59900000","0","2024-09"
"003850","보령","766018207300","11630","65865710","68690000","2824290","2024-09"
"310210","보로노이","2071549235900","117100","17690429","18093830","403401","2024-09"
"006910","보성파워텍","156330787680","3195","48929824","49129824","200000","2024-09"
"000890","보해양조","59385277784","427","139075592","139120129","44537","2024-09"
"226340","본느","72032236460","1717","41952380","41952420","40","2024-09"
"003000","부광약품","352541555650","5150","68454671","68454671","0","2024-09"
"001270","부국증권","170155845300","28650","5939122","10369886","4430764","2024-09"
"026940","부국철강","50900000000","2545","20000000","20000000","0","2024-09"
"014470","부방","92360013801","1721","53666481","60052260","6385779","2024-09"
"011390","부산산업","56390400000","53400","1056000","1056000","0","2024-09"
"005030","부산주공","38288532168","486","78782988","78782988","0","2024-09"
"008470","부스타","32812152660","4060","8081811","8404800","322989","2024-09"
"338220","뷰노","440256478900","31700","13888217","13888217","0","2024-09"
"100120","뷰웍스","235516017150","25650","9181911","10001865","819954","2024-09"
"406820","뷰티스킨","52657196000","14900","3534040","3534040","0","2024-09"
"337930","브랜드엑스코퍼레이션","275235426330","9390","29311547","29311547","0","2024-09"
"099390","브레인즈컴퍼니","48685566160","6160","7903501","8208283","304782","2024-09"
"064480","브리지텍","60733978960","5240","11590454","11952500","362046","2024-09"
"288330","브릿지바이오테라퓨틱스","270935291250","5850","46313725","46313725","0","2024-09"
"365900","브이씨","25732256000","3520","7310300","7310300","0","2024-09"
"089970","브이엠","190340789760","8640","22030184","24075595","2045411","2024-09"
"251630","브이원텍","66774071875","4375","15262645","15942886","680241","2024-09"
"018290","브이티","1146408622100","32300","35492527","35798007","305480","2024-09"
"439580","블루엠텍","286516168650","25650","11170221","11170221","0","2024-09"
"033560","블루콤","59387059560","3480","17065247","17100000","34753","2024-09"
"369370","블리츠웨이스튜디오","78416004578","1646","47640343","49871911","2231568","2024-09"
"126340","비나텍","224052937300","37900","5911687","6085118","173431","2024-09"
"121800","비덴트","256296018720","3320","77197596","77201611","4015","2024-09"
"082800","비보존 제약","203851121760","4290","47517744","48242965","725221","2024-09"
"318410","비비씨","47330670360","8520","5555243","5555243","0","2024-09"
"002070","비비안","25444067460","854","29793990","29793990","0","2024-09"
"100220","비상교육","63340332550","5170","12251515","12996741","745226","2024-09"
"419540","비스토스","45590072265","1983","22990455","22992511","2056","2024-09"
"146320","비씨엔씨","181545707200","14300","12695504","12792923","97419","2024-09"
"200780","비씨월드제약","42024053700","4980","8438565","8892384","453819","2024-09"
"413640","비아이매트릭스","54196188800","7520","7206940","7206940","0","2024-09"
"141000","비아트론","73802869110","6690","11031819","12114710","1082891","2024-09"
"090460","비에이치","553268379930","17630","31382211","34464379","3082168","2024-09"
"083650","비에이치아이","325820671020","10530","30942134","30944375","2241","2024-09"
"445360","비엔케이제1호스팩","9029450000","2095","4310000","4310000","0","2024-09"
"473370","비엔케이제2호스팩","8504200000","2020","4210000","4210000","0","2024-09"
"065170","비엘팜텍","23487750528","264","88968752","88970559","1807","2024-09"
"086670","비엠티","81031545120","8880","9125174","9125174","0","2024-09"
"335890","비올","525460754000","9100","57742940","58419125","676185","2024-09"
"230980","비유테크놀러지","21370405721","229","93320549","93320557","8","2024-09"
"138580","비즈니스온","356042480800","15850","22463248","22556163","92915","2024-09"
"082920","비츠로셀","448043280000","20000","22402164","22872213","470049","2024-09"
"054220","비츠로시스","22122269550","450","49160599","49160599","0","2024-09"
"042370","비츠로테크","185758177250","7090","26200025","26200025","0","2024-09"
"050090","비케이홀딩스","15820509265","803","19701755","19784735","82980","2024-09"
"148780","비큐AI","34118611625","1085","31445725","31445725","0","2024-09"
"307870","비투엔","50325943569","1111","45297879","45297879","0","2024-09"
"357880","비트나인","21775648260","2085","10443956","10443956","0","2024-09"
"032850","비트컴퓨터","80924689120","5020","16120456","16623293","502837","2024-09"
"238200","비피도","36523700000","4465","8180000","8180000","0","2024-09"
"093190","빅솔론","67876577890","4510","15050239","19238905","4188666","2024-09"
"065450","빅텍","141831360000","4950","28652800","28652800","0","2024-09"
"210120","빅텐츠","83017704000","26400","3144610","3144610","0","2024-09"
"044480","빌리언스","26228104560","645","40663728","40663728","0","2024-09"
"005180","빙그레","554380922700","62700","8841801","9851241","1009440","2024-09"
"069540","빛과전자","59938439840","1412","42449320","42449320","0","2024-09"
"072950","빛샘전자","32523133440","4060","8010624","8052610","41986","2024-09"
"451250","삐아","113448338120","11960","9485647","9682187","196540","2024-09"
"143240","사람인","176414257500","16250","10856262","11709263","853001","2024-09"
"003960","사조대림","379110929400","45400","8350461","9164467","814006","2024-09"
"008040","사조동아원","147711611312","1048","140946194","141144600","198406","2024-09"
"007160","사조산업","310564600000","62200","4993000","5000000","7000","2024-09"
"014710","사조씨푸드","117086092400","6800","17218543","17218543","0","2024-09"
"006090","사조오양","84804624000","9000","9422736","9422739","3","2024-09"
"452430","사피엔반도체","100706328160","12440","8095364","8096454","1090","2024-09"
"419120","산돌","49166080320","6720","7316381","7774326","457945","2024-09"
"062040","산일전기","1344511779750","44250","30384447","30445200","60753","2024-09"
"122350","삼기","56828467296","1497","37961568","38339428","377860","2024-09"
"419050","삼기이브이","118682198000","2075","57196240","57196240","0","2024-09"
"014970","삼륭물산","59547680000","4000","14886920","15125000","238080","2024-09"
"018310","삼목에스폼","335721847200","23600","14225502","14700000","474498","2024-09"
"053700","삼보모터스","96140234700","4325","22228956","22877190","648234","2024-09"
"009620","삼보산업","20585885823","279","73784537","73785902","1365","2024-09"
"023600","삼보판지","144840714480","9240","15675402","16170000","494598","2024-09"
"001470","삼부토건","109346181936","489","223611824","223611824","0","2024-09"
"028050","삼성E&A","3939600000000","20100","196000000","196000000","0","2024-09"
"006400","삼성SDI","21887384995500","334500","65433139","68764530","3331391","2024-09"
"006660","삼성공조","86861464300","11050","7860766","8126314","265548","2024-09"
"028260","삼성물산","22135874806500","136500","162167581","177784107","15616526","2024-09"
"207940","삼성바이오로직스","77650834000000","1091000","71174000","71174000","0","2024-09"
"032830","삼성생명","18280712502200","101800","179574779","200000000","20425221","2024-09"
"425290","삼성스팩6호","11619600000","2105","5520000","5520000","0","2024-09"
"439250","삼성스팩7호","36455820000","10410","3502000","3502000","0","2024-09"
"448740","삼성스팩8호","46873200000","10050","4664000","4664000","0","2024-09"
"468510","삼성스팩9호","22376250000","2025","11050000","11050000","0","2024-09"
"018260","삼성에스디에스","11478767602400","148400","77350186","77377800","27614","2024-09"
"009150","삼성전기","8941324608000","123000","72693696","74693696","2000000","2024-09"
"005930","삼성전자","352217170450000","59000","5969782550","5969782550","0","2024-09"
"001360","삼성제약","170169495168","1808","94120296","94162079","41783","2024-09"
"010140","삼성중공업","8540355710000","10000","854035571","880000000","25964429","2024-09"
"016360","삼성증권","4219425000000","47250","89300000","89300000","0","2024-09"
"068290","삼성출판사","146100000000","14610","10000000","10000000","0","2024-09"
"029780","삼성카드","4337789751750","40650","106710695","115858891","9148196","2024-09"
"000810","삼성화재","13900075304000","349000","39828296","47374837","7546541","2024-09"
"006110","삼아알미늄","741480566400","50400","14711916","14711916","0","2024-09"
"009300","삼아제약","133663189800","21900","6103342","6370000","266658","2024-09"
"145990","삼양사","489117310000","50600","9666350","10313449","647099","2024-09"
"003230","삼양식품","4109428528000","551000","7458128","7533015","74887","2024-09"
"002170","삼양통상","127234500000","46950","2710000","3000000","290000","2024-09"
"272550","삼양패키징","250623355360","16160","15508871","15788671","279800","2024-09"
"000070","삼양홀딩스","548743221000","73800","7435545","8564271","1128726","2024-09"
"003720","삼영","159352755725","4805","33163945","34000000","836055","2024-09"
"002810","삼영무역","223700639760","12690","17628104","18466948","838844","2024-09"
"361670","삼영에스앤씨","41389932360","7420","5578158","5667658","89500","2024-09"
"054540","삼영엠텍","50885350000","4195","12130000","13000000","870000","2024-09"
"065570","삼영이엔씨","25048621040","1840","13613381","13613381","0","2024-09"
"005680","삼영전자","194777076000","9750","19977136","20000000","22864","2024-09"
"023000","삼원강재","102926486040","2590","39739956","40000000","260044","2024-09"
"004380","삼익THK","190440000000","9200","20700000","21000000","300000","2024-09"
"002450","삼익악기","83025759180","1092","76030915","90530915","14500000","2024-09"
"032280","삼일","23669358720","1526","15510720","16213590","702870","2024-09"
"002290","삼일기업공사","35774000000","2885","12400000","12400000","0","2024-09"
"004440","삼일씨엔에스","54747372100","4300","12731947","12731947","0","2024-09"
"000520","삼일제약","367107643700","17350","21158942","21621100","462158","2024-09"
"009770","삼정펄프","66999222800","26800","2499971","2499971","0","2024-09"
"037460","삼지전자","133408115280","8690","15351912","16318522","966610","2024-09"
"032750","삼진","37814993020","4190","9025058","9031122","6064","2024-09"
"054090","삼진엘앤디","23795494080","960","24786973","24959232","172259","2024-09"
"005500","삼진제약","236015839200","18840","12527380","13900000","1372620","2024-09"
"000250","삼천당제약","3111849753600","133800","23257472","23457472","200000","2024-09"
"004690","삼천리","303711017500","88700","3424025","4055025","631000","2024-09"
"024950","삼천리자전거","49499912120","4090","12102668","13273577","1170909","2024-09"
"038500","삼표시멘트","326891565840","3045","107353552","107916306","562754","2024-09"
"437730","삼현","82439674200","7800","10569189","10569189","0","2024-09"
"017480","삼현철강","74280300900","4810","15442890","15702890","260000","2024-09"
"010960","삼호개발","70434000000","3150","22360000","25000000","2640000","2024-09"
"046390","삼화네트웍스","54672942066","1381","39589386","43172933","3583547","2024-09"
"004450","삼화왕관","58459935600","32400","1804319","2154379","350060","2024-09"
"009470","삼화전기","261245890000","39500","6613820","6613820","0","2024-09"
"011230","삼화전자","50787228540","3005","16900908","16902700","1792","2024-09"
"001820","삼화콘덴서","354517550000","34550","10261000","10395000","134000","2024-09"
"000390","삼화페인트","171740077600","7280","23590670","27203469","3612799","2024-09"
"027580","상보","71767277582","1274","56332243","59181279","2849036","2024-09"
"038540","상상인","88106084360","1610","54724276","55328313","604037","2024-09"
"415580","상상인제3호스팩","11151000000","2100","5310000","5310000","0","2024-09"
"452670","상상인제4호스팩","10492200000","2010","5220000","5220000","0","2024-09"
"001290","상상인증권","50262796793","473","106263841","108337120","2073279","2024-09"
"041650","상신브레이크","66502664850","3435","19360310","21471450","2111140","2024-09"
"091580","상신이디피","139813017310","10490","13328219","13428219","100000","2024-09"
"263810","상신전자","46995587100","3300","14241087","14244718","3631","2024-09"
"089980","상아프론테크","337535255950","21650","15590543","15989037","398494","2024-09"
"042940","상지건설","23436580940","5890","3979046","3981814","2768","2024-09"
"042600","새로닉스","164147655980","13420","12231569","12423574","192005","2024-09"
"075180","새론오토모티브","75456000000","3930","19200000","19200000","0","2024-09"
"107600","새빗켐","113293707750","22950","4936545","4936545","0","2024-09"
"411080","샌즈랩","113333890020","7790","14548638","15248638","700000","2024-09"
"252990","샘씨엔에스","319847833140","5610","57013874","58388063","1374189","2024-09"
"007540","샘표","90192193000","44750","2015468","2875800","860332","2024-09"
"248170","샘표식품","132431284000","29000","4566596","4568286","1690","2024-09"
"378800","샤페론","111227784390","3690","30143031","30143031","0","2024-09"
"294630","서남","91241841495","3805","23979459","23979459","0","2024-09"
"038070","서린바이오","64598084100","7650","8444194","8900676","456482","2024-09"
"006730","서부T&D","392128092160","6080","64494752","66426923","1932171","2024-09"
"079650","서산","24600000000","1230","20000000","20000000","0","2024-09"
"100660","서암기계공업","48510000000","3850","12600000","12600000","0","2024-09"
"007860","서연","154990022040","7140","21707286","23479844","1772558","2024-09"
"200880","서연이화","389668069420","14420","27022751","27028437","5686","2024-09"
"019770","서연탑메탈","43454500000","3730","11650000","11650000","0","2024-09"
"017390","서울가스","204623138400","52700","3882792","5000000","1117208","2024-09"
"043710","서울리거","32729319636","652","50198343","50198880","537","2024-09"
"092190","서울바이오시스","186339166360","4120","45227953","45868383","640430","2024-09"
"046890","서울반도체","523218835200","9280","56381340","58305400","1924060","2024-09"
"004410","서울식품","59960865440","160","374755409","374755559","150","2024-09"
"063170","서울옥션","121058159420","7190","16837018","17774267","937249","2024-09"
"027040","서울전자통신","18649629024","268","69588168","69588847","679","2024-09"
"018680","서울제약","48094690875","4125","11659319","11659319","0","2024-09"
"021050","서원","61716967000","1300","47474590","47474590","0","2024-09"
"093920","서원인텍","107508000000","5780","18600000","18600000","0","2024-09"
"189860","서전기전","47039083000","4850","9698780","9698780","0","2024-09"
"178320","서진시스템","1532756746500","27250","56247954","56247954","0","2024-09"
"122690","서진오토모티브","50934488080","2345","21720464","21844410","123946","2024-09"
"140070","서플러스글로벌","115238508030","3345","34450974","36988000","2537026","2024-09"
"011370","서한","78555892000","800","98194865","100894865","2700000","2024-09"
"065710","서호전기","106007513000","21500","4930582","5150000","219418","2024-09"
"008490","서흥","185355613710","16670","11119113","11569113","450000","2024-09"
"035890","서희건설","277784343240","1437","193308520","229808457","36499937","2024-09"
"357550","석경에이티","246114750000","45250","5439000","5455000","16000","2024-09"
"003100","선광","98249800000","15620","6290000","6600000","310000","2024-09"
"007610","선도전기","50907057000","3000","16969019","18000000","1030981","2024-09"
"067370","선바이오","85399011020","6940","12305333","12313555","8222","2024-09"
"171090","선익시스템","428576878950","48950","8755401","9494405","739004","2024-09"
"136490","선진","165027703520","6940","23779208","23779604","396","2024-09"
"086710","선진뷰티사이언스","125867524800","10480","12010260","12203280","193020","2024-09"
"014620","성광벤드","363577462220","13580","26773009","28600000","1826991","2024-09"
"037350","성도이엔지","68387445000","4815","14203000","15470000","1267000","2024-09"
"014910","성문전자","25469154339","1227","20757257","22460985","1703728","2024-09"
"003080","성보화학","51320615020","2620","19588021","20020000","431979","2024-09"
"004980","성신양회","196055738610","8130","24115097","24516073","400976","2024-09"
"011300","성안머티리얼스","38405417596","469","81887884","81887884","0","2024-09"
"081580","성우전자","71157991320","4680","15204699","15508143","303444","2024-09"
"045300","성우테크론","26969080700","2755","9789140","10151583","362443","2024-09"
"015750","성우하이텍","510346363340","6380","79991593","80000000","8407","2024-09"
"365340","성일하이텍","657844207400","54200","12137347","12137347","0","2024-09"
"000180","성창기업지주","104627400000","1500","69751600","69751600","0","2024-09"
"080470","성창오토텍","30222000000","4140","7300000","7300000","0","2024-09"
"043260","성호전자","96078447675","1575","61002189","61002189","0","2024-09"
"148150","세경하이테크","246734020130","6970","35399429","35860429","461000","2024-09"
"002420","세기상사","32185729920","5790","5558848","5558848","0","2024-09"
"188260","세니젠","23708325340","3340","7098301","7228470","130169","2024-09"
"053060","세동","18716294920","1060","17656882","17657419","537","2024-09"
"340440","세림B&G","36295921161","1279","28378359","28378364","5","2024-09"
"017510","세명전기","81718560000","5360","15246000","15246000","0","2024-09"
"004360","세방","220629085200","12300","17937324","19308690","1371366","2024-09"
"004490","세방전지","972115924200","73900","13154478","14000000","845522","2024-09"
"011560","세보엠이씨","95903404740","9670","9917622","10530000","612378","2024-09"
"396300","세아메카닉스","81318397500","3105","26189500","26489500","300000","2024-09"
"001430","세아베스틸지주","714373410480","19920","35862119","35862119","0","2024-09"
"306200","세아제강","318091360000","113600","2800100","2836300","36200","2024-09"
"003030","세아제강지주","662635604000","164000","4040461","4141657","101196","2024-09"
"019440","세아특수강","114491602680","13720","8344869","8570000","225131","2024-09"
"058650","세아홀딩스","376705390300","96700","3895609","4000000","104391","2024-09"
"013000","세우글로벌","36223162022","1262","28702981","28705031","2050","2024-09"
"100700","세운메디칼","121431535500","2805","43291100","43800000","508900","2024-09"
"024830","세원물산","53356500000","6390","8350000","8350000","0","2024-09"
"091090","세원이앤씨","54828158060","1270","43171778","43180255","8477","2024-09"
"021820","세원정공","71800000000","7180","10000000","10000000","0","2024-09"
"067830","세이브존I&C","80900290185","2145","37715753","41040895","3325142","2024-09"
"258830","세종메디칼","22974088612","412","55762351","55786351","24000","2024-09"
"036630","세종텔레콤","96682393876","509","189945764","200000000","10054236","2024-09"
"039310","세중","30915563902","1706","18121667","18121667","0","2024-09"
"075580","세진중공업","421254468960","7410","56849456","56849456","0","2024-09"
"067770","세진티에스","20241481160","2440","8295689","8396593","100904","2024-09"
"053450","세코닉스","78992803800","5400","14628297","14792803","164506","2024-09"
"222810","세토피아","81189010800","1080","75175010","75659350","484340","2024-09"
"252500","세화피앤씨","40200311910","969","41486390","41486390","0","2024-09"
"321370","센서뷰","60195457325","2285","26343745","26343745","0","2024-09"
"347000","센코","80901861285","2485","32556081","33004976","448895","2024-09"
"331920","셀레믹스","36003892680","4410","8164148","8164148","0","2024-09"
"049180","셀루메드","183263924730","3590","51048447","51057455","9008","2024-09"
"299660","셀리드","114378135340","5420","21102977","21102977","0","2024-09"
"268600","셀리버리","248384003120","6680","37183234","37183234","0","2024-09"
"108860","셀바스AI","284214754560","10560","26914276","26914790","514","2024-09"
"208370","셀바스헬스케어","113800287075","4425","25717579","25740564","22985","2024-09"
"318160","셀바이오휴먼텍","30804865650","3510","8776315","9260901","484586","2024-09"
"308430","셀비온","287901603400","22600","12739009","12739009","0","2024-09"
"068270","셀트리온","39508392905100","191700","206094903","217021190","10926287","2024-09"
"068760","셀트리온제약","2706946613400","65400","41390621","41600387","209766","2024-09"
"068940","셀피글로벌","29334496224","778","37705008","38260597","555589","2024-09"
"060230","소니드","41554353048","908","45764706","46066730","302024","2024-09"
"290690","소룩스","441017005440","9680","45559608","45564340","4732","2024-09"
"032680","소프트센","45674380704","438","104279408","105590764","1311356","2024-09"
"258790","소프트캠프","20933363196","873","23978652","24991284","1012632","2024-09"
"066910","손오공","56656923638","1682","33684259","33784259","100000","2024-09"
"336370","솔루스첨단소재","877653725000","12500","70212298","70217344","5046","2024-09"
"248070","솔루엠","997755828000","20500","48671016","50005551","1334535","2024-09"
"035610","솔본","101384432750","3950","25666945","27345997","1679052","2024-09"
"357780","솔브레인","1591215681000","205500","7743142","7778566","35424","2024-09"
"036830","솔브레인홀딩스","1047542765100","50700","20661593","20964056","302463","2024-09"
"304100","솔트룩스","240306552080","19810","12130568","12130568","0","2024-09"
"328380","솔트웨어","39773757429","1161","34258189","34262778","4589","2024-09"
"004430","송원산업","299760000000","12490","24000000","24000000","0","2024-09"
"086980","쇼박스","255995800000","4100","62438000","62638000","200000","2024-09"
"050960","수산아이앤티","66902410000","9910","6751000","6751000","0","2024-09"
"126720","수산인더스트리","315261520000","22400","14074175","14286000","211825","2024-09"
"017550","수산중공업","107326503600","1720","62399130","62399130","0","2024-09"
"084180","수성웹툰","86458268128","736","117470473","117470473","0","2024-09"
"253840","수젠텍","94337251560","6170","15289668","16743200","1453532","2024-09"
"298830","슈어소프트테크","258618277180","4955","52193396","52619061","425665","2024-09"
"236200","슈프리마","178005706800","25800","6899446","7193273","293827","2024-09"
"094840","슈프리마에이치큐","53365592940","5830","9153618","10471840","1318222","2024-09"
"192440","슈피겐코리아","132354812400","21950","6029832","6216363","186531","2024-09"
"424960","스마트레이더시스템","186158692800","11920","15617340","15617340","0","2024-09"
"099440","스맥","127329955180","3415","37285492","40243394","2957902","2024-09"
"053210","스카이라이프","239306283920","5060","47293732","47522955","229223","2024-09"
"276040","스코넥","40802040500","3250","12554474","12554474","0","2024-09"
"159910","스킨앤스킨","27711972660","766","36177510","36410098","232588","2024-09"
"060240","스타코링크","26132140600","860","30386210","31136323","750113","2024-09"
"115570","스타플렉스","24419605710","3095","7890018","7984508","94490","2024-09"
"330730","스톤브릿지벤처스","66689242200","3825","17435096","18150830","715734","2024-09"
"352090","스톰테크","91905653160","3420","26872998","26872998","0","2024-09"
"253450","스튜디오드래곤","1119679050500","37250","30058498","30058498","0","2024-09"
"408900","스튜디오미르","136057172160","4160","32706051","32706134","83","2024-09"
"204630","스튜디오산타클로스","23613109200","4650","5078088","5089941","11853","2024-09"
"415380","스튜디오삼익","34585993900","8530","4054630","4225498","170868","2024-09"
"026890","스틱인베스트먼트","313586902200","8580","36548590","41678175","5129585","2024-09"
"013810","스페코","62139192800","4240","14655470","14655470","0","2024-09"
"203690","스피어파워","67036526690","5090","13170241","13337850","167609","2024-09"
"049830","승일","41529907780","7030","5907526","6132112","224586","2024-09"
"020710","시공테크","68473651950","3630","18863265","20047970","1184705","2024-09"
"033170","시그네틱스","85042492448","992","85728319","85728319","0","2024-09"
"048870","시너지이노베이션","248125032000","3000","82708344","82708344","0","2024-09"
"025320","시노펙스","575961367800","6900","83472662","83817936","345274","2024-09"
"134790","시디즈","49949000500","29750","1678958","2000000","321042","2024-09"
"269620","시스웍","131663951937","889","148103433","148582691","479258","2024-09"
"429270","시지트로닉스","31949312500","7090","4506250","4506250","0","2024-09"
"418250","시큐레터","52279100100","6550","7981542","7981542","0","2024-09"
"131090","시큐브","34017243720","876","38832470","44000000","5167530","2024-09"
"232830","시큐센","24234467040","2070","11707472","11707472","0","2024-09"
"462870","시프트업","3430081536000","58800","58334720","58334720","0","2024-09"
"016590","신대양제지","176365339750","5750","30672233","40297820","9625587","2024-09"
"290520","신도기연","34226156700","2175","15736164","15929362","193198","2024-09"
"029530","신도리코","352240522150","40850","8622779","10080029","1457250","2024-09"
"004970","신라교역","148536850000","9410","15785000","16000000","215000","2024-09"
"001000","신라섬유","24860200960","1024","24277540","24277540","0","2024-09"
"025870","신라에스지","24800000000","6200","4000000","4000000","0","2024-09"
"215600","신라젠","343916773125","2505","137292125","137367125","75000","2024-09"
"065350","신성델타테크","1323858267600","48700","27183948","27483948","300000","2024-09"
"416180","신성에스티","231433447300","25850","8952938","9039778","86840","2024-09"
"011930","신성이엔지","312473808465","1535","203565999","205848151","2282152","2024-09"
"005390","신성통상","321906793600","2240","143708390","143708390","0","2024-09"
"004170","신세계","1343363694400","145600","9226399","9845181","618782","2024-09"
"035510","신세계 I&C","132904139100","10110","13145810","17200000","4054190","2024-09"
"034300","신세계건설","137970237960","18180","7589122","7760554","171432","2024-09"
"031430","신세계인터내셔날","455025060000","13140","34629000","35700000","1071000","2024-09"
"031440","신세계푸드","138240788700","35700","3872291","3872480","189","2024-09"
"006880","신송홀딩스","71643614640","6640","10789701","11828858","1039157","2024-09"
"162300","신스틸","105830444160","2580","41019552","41471382","451830","2024-09"
"290560","신시웨이","24415234200","6300","3875434","3877972","2538","2024-09"
"002800","신신제약","93601985000","6170","15170500","15170500","0","2024-09"
"472220","신영스팩10호","10106950000","2155","4690000","4690000","0","2024-09"
"430220","신영스팩8호","14669200000","2170","6760000","6760000","0","2024-09"
"445970","신영스팩9호","11711600000","2185","5360000","5360000","0","2024-09"
"005800","신영와코루","82260000000","9140","9000000","9000000","0","2024-09"
"001720","신영증권","632397252800","82100","7702768","16440000","8737232","2024-09"
"009270","신원","91488821964","1219","75052356","102586356","27534000","2024-09"
"017000","신원종합개발","35937599940","3210","11195514","11668027","472513","2024-09"
"002700","신일전자","104875407376","1492","70291828","71047521","755693","2024-09"
"012790","신일제약","86696707500","7500","11559561","11986415","426854","2024-09"
"138070","신진에스엠","41226963400","2450","16827332","17503204","675872","2024-09"
"226330","신테카바이오","89414663500","5860","15258475","15258475","0","2024-09"
"002870","신풍","26736656700","965","27706380","34958700","7252320","2024-09"
"019170","신풍제약","582876273070","11830","49271029","52984990","3713961","2024-09"
"418210","신한제10호스팩","7997100000","2185","3660000","3660000","0","2024-09"
"452980","신한제11호스팩","37015990000","1958","18905000","18905000","0","2024-09"
"474660","신한제12호스팩","11757600000","2130","5520000","5520000","0","2024-09"
"474930","신한제13호스팩","7801100000","2155","3620000","3620000","0","2024-09"
"055550","신한지주","28092249079200","55800","503445324","509393214","5947890","2024-09"
"056700","신화인터텍","50450287249","1739","29011091","29135091","124000","2024-09"
"187270","신화콘텍","30861279515","3355","9198593","10143845","945252","2024-09"
"004080","신흥","135034971500","14300","9443005","9500000","56995","2024-09"
"243840","신흥에스이씨","302055835050","7830","38576735","38919035","342300","2024-09"
"257720","실리콘투","2514064564200","41300","60873234","60873234","0","2024-09"
"222800","심텍","547749084400","17200","31845877","31854143","8266","2024-09"
"036710","심텍홀딩스","75297121250","1625","46336690","48350145","2013455","2024-09"
"160980","싸이맥스","118454760520","11590","10220428","10924243","703815","2024-09"
"356890","싸이버원","36042633000","3025","11914920","11916325","1405","2024-09"
"217330","싸이토젠","173252297970","7510","23069547","23129547","60000","2024-09"
"102280","쌍방울","70634046631","269","262580099","262592129","12030","2024-09"
"010280","쌍용정보통신","39399883270","605","65123774","65123786","12","2024-09"
"004770","써니전자","58029484723","1597","36336559","36702884","366325","2024-09"
"208640","썸에이지","36480946548","262","139240254","139240254","0","2024-09"
"222420","쎄노텍","37413767644","823","45460228","45460231","3","2024-09"
"037760","쎄니트","46425260367","1527","30402921","33832921","3430000","2024-09"
"099320","쎄트렉아이","411220488900","37550","10951278","10951278","0","2024-09"
"049960","쎌바이오텍","95883039000","14010","6843900","9400000","2556100","2024-09"
"088280","쏘닉스","42920095200","2480","17306490","17306490","0","2024-09"
"403550","쏘카","580407166380","17690","32809902","32809902","0","2024-09"
"050890","쏠리드","263612340300","4350","60600538","61095231","494693","2024-09"
"109670","씨싸이트","58703107940","10060","5835299","5836602","1303","2024-09"
"066790","씨씨에스","99195664040","1640","60485161","65152039","4666878","2024-09"
"222080","씨아이에스","587463188130","8190","71729327","71729327","0","2024-09"
"004920","씨아이테크","62331912285","1245","50065793","50065793","0","2024-09"
"352480","씨앤씨인터내셔널","737786275200","73800","9997104","10013941","16837","2024-09"
"264660","씨앤지하이테크","125643014460","13470","9327618","9627896","300278","2024-09"
"352700","씨앤투스","76891657530","3005","25587906","27276899","1688993","2024-09"
"458870","씨어스테크놀로지","174970419200","13940","12551680","12551680","0","2024-09"
"297090","씨에스베어링","152712000000","5600","27270000","27270000","0","2024-09"
"112610","씨에스윈드","2460911171400","59400","41429481","42171403","741922","2024-09"
"359090","씨엔알리서치","73611347680","1304","56450420","56450891","471","2024-09"
"115530","씨엔플러스","33709648000","496","67963000","67963000","0","2024-09"
"115480","씨유메디칼","36815286870","765","48124558","48224558","100000","2024-09"
"340810","씨유박스","42603409260","4020","10597863","10597863","0","2024-09"
"376290","씨유테크","55267975000","3130","17657500","17657500","0","2024-09"
"189330","씨이랩","41853991080","6870","6092284","6092284","0","2024-09"
"096530","씨젠","1096943815000","23750","46187108","52225994","6038886","2024-09"
"101240","씨큐브","50399973000","4875","10338456","10340947","2491","2024-09"
"060590","씨티씨바이오","187683883750","7850","23908775","24181020","272245","2024-09"
"308170","씨티알모빌리티","47182800000","5480","8610000","8610000","0","2024-09"
"260930","씨티케이","106844283630","5670","18843789","19341591","497802","2024-09"
"052300","씨티프라퍼티","63408414024","376","168639399","168651433","12034","2024-09"
"413630","씨피시스템","100131874945","2705","37017329","38703425","1686096","2024-09"
"013990","아가방컴퍼니","134347803390","4470","30055437","32887536","2832099","2024-09"
"123860","아나패스","229132543500","18900","12123415","12123415","0","2024-09"
"025980","아난티","417444841380","4710","88629478","88629478","0","2024-09"
"008700","아남전자","101568791610","1317","77121330","77124820","3490","2024-09"
"125210","아모그린텍","109208749800","6620","16496790","16496790","0","2024-09"
"002790","아모레G","1800020970000","23600","76272075","82458180","6186105","2024-09"
"090430","아모레퍼시픽","7390381735000","126500","58421990","58492759","70769","2024-09"
"357580","아모센스","80561495520","7180","11220264","11220264","0","2024-09"
"052710","아모텍","58742434920","4020","14612546","14615109","2563","2024-09"
"074430","아미노로직스","107500057056","1224","87826844","87826844","0","2024-09"
"092040","아미코젠","240369115930","4385","54816218","55018347","202129","2024-09"
"083930","아바코","195834208590","13490","14516991","14912798","395807","2024-09"
"149950","아바텍","154940968000","11200","13834015","15607500","1773485","2024-09"
"036010","아비코전자","71781843600","5400","13292934","13292934","0","2024-09"
"002030","아세아","410896431000","244500","1680558","2115648","435090","2024-09"
"183190","아세아시멘트","415025126750","11050","37558835","38501886","943051","2024-09"
"002310","아세아제지","334844269000","8380","39957550","42782510","2824960","2024-09"
"050860","아세아텍","43554557200","2200","19797526","22500000","2702474","2024-09"
"012170","아센디오","51784693000","500","103569386","103569488","102","2024-09"
"136410","아셈스","89813199450","8450","10628781","11019106","390325","2024-09"
"246720","아스타","64648184500","4765","13567300","13567300","0","2024-09"
"067390","아스트","191647321415","557","344070595","344203992","133397","2024-09"
"159010","아스플로","86466845100","6690","12924790","13334739","409949","2024-09"
"127710","아시아경제","48028016832","1376","34904082","34904082","0","2024-09"
"267850","아시아나IDT","195804000000","17640","11100000","11100000","0","2024-09"
"020560","아시아나항공","744861757640","10010","74411764","74411764","0","2024-09"
"154030","아시아종묘","27297633960","2355","11591352","11591352","0","2024-09"
"227610","아우딘퓨쳐스","49840432122","1406","35448387","35583547","135160","2024-09"
"143160","아이디스","151510741650","15030","10080555","10716390","635835","2024-09"
"054800","아이디스홀딩스","81162486710","9190","8831609","10347756","1516147","2024-09"
"332370","아이디피","48498730630","3845","12613454","13273726","660272","2024-09"
"122900","아이마켓코리아","262727239000","8350","31464340","33428840","1964500","2024-09"
"339950","아이비김영","79052152710","1823","43363770","44946655","1582885","2024-09"
"469750","아이비젼웍스","56192350662","1659","33871218","33936481","65263","2024-09"
"460470","아이빔테크놀로지","79042098800","5240","15084370","15084370","0","2024-09"
"099190","아이센스","546047563360","19760","27633986","27637273","3287","2024-09"
"461300","아이스크림미디어","180415323300","14100","12795413","13063433","268020","2024-09"
"289010","아이스크림에듀","32074739200","2560","12529195","12864037","334842","2024-09"
"214430","아이쓰리시스템","228728421900","32950","6941682","7106760","165078","2024-09"
"040910","아이씨디","90201771030","5530","16311351","18574275","2262924","2024-09"
"368600","아이씨에이치","65568645345","3815","17187063","17538346","351283","2024-09"
"456010","아이씨티케이","100750847520","7620","13221896","13221896","0","2024-09"
"052860","아이앤씨","26875570104","1656","16229209","17862854","1633645","2024-09"
"464500","아이언디바이스","84650230600","6200","13653263","13653263","0","2024-09"
"010780","아이에스동서","642982588800","21300","30186976","30186976","0","2024-09"
"038880","아이에이","65504181365","215","304670611","315334702","10664091","2024-09"
"307180","아이엘사이언스","88699370480","3280","27042491","27042828","337","2024-09"
"101390","아이엠","31908864015","3035","10513629","10548085","34456","2024-09"
"461030","아이엠비디엑스","224424177500","16010","14017750","14017750","0","2024-09"
"451220","아이엠티","74887550610","9510","7874611","7874611","0","2024-09"
"090150","아이윈","36141410760","910","39715836","41875293","2159457","2024-09"
"123010","아이윈플러스","23895019159","737","32422007","32658542","236535","2024-09"
"031310","아이즈비전","44951157680","1840","24429977","25334636","904659","2024-09"
"185490","아이진","81494798760","3015","27029784","27029784","0","2024-09"
"059100","아이컴포넌트","30387995600","4600","6606086","7070860","464774","2024-09"
"262840","아이퀘스트","42813561700","2275","18819148","19290000","470852","2024-09"
"175250","아이큐어","76047308975","2035","37369685","37558368","188683","2024-09"
"052460","아이크래프트","28280518640","2365","11957936","14607936","2650000","2024-09"
"119830","아이텍","121360421400","5700","21291302","21434297","142995","2024-09"
"052770","아이톡시","67004566128","1368","48979946","48979946","0","2024-09"
"124500","아이티센","157558738330","6790","23204527","23204527","0","2024-09"
"372800","아이티아이즈","34733241000","5900","5886990","6026990","140000","2024-09"
"084850","아이티엠반도체","382948225710","18510","20688721","22682934","1994213","2024-09"
"114840","아이패밀리에스씨","369410698800","21450","17221944","17221944","0","2024-09"
"027360","아주IB투자","238004719080","2010","118410308","120945406","2535098","2024-09"
"139990","아주스틸","137361136920","5180","26517594","26517744","150","2024-09"
"032080","아즈텍WB","23928633060","1140","20990029","21491029","501000","2024-09"
"013310","아진산업","110203195280","2840","38803942","38806582","2640","2024-09"
"059120","아진엑스텍","73423364660","8020","9155033","9748596","593563","2024-09"
"158430","아톤","88693484600","4150","21371924","22602474","1230550","2024-09"
"321820","아티스트유나이티드","222691054600","16660","13366810","13366810","0","2024-09"
"001540","안국약품","83194471800","7320","11365365","13042420","1677055","2024-09"
"053800","안랩","542833243600","55400","9798434","11126506","1328072","2024-09"
"065660","안트로젠","153755693400","15800","9731373","9731373","0","2024-09"
"297570","알로이스","37737127620","1090","34621218","34621218","0","2024-09"
"001780","알루코","232392316800","2400","96830132","96830132","0","2024-09"
"260660","알리코제약","59828363135","3985","15013391","15327021","313630","2024-09"
"354320","알멕","206441606300","32300","6391381","6391381","0","2024-09"
"361570","알비더블유","65574816390","2290","28635291","28635291","0","2024-09"
"131370","알서포트","151575433980","2910","52087778","53267083","1179305","2024-09"
"140670","알에스오토메이션","104764408560","11340","9238484","9303140","64656","2024-09"
"096610","알에프세미","51550708615","2965","17386411","17386411","0","2024-09"
"061040","알에프텍","95849538360","3070","31221348","32089259","867911","2024-09"
"148250","알엔투테크놀로지","29056016250","4050","7174325","7391186","216861","2024-09"
"347860","알체라","52186613160","2370","22019668","22019668","0","2024-09"
"196170","알테오젠","21117115950000","397500","53124820","53148528","23708","2024-09"
"123750","알톤","20624701140","1620","12731297","12746297","15000","2024-09"
"085810","알티캐스트","39457885390","1330","29667583","30447327","779744","2024-09"
"043100","알파녹스","22669233120","2845","7968096","7975920","7824","2024-09"
"117670","알파홀딩스","37743429465","945","39940137","39940137","0","2024-09"
"314140","알피바이오","57867442980","6690","8649842","8666361","16519","2024-09"
"291650","압타머사이언스","43044938820","2535","16980252","16980252","0","2024-09"
"293780","압타바이오","220840686000","8930","24730200","24730200","0","2024-09"
"018250","애경산업","435639882600","16950","25701468","26409935","708467","2024-09"
"161000","애경케미칼","518978029500","10750","48277026","48648709","371683","2024-09"
"196300","애니젠","87049111500","14500","6003387","6003387","0","2024-09"
"310200","애니플러스","127893817250","2875","44484806","45520979","1036173","2024-09"
"299910","애닉","32483121920","6880","4721384","4721384","0","2024-09"
"179530","애드바이오텍","31580234020","3455","9140444","9140444","0","2024-09"
"205500","액션스퀘어","56548159965","1089","51926685","51928120","1435","2024-09"
"052790","액토즈소프트","69917100800","6400","10924547","11330638","406091","2024-09"
"290740","액트로","52354354470","5610","9332327","10065011","732684","2024-09"
"238090","앤디포스","93318238600","4100","22760546","23541303","780757","2024-09"
"092600","앤씨앤","27819960672","1136","24489402","25083517","594115","2024-09"
"129890","앱코","56995678320","1190","47895528","50643410","2747882","2024-09"
"174900","앱클론","301454420300","17300","17425111","17425111","0","2024-09"
"255440","야스","110426491350","9150","12068469","13058000","989531","2024-09"
"030960","양지사","128844336600","9380","13736070","15980000","2243930","2024-09"
"102120","어보브반도체","167627340640","10160","16498754","17780753","1281999","2024-09"
"263540","어스앤에어로스페이스","85022108500","5950","14289430","14294091","4661","2023-12"
"238120","얼라인드","42921004560","2985","14378896","14378896","0","2024-09"
"019990","에너토크","60095938760","6280","9569417","9756088","186671","2024-09"
"011090","에넥스","33031526477","557","59302561","59991641","689080","2024-09"
"270660","에브리봇","199737814860","16330","12231342","12231342","0","2024-09"
"038680","에스넷","68895609190","3790","18178261","19549677","1371416","2024-09"
"137310","에스디바이오센서","1125596687200","9200","122347466","124477353","2129887","2024-09"
"217480","에스디생명공학","54756837359","499","109733141","109733141","0","2024-09"
"121890","에스디시스템","19405511160","1460","13291446","13291446","0","2024-09"
"304360","에스바이오메딕스","394658745600","33600","11745796","11745796","0","2024-09"
"389500","에스비비테크","96644246940","16210","5962014","6174904","212890","2024-09"
"042110","에스씨디","71914391232","1488","48329564","48329564","0","2024-09"
"298060","에스씨엠생명과학","42455765750","2075","20460610","20467248","6638","2024-09"
"065420","에스아이리소스","19468327648","272","71574734","71577299","2565","2024-09"
"103230","에스앤더블류","26064000000","3620","7200000","7200000","0","2024-09"
"260970","에스앤디","103271317800","35700","2892754","2892754","0","2024-09"
"101490","에스앤에스텍","504899820000","24100","20950200","21451447","501247","2024-09"
"095910","에스에너지","28786688032","1544","18644228","19504503","860275","2024-09"
"275630","에스에스알","17828612360","3295","5410808","6017989","607181","2024-09"
"031330","에스에이엠티","312631939735","3205","97545067","99995067","2450000","2024-09"
"060540","에스에이티","39330065670","1505","26132934","26133306","372","2024-09"
"351320","에스에이티이엔지","34124297800","1550","22015676","22015886","210","2024-09"
"056190","에스에프에이","658140353300","20950","31414814","35908760","4493946","2024-09"
"080000","에스엔유","59535885240","1740","34216026","34322870","106844","2024-09"
"005850","에스엘","1549766296300","33650","46055462","46448520","393058","2024-09"
"214310","에스엘에너지","22487615640","6120","3674447","3679130","4683","2024-09"
"246250","에스엘에스바이오","46658546240","3040","15348206","15348206","0","2024-09"
"041510","에스엠","1556838920000","68000","22894690","23353627","458937","2024-09"
"010580","에스엠벡셀","137993984856","1242","111106268","111251760","145492","2024-09"
"007820","에스엠코어","98549952480","5040","19553562","20033946","480384","2024-09"
"464080","에스오에스랩","102545469000","5850","17529140","17529140","0","2024-09"
"109610","에스와이","185301078800","3880","47758010","48907400","1149390","2024-09"
"365330","에스와이스틸텍","158559800000","5180","30610000","30610000","0","2024-09"
"012750","에스원","2025233316100","59900","33810239","37999178","4188939","2024-09"
"031860","에스유홀딩스","17965788152","1196","15021562","15026356","4794","2024-09"
"306040","에스제이그룹","57149632720","6070","9415096","9865828","450732","2024-09"
"457940","에스케이증권제10호스팩","7066850000","2135","3310000","3310000","0","2024-09"
"472230","에스케이증권제11호스팩","8663175000","2085","4155000","4155000","0","2024-09"
"473000","에스케이증권제12호스팩","6967550000","2105","3310000","3310000","0","2024-09"
"473950","에스케이증권제13호스팩","9105200000","2060","4420000","4420000","0","2024-09"
"435870","에스케이증권제8호스팩","7849200000","2110","3720000","3720000","0","2024-09"
"455910","에스케이증권제9호스팩","10742800000","2140","5020000","5020000","0","2024-09"
"096630","에스코넥","60607713285","777","78002205","79052205","1050000","2024-09"
"069510","에스텍","91332600000","10860","8410000","10910000","2500000","2024-09"
"234300","에스트래픽","119712935250","4350","27520215","27809848","289633","2024-09"
"039440","에스티아이","301372611150","20450","14737047","15830000","1092953","2024-09"
"098660","에스티오","39203311040","3230","12137248","12500976","363728","2024-09"
"052020","에스티큐브","325110415530","6970","46644249","46694249","50000","2024-09"
"237690","에스티팜","2201792055000","109500","20107690","20107690","0","2024-09"
"050760","에스폴리텍","24801087014","1606","15442769","16334678","891909","2024-09"
"288620","에스퓨얼셀","77470407600","11100","6979316","6979316","0","2024-09"
"443670","에스피소프트","167219222180","6910","24199598","24201392","1794","2024-09"
"317830","에스피시스템스","55633827460","5470","10170718","10773818","603100","2024-09"
"058610","에스피지","493446260000","22250","22177360","22177360","0","2024-09"
"043340","에쎈테크","46265000000","487","95000000","95000000","0","2024-09"
"023960","에쓰씨엔지니어링","61330842330","1805","33978306","33978308","2","2024-09"
"298690","에어부산","282711311200","2425","116581984","116640000","58016","2024-09"
"054630","에이디칩스","12594094838","158","79709461","79709461","0","2024-09"
"200710","에이디테크놀로지","206237884720","15920","12954641","13440822","486181","2024-09"
"096690","에이루트","43480221528","1299","33472072","33477189","5117","2024-09"
"078520","에이블씨엔씨","184960663380","7110","26014158","26014161","3","2024-09"
"298380","에이비엘바이오","1984373685700","41300","48047789","48047789","0","2024-09"
"203400","에이비온","220969002720","8760","25224772","25224772","0","2024-09"
"195990","에이비프로바이오","154300845052","542","284687906","284689721","1815","2024-09"
"003800","에이스침대","290315987500","27500","10556945","11090000","533055","2024-09"
"088800","에이스테크","120659991928","952","126743689","127068928","325239","2024-09"
"241840","에이스토리","65050591850","7010","9279685","9539994","260309","2024-09"
"453860","에이에스텍","137781006750","24450","5635215","5657215","22000","2024-09"
"312610","에이에프더블류","34153113168","1686","20256888","20256888","0","2024-09"
"015260","에이엔피","33383722120","740","45113138","45116894","3756","2024-09"
"172670","에이엘티","85400037000","9640","8858925","8960259","101334","2024-09"
"445090","에이직랜드","339308109000","31500","10771686","10771686","0","2024-09"
"295310","에이치브이엠","188883644970","15870","11901931","11901931","0","2024-09"
"072990","에이치시티","74335359000","10500","7079558","7287341","207783","2024-09"
"239610","에이치엘사이언스","86478307980","16980","5092951","5392115","299164","2024-09"
"462020","에이치엠씨제6호스팩","8863800000","2040","4345000","4345000","0","2024-09"
"477340","에이치엠씨제7호스팩","14922370000","1987","7510000","7510000","0","2024-09"
"148930","에이치와이티씨","44818696600","4610","9722060","10175213","453153","2024-09"
"044780","에이치케이","23976048198","1306","18358383","18505787","147404","2024-09"
"357230","에이치피오","122156864560","2960","41269211","42089487","820276","2024-09"
"355690","에이텀","37888909800","7010","5404980","5404980","0","2024-09"
"071670","에이테크솔루션","64500000000","6450","10000000","10000000","0","2024-09"
"045660","에이텍","113681358780","15070","7543554","8260000","716446","2024-09"
"224110","에이텍모빌리티","65546685040","13360","4906189","5340000","433811","2024-09"
"021080","에이티넘인베스트","118666003500","2580","45994575","48000000","2005425","2024-09"
"200470","에이팩트","123058789245","2905","42361029","42362093","1064","2024-09"
"262260","에이프로","105447901320","7320","14405451","14468152","62701","2024-09"
"007460","에이프로젠","313989846200","1180","266093090","286851768","20758678","2024-09"
"003060","에이프로젠바이오로직스","175444651728","888","197572806","198407845","835039","2024-09"
"397030","에이프릴바이오","540254444400","24650","21917016","21917016","0","2024-09"
"244920","에이플러스에셋","94500156740","4180","22607693","22607693","0","2024-09"
"278470","에이피알","1984308631500","266500","7445811","7622678","176867","2024-09"
"230240","에치에프알","127300607800","9700","13123774","13309000","185226","2024-09"
"230360","에코마케팅","324750059280","10320","31468029","31468029","0","2024-09"
"038870","에코바이오","56121115815","4005","14012763","14014949","2186","2024-09"
"097780","에코볼트","59196315412","874","67730338","67730338","0","2024-09"
"448280","에코아이","199022416450","20150","9877043","9877043","0","2024-09"
"101360","에코앤드림","683480811700","38950","17547646","17786114","238468","2024-09"
"128540","에코캡","35244357384","1356","25991414","26690460","699046","2024-09"
"086520","에코프로","10592225238000","80400","131744095","133138340","1394245","2024-09"
"450080","에코프로머티","8012189368000","116000","69070598","69070598","0","2024-09"
"247540","에코프로비엠","16104147356900","164900","97660081","97801344","141263","2024-09"
"383310","에코프로에이치엔","683024204800","44800","15246076","15304932","58856","2024-09"
"038110","에코플라스틱","117723702340","2930","40178738","41169370","990632","2024-09"
"073540","에프알텍","14865600000","1304","11400000","11400000","0","2024-09"
"064850","에프앤가이드","133044471120","11660","11410332","11410332","0","2024-09"
"036810","에프에스티","370981891280","18590","19955992","21756789","1800797","2024-09"
"173940","에프엔씨엔터","55158557245","3695","14927891","15392808","464917","2024-09"
"083500","에프엔에스테크","80733340000","10100","7993400","8575722","582322","2024-09"
"054940","엑사이엔씨","23984475204","723","33173548","33173548","0","2024-09"
"373110","엑셀세라퓨틱스","70205710660","6430","10918462","10918462","0","2024-09"
"205100","엑셈","129451391384","1799","71957416","71963431","6015","2024-09"
"356680","엑스게이트","139100237250","4875","28533382","28543492","10110","2024-09"
"070300","엑스큐어","43762478320","5240","8351618","8351618","0","2024-09"
"317770","엑스페릭스","77992280400","3400","22938906","22938906","0","2024-09"
"373200","엑스플러스","48375415764","639","75704876","75705657","781","2024-09"
"069920","엑시온그룹","49986877248","1428","35004816","35194116","189300","2024-09"
"092870","엑시콘","144777896220","11580","12502409","13050797","548388","2024-09"
"317870","엔바이오니아","158140482500","18590","8506750","8506750","0","2024-09"
"067570","엔브이에이치코리아","106576079550","2550","41794541","42170000","375459","2024-09"
"236810","엔비티","60962895000","3780","16127750","16975426","847676","2024-09"
"333620","엔시스","105491853890","10210","10332209","10556344","224135","2024-09"
"101400","엔시트론","27102303256","436","62161246","62162413","1167","2024-09"
"036570","엔씨소프트","4006136365000","200500","19980730","21954022","1973292","2024-09"
"078860","엔에스이엔엠","91440611900","8690","10522510","10531054","8544","2024-09"
"422040","엔에이치스팩23호","15071800000","2105","7160000","7160000","0","2024-09"
"437780","엔에이치스팩24호","10663600000","2120","5030000","5030000","0","2024-09"
"438580","엔에이치스팩25호","6583600000","2180","3020000","3020000","0","2024-09"
"439410","엔에이치스팩26호","18392000000","2090","8800000","8800000","0","2024-09"
"440820","엔에이치스팩27호","16341000000","2095","7800000","7800000","0","2024-09"
"451700","엔에이치스팩29호","28771750000","2005","14350000","14350000","0","2024-09"
"466910","엔에이치스팩30호","18154500000","1995","9100000","9100000","0","2024-09"
"481890","엔에이치스팩31호","12848625000","2025","6345000","6345000","0","2024-09"
"265740","엔에프씨","54930570000","6150","8931800","8931800","0","2024-09"
"354200","엔젠바이오","39223371820","2855","13738484","13738484","0","2024-09"
"455900","엔젤로보틱스","364667296400","24400","14945381","14945381","0","2024-09"
"419080","엔젯","92294047380","9140","10097817","10517817","420000","2024-09"
"208860","엔지스테크널러지","41831348265","2205","18971133","18971133","0","2024-09"
"183490","엔지켐생명과학","119915538986","1502","79837243","85065562","5228319","2024-09"
"085310","엔케이","61368890516","778","78880322","79983352","1103030","2024-09"
"182400","엔케이맥스","172744574320","2020","85517116","85518831","1715","2024-09"
"348370","엔켐","3860131601100","185700","20786923","20786923","0","2024-09"
"069410","엔텔스","35052755990","3535","9915914","10244824","328910","2024-09"
"227950","엔투텍","46194686380","446","103575530","103575530","0","2024-09"
"291230","엔피","96349242155","2185","44095763","44095775","12","2024-09"
"198080","엔피디","55345425450","2570","21535185","21535185","0","2024-09"
"048830","엔피케이","21836223696","1168","18695397","18723923","28526","2024-09"
"096870","엘디티","15393712000","2305","6678400","6678400","0","2024-09"
"290650","엘앤씨바이오","441221129950","19450","22684891","22684891","0","2024-09"
"066970","엘앤에프","3265166837100","97300","33557727","36296338","2738611","2024-09"
"156100","엘앤케이바이오","133376743770","6690","19936733","19936743","10","2024-09"
"073110","엘엠에스","38062852240","6580","5784628","8895755","3111127","2024-09"
"083310","엘오티베큠","161152989240","9960","16180019","17810033","1630014","2024-09"
"037950","엘컴텍","108209013774","1282","84406407","84447519","41112","2024-09"
"170920","엘티씨","91565628420","9870","9277166","9805620","528454","2024-09"
"058630","엠게임","124451220060","6690","18602574","19543877","941303","2024-09"
"058970","엠로","557124746000","47000","11853718","11853718","0","2024-09"
"019590","엠벤처투자","104963185182","921","113966542","113966542","0","2024-09"
"169330","엠브레인","38621296650","2175","17756918","18256918","500000","2024-09"
"097520","엠씨넥스","305638856400","17700","17267732","17977732","710000","2024-09"
"373170","엠아이큐브솔루션","41814819000","8300","5037930","5037930","0","2024-09"
"179290","엠아이텍","272842665540","8430","32365678","32365678","0","2024-09"
"009780","엠에스씨","89936000000","5110","17600000","17600000","0","2024-09"
"123040","엠에스오토텍","173820340920","3160","55006437","69172213","14165776","2024-09"
"323230","엠에프엠코리아","6967193212","161","43274492","43274492","0","2024-06"
"032790","엠젠솔루션","62529093552","1461","42798832","42798832","0","2024-09"
"033160","엠케이전자","176842171800","8460","20903330","22066331","1163001","2024-09"
"347890","엠투아이","92917063840","5680","16358638","16913204","554566","2024-09"
"033310","엠투엔","82925245320","2095","39582456","40342231","759775","2024-09"
"259630","엠플러스","120841731010","10010","12072101","12282402","210301","2024-09"
"105550","엣지파운드리","130336781400","2280","57165255","57165255","0","2024-09"
"060850","영림원소프트랩","56673070000","6970","8131000","8131000","0","2024-09"
"014440","영보화학","65910000000","3380","19500000","20000000","500000","2024-09"
"143540","영우디에스피","34862066400","798","43686800","44599895","913095","2024-09"
"111770","영원무역","1774871875500","41500","42767997","44311468","1543471","2024-09"
"009970","영원무역홀딩스","1050243269000","90500","11604898","13635592","2030694","2024-09"
"003520","영진약품","466375757700","2550","182892454","182892731","277","2024-09"
"000670","영풍","620968374000","361000","1720134","1842040","121906","2024-09"
"036560","영풍정밀","391387500000","24850","15750000","15750000","0","2024-09"
"006740","영풍제지","56622792690","1282","44167545","46482148","2314603","2024-09"
"012280","영화금속","38680941820","764","50629505","51664505","1035000","2024-09"
"265560","영화테크","94633885600","8920","10609180","10690180","81000","2024-09"
"012160","영흥","32312723622","474","68170303","101310372","33140069","2024-09"
"036000","예림당","46068554000","2000","23034277","23034277","0","2024-09"
"250930","예선테크","18823891392","576","32680367","33000440","320073","2024-09"
"053280","예스24","168653151000","6750","24985652","25000000","14348","2024-09"
"015360","예스코홀딩스","207414450000","48450","4281000","6000000","1719000","2024-09"
"122640","예스티","392646185000","19480","20156375","20930108","773733","2024-09"
"045060","오공","45573910060","2690","16941974","16941974","0","2024-09"
"080520","오디텍","36481945200","3525","10349488","11746609","1397121","2024-09"
"007310","오뚜기","1396366762000","406000","3439327","4007830","568503","2024-09"
"039830","오로라","58312591000","5900","9883490","10762890","879400","2024-09"
"322310","오로스테크놀로지","154559606760","16780","9210942","9366542","155600","2024-09"
"046120","오르비텍","64275689280","2370","27120544","27449486","328942","2024-09"
"014940","오리엔탈정공","167841759965","3685","45547289","45573661","26372","2024-09"
"002630","오리엔트바이오","54659906086","461","118568126","118583005","14879","2024-09"
"065500","오리엔트정공","38167044462","1203","31726554","31742912","16358","2024-09"
"271560","오리온","3933114406000","99500","39528788","39536132","7344","2024-09"
"001800","오리온홀딩스","981756576960","16320","60156653","62645422","2488769","2024-09"
"010470","오리콤","74618446050","6430","11604735","11975050","370315","2024-09"
"417860","오브젠","43552935620","9830","4430614","4430614","0","2024-09"
"352910","오비고","85305163500","6750","12637802","12637802","0","2024-09"
"053980","오상자이엘","71244434950","3775","18872698","18982783","110085","2024-09"
"036220","오상헬스케어","178936601850","13050","13711617","14489416","777799","2024-09"
"052420","오성첨단소재","151502864562","1818","83334909","86315192","2980283","2024-09"
"039200","오스코텍","1514469369600","39600","38244176","38244176","0","2024-09"
"226400","오스테오닉","120791705900","6100","19801919","20661601","859682","2024-09"
"031510","오스템","34759335821","1327","26193923","28000000","1806077","2024-09"
"368970","오에스피","30842328000","3300","9346160","9346160","0","2024-09"
"138080","오이솔루션","103259952400","10130","10193480","10624095","430615","2024-09"
"080580","오킨스전자","99776153000","5800","17202785","17679298","476513","2024-09"
"067170","오텍","51140480400","3600","14205689","15391605","1185916","2024-09"
"353590","오토앤","66180429800","5140","12875570","12875570","0","2024-09"
"173130","오파스넷","97040544960","7440","13043084","13046473","3389","2024-09"
"440320","오픈놀","45985450000","4690","9805000","9805000","0","2024-09"
"049480","오픈베이스","67944419040","2265","29997536","31422383","1424847","2024-09"
"394280","오픈엣지테크놀로지","270294729990","12370","21850827","21850827","0","2024-09"
"309930","오하임앤컴퍼니","41788779945","2035","20535027","21290990","755963","2024-09"
"244460","올리패스","18290883206","454","40288289","40290730","2441","2024-09"
"226950","올릭스","499908467000","29000","17238223","17238223","0","2024-09"
"057540","옴니시스템","48484124798","817","59344094","61449355","2105261","2024-09"
"131030","옵투스제약","102184819470","6690","15274263","16153162","878899","2024-09"
"082210","옵트론텍","62494429760","2240","27899299","28566538","667239","2024-09"
"109080","옵티시스","33342413070","7010","4756407","5636000","879593","2024-09"
"380540","옵티코어","34048283372","1186","28708502","29779596","1071094","2024-09"
"153710","옵티팜","78044176560","5320","14669958","14669958","0","2024-09"
"432430","와이랩","86545626400","5270","16422320","16422320","0","2024-09"
"338840","와이바이오로직스","180483485520","12220","14769516","14769516","0","2024-09"
"122990","와이솔","169073066630","6110","27671533","28186941","515408","2024-09"
"232140","와이씨","939426482740","11710","80224294","82045350","1821056","2024-09"
"112290","와이씨켐","176934537500","17500","10110545","10110545","0","2024-09"
"065530","와이어블","68648619165","1435","47838759","52860000","5021241","2024-09"
"067900","와이엔텍","117104793730","6470","18099659","18199659","100000","2024-09"
"007530","와이엠","50698733475","2665","19023915","19174452","150537","2024-09"
"155650","와이엠씨","76339563680","4220","18089944","19474358","1384414","2024-09"
"273640","와이엠텍","123839907400","11720","10566545","10966000","399455","2024-09"
"251370","와이엠티","133452315520","8180","16314464","16314464","0","2024-09"
"066430","와이오엠","22391009784","572","39145122","39153476","8354","2024-09"
"209640","와이제이링크","273907495980","19260","14221573","14221573",,"자료 없음"
"273060","와이즈버즈","46422809000","920","50459575","50459582","7","2024-09"
"019210","와이지-원","173240906040","5160","33573819","33573819","0","2024-09"
"122870","와이지엔터테인먼트","707563395700","38150","18546878","18691049","144171","2024-09"
"011690","와이투솔루션","94895937390","2595","36568762","36574394","5632","2024-09"
"332570","와이팜","108506667440","2630","41257288","42233850","976562","2024-09"
"079000","와토스코리아","35746997770","5030","7106759","7200000","93241","2024-09"
"403490","우듬지팜","86443020920","1912","45210785","45212464","1679","2024-09"
"316140","우리금융지주","12207317420640","16440","742537556","742591501","53945","2024-09"
"032820","우리기술","370932169100","2335","158857460","158859048","1588","2024-09"
"041190","우리기술투자","661126114440","8490","77871156","84000000","6128844","2024-09"
"115440","우리넷","80133090740","7660","10461239","10754239","293000","2024-09"
"046970","우리로","48433459212","1116","43399157","43824999","425842","2024-09"
"082850","우리바이오","183636700420","3890","47207378","48456578","1249200","2024-09"
"215360","우리산업","109951242520","12040","9132163","9132163","0","2024-09"
"072470","우리산업홀딩스","57878629385","3065","18883729","18887341","3612","2024-09"
"073560","우리손에프앤지","96724987271","1397","69237643","69237643","0","2024-09"
"037400","우리엔터프라이즈","32593123584","1344","24250836","26223346","1972510","2024-09"
"153490","우리이앤엘","43852079700","867","50579100","51480000","900900","2024-09"
"101170","우림피티에스","72032115900","5450","13216902","13500000","283098","2024-09"
"006980","우성","43018830560","16760","2566756","3090000","523244","2024-09"
"066590","우수AMS","118547876905","3065","38677937","39073104","395167","2024-09"
"017370","우신시스템","129362704640","8320","15548402","18314054","2765652","2024-09"
"103840","우양","65874872700","4025","16366428","16366428","0","2024-09"
"046940","우원개발","42745837750","2365","18074350","18074350","0","2024-09"
"215380","우정바이오","36078630120","2295","15720536","15879576","159040","2024-09"
"065680","우주일렉트로","119451679060","14860","8038471","9530000","1491529","2024-09"
"105840","우진","169440958800","8550","19817656","20323614","505958","2024-09"
"018620","우진비앤지","30042657840","1040","28887171","28889293","2122","2024-09"
"010400","우진아이엔에스","23994681240","3560","6740079","7622000","881921","2024-09"
"457550","우진엔텍","197479520700","21300","9271339","9271339","0","2024-09"
"049800","우진플라임","46200000000","2310","20000000","20000000","0","2024-09"
"016880","웅진","71187348536","916","77715446","79927080","2211634","2024-09"
"095720","웅진씽크빅","196068574860","1740","112683089","115505985","2822896","2024-09"
"396470","워트","151850400000","9420","16120000","16120000","0","2024-09"
"005820","원림","33258941100","16170","2056830","2297970","241140","2024-09"
"307280","원바이오젠","47604602276","1342","35472878","36959013","1486135","2024-09"
"032940","원익","71772099045","3945","18193181","18193230","49","2024-09"
"240810","원익IPS","1418313363500","29150","48655690","49083901","428211","2024-09"
"074600","원익QnC","609881600000","23200","26288000","26288000","0","2024-09"
"104830","원익머트리얼즈","278636800000","22100","12608000","12608000","0","2024-09"
"014190","원익큐브","56384348103","1593","35395071","35399906","4835","2024-09"
"217820","원익피앤이","131619825050","2975","44241958","47454559","3212601","2024-09"
"030530","원익홀딩스","178354316675","2335","76383005","77237981","854976","2024-09"
"012620","원일특강","32868000000","7470","4400000","4400000","0","2024-09"
"382840","원준","225560822850","14850","15189281","15271581","82300","2024-09"
"336570","원텍","532447482960","5960","89336826","89340619","3793","2024-09"
"376980","원티드랩","41480495655","4645","8930139","9754994","824855","2024-09"
"008370","원풍","53189706570","4870","10921911","12000000","1078089","2024-09"
"008290","원풍물산","21895557556","548","39955397","40693679","738282","2024-09"
"101160","월덱스","321469033710","19470","16510993","16510993","0","2024-09"
"336060","웨이버스","68380384000","1420","48155200","48155200","0","2024-09"
"095270","웨이브일렉트로","58189968480","4560","12760958","14971256","2210298","2024-09"
"010600","웰바이오텍","49552926545","545","90922801","90923407","606","2024-09"
"065950","웰크론","62666998300","2300","27246521","28231302","984781","2024-09"
"076080","웰크론한텍","33307977429","1509","22072881","22594156","521275","2024-09"
"043590","웰킵스하이텍","20294833280","760","26703728","27136762","433034","2024-09"
"196700","웹스","19305409536","1344","14364144","14364144","0","2024-09"
"069080","웹젠","492390478650","16710","29466815","34950884","5484069","2024-09"
"053580","웹케시","93090502960","7280","12787157","13636248","849091","2024-09"
"071460","위니아","21802751835","613","35567295","35967295","400000","2024-09"
"377460","위니아에이드","26030247855","1691","15393405","15393405","0","2024-09"
"044340","위닉스","97850925760","6190","15807904","17873425","2065521","2024-09"
"330350","위더스제약","97677632000","7400","13199680","13202139","2459","2024-09"
"348350","위드텍","78384272000","8020","9773600","10183600","410000","2024-09"
"112040","위메이드","1152998650300","34300","33615121","33948483","333362","2024-09"
"101730","위메이드맥스","341690335650","10350","33013559","33295292","281733","2024-09"
"123420","위메이드플레이","80816088570","7770","10401041","11469842","1068801","2024-09"
"065370","위세아이텍","31322373940","4510","6945094","7383954","438860","2024-09"
"038620","위즈코프","38082585906","606","62842551","66546465","3703914","2024-09"
"299900","위지윅스튜디오","224327814416","1324","169431884","171048884","1617000","2024-09"
"036090","위지트","84802767765","719","117945435","118392284","446849","2024-09"
"136540","윈스","153419171040","12410","12362544","13644162","1281618","2024-09"
"097800","윈팩","177004348080","1520","116450229","116450229","0","2024-09"
"192390","윈하이텍","41514965800","3800","10924991","10924991","0","2024-09"
"008600","윌비스","28359537090","431","65799390","67236039","1436649","2024-09"
"335870","윙스풋","19066865346","1143","16681422","16681422","0","2024-09"
"033270","유나이티드제약","319234537300","21700","14711269","16333822","1622553","2024-09"
"014830","유니드","457422208100","68900","6638929","6767600","128671","2024-09"
"446070","유니드비티플러스","45195450300","4420","10225215","10611215","386000","2024-09"
"036200","유니셈","199440839340","6780","29416053","30664223","1248170","2024-09"
"018000","유니슨","120736751388","717","168391564","168391564","0","2024-09"
"000910","유니온","66583555035","4265","15611619","15611619","0","2024-09"
"047400","유니온머티리얼","100170000000","2385","42000000","42000000","0","2024-09"
"203450","유니온커뮤니티","32817404295","2665","12314223","14079007","1764784","2024-09"
"011330","유니켐","136568964560","1520","89848003","96997167","7149164","2024-09"
"077500","유니퀘스트","99468469710","4605","21600102","21794015","193913","2024-09"
"011320","유니크","79021642550","4090","19320695","19320695","0","2024-09"
"086390","유니테스트","185638619210","9130","20332817","21134126","801309","2024-09"
"241690","유니테크노","92743975740","3790","24470706","24470706","0","2024-09"
"142210","유니트론텍","95212653710","5030","18928957","19246092","317135","2024-09"
"088340","유라클","54515556120","12590","4330068","4330068","0","2024-09"
"048430","유라테크","76162130800","6650","11452952","11520000","67048","2024-09"
"206650","유바이오로직스","459966925130","12590","36534307","36534307","0","2024-09"
"089850","유비벨록스","98773654700","6790","14546930","14730199","183269","2024-09"
"084440","유비온","17997786400","913","19712800","19712800","0","2024-09"
"032620","유비케어","195359171700","3850","50742642","52197139","1454497","2024-09"
"264450","유비쿼스","132873069040","13360","9945589","10245706","300117","2024-09"
"078070","유비쿼스홀딩스","161661428060","9790","16512914","18150700","1637786","2024-09"
"002920","유성기업","52833850000","2060","25647500","25947500","300000","2024-09"
"024800","유성티엔에스","66296872080","1985","33398928","37051812","3652884","2024-09"
"000700","유수홀딩스","128129330680","5230","24498916","26041812","1542896","2024-09"
"054930","유신","66900000000","22300","3000000","3000000","0","2024-09"
"069330","유아이디","17591791877","1247","14107291","14191091","83800","2024-09"
"049520","유아이엘","109063173600","5100","21384936","21784936","400000","2024-09"
"435380","유안타제10호스팩","12004350000","2095","5730000","5730000","0","2024-09"
"444920","유안타제11호스팩","10820600000","2065","5240000","5240000","0","2024-09"
"446150","유안타제12호스팩","9754650000","2045","4770000","4770000","0","2024-09"
"449020","유안타제13호스팩","19654600000","2020","9730000","9730000","0","2024-09"
"450940","유안타제14호스팩","9579400000","2110","4540000","4540000","0","2024-09"
"473050","유안타제15호스팩","14230300000","2030","7010000","7010000","0","2024-09"
"474490","유안타제16호스팩","11185300000","2030","5510000","5510000","0","2024-09"
"430700","유안타제9호스팩","11030200000","2105","5240000","5240000","0","2024-09"
"003470","유안타증권","564552701790","2930","192680103","199596576","6916473","2024-09"
"263770","유에스티","50317090260","2140","23512659","23700172","187513","2024-09"
"072130","유엔젤","60247575360","5040","11953884","13195454","1241570","2024-09"
"000220","유유제약","75411256180","4660","16182673","17032351","849678","2024-09"
"388720","유일로보틱스","385980725800","33700","11453434","11453434","0","2024-09"
"340930","유일에너테크","81509635500","2390","34104450","34204450","100000","2024-09"
"023410","유진기업","239200471330","3490","68538817","77310863","8772046","2024-09"
"056080","유진로봇","216820238560","5780","37512152","37512152","0","2024-09"
"468760","유진스팩10호","9031200000","2130","4240000","4240000","0","2024-09"
"442130","유진스팩9호","7750400000","2240","3460000","3460000","0","2024-09"
"084370","유진테크","784072447500","35250","22243190","22916042","672852","2024-09"
"240600","유진테크놀로지","46622806000","6800","6856295","6928151","71856","2024-09"
"001200","유진투자증권","380673256025","4145","91839145","96866418","5027273","2024-09"
"221800","유투바이오","41085393440","3640","11287196","11287196","0","2024-09"
"179900","유티아이","352821523900","22300","15821593","16286895","465302","2024-09"
"263050","유틸렉스","92723097600","2520","36794880","36798858","3978","2024-09"
"000100","유한양행","11807029600000","160000","73793935","80209064","6415129","2024-09"
"003460","유화증권","102493451200","2240","45756005","56702415","10946410","2024-09"
"191410","육일씨엔에쓰","19002416480","1696","11204255","11204255","0","2024-09"
"372170","윤성에프앤씨","421293734400","52800","7979048","7979048","0","2024-09"
"146060","율촌","29897354055","1245","24013939","24015595","1656","2024-09"
"008730","율촌화학","647280000000","26100","24800000","24800000","0","2024-09"
"072770","율호","153821754360","2190","70238244","70238244","0","2024-09"
"008250","이건산업","52144256400","5100","10224364","10952635","728271","2024-09"
"039020","이건홀딩스","70392468250","3250","21659221","22584709","925488","2024-09"
"025820","이구산업","158509339860","4740","33440789","33442000","1211","2024-09"
"067920","이글루","53191506520","5080","10470769","10996119","525350","2024-09"
"044960","이글벳","62970221610","5130","12274897","12641883","366986","2024-09"
"303530","이노뎁","55400844100","7790","7111790","7339299","227509","2024-09"
"296640","이노룰스","29673742240","5870","5055152","5178252","123100","2024-09"
"302430","이노메트리","94344240000","9600","9827525","9833208","5683","2024-09"
"214320","이노션","800000000000","20000","40000000","40000000","0","2024-09"
"462350","이노스페이스","189389018800","20200","9375694","9375694","0","2024-09"
"274400","이노시뮬레이션","42305258660","5410","7819826","7819826","0","2024-09"
"056090","이노시스","122874650850","1306","94084725","94084725","0","2024-09"
"073490","이노와이어리스","129417458920","17020","7603846","7603846","0","2024-09"
"215790","이노인스트루먼트","19255000584","478","40282428","40283149","721","2024-09"
"344860","이노진","22301670000","1865","11958000","12030000","72000","2024-09"
"088390","이녹스","110565124520","11780","9385834","9385844","10","2024-09"
"272290","이녹스첨단소재","458706705800","23800","19273391","20227658","954267","2024-09"
"053350","이니텍","67419938580","4020","16771129","19790916","3019787","2024-09"
"452400","이닉스","109945707360","12120","9071428","9071428","0","2024-09"
"264850","이랜시스","181161779760","5980","30294612","30294612","0","2024-09"
"054210","이랜텍","142352959320","5720","24886881","25291210","404329","2024-09"
"009730","이렘","46090523479","1001","46044479","46056774","12295","2024-09"
"164060","이루다","148702994160","7090","20973624","21200934","227310","2024-06"
"065440","이루온","35345036286","1337","26436078","27275020","838942","2024-09"
"139480","이마트","1666235556600","62200","26788353","27875819","1087466","2024-09"
"115610","이미지스","58859846325","3735","15758995","15758995","0","2024-09"
"478110","이베스트스팩6호","10140400000","2020","5020000","5020000","0","2024-09"
"131400","이브이첨단소재","135855336720","2280","59585674","59589882","4208","2024-09"
"351330","이삭엔지니어링","67965864000","8200","8288520","8288520","0","2024-09"
"080010","이상네트웍스","50466227560","5320","9486133","9835071","348938","2024-09"
"457190","이수스페셜티케미컬","1332261692500","44500","29938465","30208280","269815","2024-09"
"086890","이수앱지스","238749184450","6650","35902133","35902133","0","2024-09"
"007660","이수페타시스","2751219226500","43500","63246419","63246419","0","2024-09"
"005950","이수화학","178839138600","8100","22078906","22722739","643833","2024-09"
"015020","이스타코","26212506366","674","38890959","42851600","3960641","2024-09"
"047560","이스트소프트","133299291730","12970","10277509","11603992","1326483","2024-09"
"239340","이스트에이드","47079335690","1745","26979562","26979634","72","2024-09"
"067010","이씨에스","32117121000","2820","11389050","12294000","904950","2024-09"
"093230","이아이디","354065768064","1392","254357592","254384360","26768","2024-09"
"418620","이에이트","149485888730","15490","9650477","9650477","0","2024-09"
"456070","이엔셀","267929363250","25150","10653255","10653255","0","2024-09"
"102710","이엔에프테크놀로지","261181642080","18280","14287836","14287836","0","2024-09"
"074610","이엔플러스","115932071820","1580","73374729","73374729","0","2024-09"
"041520","이엘씨","67264195750","5750","11698121","12188730","490609","2024-09"
"063760","이엘피","21675833300","2455","8829260","9325130","495870","2024-09"
"123570","이엠넷","54130182015","2535","21353129","22276078","922949","2024-09"
"083470","이엠앤아이","29255662062","1371","21338922","21340329","1407","2024-09"
"095190","이엠코리아","98117306380","2165","45319772","45319772","0","2024-09"
"091120","이엠텍","427365068000","26000","16437118","17132936","695818","2024-09"
"102460","이연제약","302993171320","16520","18340991","18586811","245820","2024-09"
"039030","이오테크닉스","2033161704000","168000","12102153","12319550","217397","2024-09"
"294090","이오플로우","187179302850","6150","30435659","30435659","0","2024-09"
"088290","이원컴포텍","38349441432","1224","31331243","31331669","426","2024-09"
"084680","이월드","243897682160","1720","141800978","141806193","5215","2024-09"
"353810","이지바이오","116228742000","3475","33447120","34191720","744600","2024-09"
"099750","이지케어텍","113986701440","16960","6720914","6834776","113862","2024-09"
"377330","이지트로닉스","48403814400","6120","7909120","8139954","230834","2024-09"
"035810","이지홀딩스","168707297685","2615","64515219","65145845","630626","2024-09"
"160600","이큐셀","106346383500","3100","34305285","34482552","177267","2024-09"
"092130","이크레더블","153315028000","12730","12043600","12043600","0","2024-09"
"096040","이트론","245561522409","271","906131079","906131295","216","2024-09"
"134060","이퓨쳐","15405584940","4005","3846588","4769250","922662","2024-09"
"001840","이화공영","48816283190","2465","19803766","19805760","1994","2024-09"
"000760","이화산업","33880000000","12100","2800000","2800000","0","2024-09"
"024810","이화전기","196810080587","899","218921113","218948640","27527","2024-09"
"014990","인디에프","56407602490","751","75109990","75112995","3005","2024-09"
"041830","인바디","310038958600","23800","13026847","13683782","656935","2024-09"
"352940","인바이오","24995779000","2300","10867730","10867730","0","2024-09"
"101140","인바이오젠","93257770480","9340","9984772","10044216","59444","2024-09"
"079950","인베니아","17214100000","790","21790000","23200000","1410000","2024-09"
"389470","인벤티지랩","205657517000","20500","10032074","10032074","0","2024-09"
"277410","인산가","53072000256","1408","37693182","38356789","663607","2024-09"
"060150","인선이엔티","257732198250","5750","44822991","46563612","1740621","2024-09"
"033230","인성정보","102719557050","2050","50107101","50515380","408279","2024-09"
"450520","인스웨이브시스템즈","50951362770","3465","14704578","14704578","0","2024-09"
"006490","인스코비","233376272610","1970","118465113","119368998","903885","2024-09"
"465480","인스피언","208331214600","20550","10137772","10137772",,"자료 없음"
"037330","인지디스플레","63555938272","1576","40327372","43885224","3557852","2024-09"
"100030","인지소프트","46123976900","16790","2747110","3283714","536604","2024-09"
"023800","인지컨트롤스","97079660800","6400","15168697","15809197","640500","2024-09"
"034590","인천도시가스","105935374300","25700","4121999","4374754","252755","2024-09"
"211050","인카금융서비스","251534090650","5150","48841571","51379800","2538229","2024-09"
"083640","인콘","27143133952","352","77111176","77720351","609175","2024-09"
"064090","인크레더블버즈","208910839200","4200","49740676","49742745","2069","2024-09"
"216050","인크로스","83646416700","6930","12070190","12843222","773032","2024-09"
"049070","인탑스","330064087250","20750","15906703","17200000","1293297","2024-09"
"119610","인터로조","312050211300","24900","12532137","13216478","684341","2024-09"
"017250","인터엠","20792094609","1027","20245467","21045467","800000","2024-09"
"129260","인터지스","62494302380","2215","28214132","29747874","1533742","2024-09"
"051370","인터플렉스","240272961600","10300","23327472","23327472","0","2024-09"
"064290","인텍플러스","169277779840","13660","12392224","12863962","471738","2024-09"
"189300","인텔리안테크","556863530400","53400","10428156","10733334","305178","2024-09"
"150840","인트로메딕","251537720850","5850","42997901","42997901","0","2024-09"
"048530","인트론바이오","196648251750","6010","32720175","34150762","1430587","2024-09"
"023810","인팩","73200000000","7320","10000000","10000000","0","2024-09"
"115310","인포바인","42851020000","20000","2142551","3192883","1050332","2024-09"
"039290","인포뱅크","50880167100","6100","8341011","8693978","352967","2024-09"
"071200","인피니트헬스케어","111766037005","4585","24376453","24396458","20005","2024-09"
"101930","인화정공","246625115100","25950","9503858","9615733","111875","2024-09"
"249420","일동제약","403902012360","14460","27932366","28062501","130135","2024-09"
"000230","일동홀딩스","92030533500","8150","11292090","11540400","248310","2024-09"
"013360","일성건설","67477075120","1249","54024880","54024880","0","2024-09"
"003120","일성아이에스","108096573780","15860","6815673","13300000","6484327","2024-09"
"333430","일승","91428423420","2980","30680679","30726747","46068","2024-09"
"068330","일신바이오","52679422112","1264","41676758","44216140","2539382","2024-09"
"003200","일신방직","172323552900","8090","21300810","23280000","1979190","2024-09"
"007110","일신석재","101741719140","1314","77429010","77456610","27600","2024-09"
"007570","일양약품","237780461520","13230","17972824","19085664","1112840","2024-09"
"178780","일월지엠엘","124101377000","8650","14346980","14349195","2215","2024-09"
"008500","일정실업","14923822710","12630","1181617","1200000","18383","2024-09"
"019540","일지테크","55098735420","4170","13213126","13513500","300374","2024-09"
"081000","일진다이아","179322381900","12630","14198130","14202975","4845","2024-09"
"020760","일진디스플","47643539882","926","51450907","51513741","62834","2024-09"
"103590","일진전기","1256296038150","26350","47677269","47685390","8121","2024-09"
"094820","일진파워","145509541850","9650","15078709","15078709","0","2024-09"
"271940","일진하이솔루스","746236054500","20550","36313190","36313190","0","2024-09"
"015860","일진홀딩스","180263305040","3920","45985537","49347483","3361946","2024-09"
"226320","잇츠한불","215099723850","12210","17616685","21929315","4312630","2024-09"
"049550","잉크테크","75092040910","3830","19606277","19606277","0","2024-09"
"389020","자람테크놀로지","207901852200","33900","6132798","6197730","64932","2024-09"
"254120","자비스","59090215080","1924","30712170","30754270","42100","2024-09"
"043910","자연과환경","71095187658","627","113389454","113391457","2003","2024-09"
"234920","자이글","50681341775","3775","13425521","13530910","105389","2024-09"
"289220","자이언트스텝","167019174750","7550","22121745","22121745","0","2024-09"
"317400","자이에스앤디","152450080000","4000","38112520","38782520","670000","2024-09"
"033240","자화전자","350036232000","16600","21086520","22155870","1069350","2024-09"
"174880","장원테크","11454988050","2650","4322637","4381265","58628","2024-09"
"049630","재영솔루텍","53120425255","635","83654213","83654213","0","2024-09"
"417840","저스템","56879893120","8020","7092256","7249175","156919","2024-09"
"000950","전방","22048744500","19350","1139470","1680000","540530","2024-09"
"079900","전진건설로봇","245866263600","16930","14522520","15360574","838054","2024-09"
"110020","전진바이오팜","22556317380","2490","9058762","9058762","0","2024-09"
"208140","정다운","84325328880","2580","32684236","32684246","10","2024-09"
"040420","정상제이엘에스","96803048160","6480","14938742","15677552","738810","2024-09"
"045510","정원엔시스","27859761945","885","31479957","32209292","729335","2024-09"
"217190","제너셈","69451858080","7920","8769174","8769174","0","2024-09"
"095700","제넥신","408407508440","8980","45479678","45540494","60816","2024-09"
"072520","제넨바이오","28838655818","389","74135362","74163194","27832","2024-09"
"122310","제노레이","82507281840","6120","13481582","14553844","1072262","2024-09"
"361390","제노코","110411614080","14720","7500789","7500789","0","2024-09"
"187420","제노포커스","73748749515","3115","23675361","23675361","0","2024-09"
"225220","제놀루션","54709755750","3030","18056025","19190021","1133996","2024-09"
"123330","제닉","188183698300","24050","7824686","7968680","143994","2024-09"
"381620","제닉스","124620240000","28500","4372640","4372640","0","2024-09"
"159580","제로투세븐","86641150700","4325","20032636","20032636","0","2024-09"
"147830","제룡산업","125253942660","6540","19151979","20000000","848021","2024-09"
"033100","제룡전기","947682131000","59000","16062409","16062409","0","2024-09"
"079370","제우스","382309694060","12460","30682961","31016990","334029","2024-09"
"054950","제이브이엠","241301429600","20950","11517968","12089892","571924","2024-09"
"023440","제이스코홀딩스","97127829050","1655","58687510","58687510","0","2024-09"
"090470","제이스텍","93691085400","5400","17350201","17476594","126393","2024-09"
"287410","제이시스메디칼","960860460300","12900","74485307","75692193","1206886","2024-06"
"137950","제이씨케미칼","100904877425","4675","21583931","22267814","683883","2024-09"
"033320","제이씨현시스템","70372517475","3725","18891951","19114432","222481","2024-09"
"417500","제이아이테크","115192730880","3645","31602944","32784744","1181800","2024-09"
"204270","제이앤티씨","1361086610850","23850","57068621","57848466","779845","2024-09"
"194370","제이에스코퍼레이션","211366023300","15870","13318590","13335601","17011","2024-09"
"026040","제이에스티나","24881689503","1737","14324519","16503790","2179271","2024-09"
"452160","제이엔비","57796348970","6010","9616697","9617527","830","2024-09"
"126880","제이엔케이글로벌","88038867400","3800","23168123","23204903","36780","2024-09"
"322510","제이엘케이","192268189440","12120","15863712","16195712","332000","2024-09"
"033050","제이엠아이","29928968320","940","31839328","32579342","740014","2024-09"
"094970","제이엠티","56319891580","3370","16712134","16748240","36106","2024-09"
"418550","제이오","534423376110","18070","29575173","31772273","2197100","2024-09"
"025620","제이준코스메틱","23311405180","5210","4474358","4484846","10488","2024-09"
"420570","제이투케이바이오","98564016000","17250","5713856","5732807","18951","2024-09"
"089790","제이티","44553210000","4875","9139120","10315513","1176393","2024-09"
"030000","제일기획","1838208858750","18150","101278725","115041225","13762500","2024-09"
"052670","제일바이오","56184286080","2080","27011676","29129064","2117388","2024-09"
"271980","제일약품","217261318470","14910","14571517","14704872","133355","2024-09"
"412540","제일엠앤에스","231345467950","11230","20600665","20600665","0","2024-09"
"001560","제일연마","57170400000","8400","6806000","9900000","3094000","2024-09"
"199820","제일일렉트릭","216645000000","9750","22220000","22220000","0","2024-09"
"038010","제일테크노스","55966680000","6730","8316000","9000000","684000","2024-09"
"002620","제일파마홀딩스","136778523750","8910","15351125","15973355","622230","2024-09"
"276730","제주맥주","30569846375","2575","11871785","11886605","14820","2024-09"
"080220","제주반도체","429796407040","12760","33683104","34442833","759729","2024-09"
"006220","제주은행","264741097760","8240","32128774","32128774","0","2024-09"
"089590","제주항공","729168554550","9050","80571111","80640985","69874","2024-09"
"216080","제테마","350567439170","19630","17858759","17858759","0","2024-09"
"229000","젠큐릭스","38110012500","2500","15244005","15244005","0","2024-09"
"082270","젬백스","793598320000","20000","39679916","39994174","314258","2024-09"
"044060","조광ILI","70075958688","732","95732184","95732184","0","2024-09"
"004910","조광페인트","63351914020","6190","10234558","12800000","2565442","2024-09"
"004700","조광피혁","186528457500","52500","3552923","6649138","3096215","2024-09"
"001550","조비","56071742400","10800","5191828","5192239","411","2024-09"
"462520","조선내화","199776399240","16860","11849134","11855168","6034","2024-09"
"120030","조선선재","90853273000","93800","968585","1257651","289066","2024-09"
"034940","조아제약","42907060395","1385","30979827","30979827","0","2024-09"
"067000","조이시티","117018368604","1674","69903446","69903446","0","2024-09"
"018470","조일알미늄","211854869233","1673","126631721","126631721","0","2024-09"
"002600","조흥","103800000000","173000","600000","600000","0","2024-09"
"185750","종근당","1433198388800","113600","12616183","13174420","558237","2024-09"
"063160","종근당바이오","167321749500","30500","5485959","5485962","3","2024-09"
"001630","종근당홀딩스","288965870600","60700","4760558","5009861","249303","2024-09"
"033340","좋은사람들","62533109910","645","96950558","96950558","0","2024-09"
"036930","주성엔지니어링","1295151995400","27400","47268321","47268321","0","2024-09"
"109070","주성코퍼레이션","216476814300","4100","52799223","52810230","11007","2024-09"
"044380","주연테크","23148053981","359","64479259","66403852","1924593","2024-09"
"072020","중앙백신","102274254720","10670","9585216","9658687","73471","2024-09"
"000440","중앙에너비스","99761287500","22500","4433835","6227130","1793295","2024-09"
"051980","중앙첨단소재","1291565012500","12950","99734750","99961003","226253","2024-09"
"228760","지노믹트리","422705773440","17620","23990112","24362333","372221","2024-09"
"314130","지놈앤컴퍼니","126725239500","4100","30908595","30908595","0","2024-09"
"013890","지누스","423545244250","20750","20411819","20735204","323385","2024-09"
"389030","지니너스","50728156245","1521","33351845","33351845","0","2024-09"
"043610","지니뮤직","138605319630","2385","58115438","58115438","0","2024-09"
"263860","지니언스","86268690000","10000","8626869","9444600","817731","2024-09"
"303030","지니틱스","44813134608","1254","35736152","35745668","9516","2024-09"
"036180","지더블유바이텍","53929030348","577","93464524","93464524","0","2024-09"
"208350","지란지교시큐리티","23591856420","3015","7824828","8838549","1013721","2024-09"
"144510","지씨셀","559009645200","37200","15027141","15800344","773203","2024-09"
"358570","지아이이노베이션","656192315240","14840","44217811","44217811","0","2024-09"
"382480","지아이텍","92004972795","2355","39067929","39357140","289211","2024-09"
"382800","지앤비에스 에코","106596608170","3370","31631041","31631041","0","2024-09"
"051160","지어소프트","140039605200","9640","14526930","15474430","947500","2024-09"
"053050","지에스이","109604667035","3655","29987597","29987597","0","2024-09"
"119850","지엔씨에너지","80839012740","5420","14914947","16448909","1533962","2024-09"
"065060","지엔코","35055012850","325","107861578","108008044","146466","2024-09"
"204840","지엘팜텍","85704682390","1115","76865186","76865206","20","2024-09"
"013870","지엠비코리아","74477253400","3905","19072280","19072280","0","2024-09"
"071320","지역난방공사","527990726400","45600","11578744","11578744","0","2024-09"
"270520","지오릿에너지","159425949144","1004","158790786","158790786","0","2024-09"
"311320","지오엘리먼트","86662027200","6870","12614560","12614560","0","2024-09"
"388050","지투파워","105402337650","5650","18655281","18709437","54156","2024-09"
"088790","진도","22941192192","1843","12447744","12447744","0","2024-09"
"018120","진로발효","116935889880","17670","6617764","6621120","3356","2024-09"
"109820","진매트릭스","74865611250","3750","19964163","20393640","429477","2024-09"
"086060","진바이오텍","30137054500","3500","8610587","8610587","0","2024-09"
"036890","진성티이씨","172674650880","8640","19985492","22482268","2496776","2024-09"
"363250","진시스템","67570392960","9960","6784176","7006491","222315","2024-09"
"003780","진양산업","84500000000","6500","13000000","13000000","0","2024-09"
"007370","진양제약","65151732240","5740","11350476","12574867","1224391","2024-09"
"010640","진양폴리","67700000000","6770","10000000","10000000","0","2024-09"
"100250","진양홀딩스","178026505020","3185","55895292","55895292","0","2024-09"
"051630","진양화학","42265000000","2675","15800000","15800000","0","2024-09"
"272450","진에어","551925220140","10710","51533634","52200000","666366","2024-09"
"285800","진영","44392220080","2540","17477252","17477270","18","2024-09"
"011000","진원생명과학","189595231125","2375","79829571","80039035","209464","2024-09"
"002780","진흥기업","116330891200","800","145413614","145471745","58131","2024-09"
"085660","차바이오텍","1008028529700","17900","56314443","56314443","0","2024-09"
"261780","차백신연구소","109713219320","4090","26824748","26824748","0","2024-09"
"351870","차이커뮤니케이션","119756002400","10760","11129740","11131089","1349","2024-09"
"009310","참엔지니어링","33252183176","394","84396404","84867419","471015","2024-09"
"094850","참좋은여행","64116147430","4790","13385417","14000000","614583","2024-09"
"004650","창해에탄올","72079834500","9500","7587351","9190885","1603534","2024-09"
"278280","천보","558066000000","56200","9930000","10000000","70000","2024-09"
"000650","천일고속","58081097800","40700","1427054","1429220","2166","2024-09"
"362320","청담글로벌","135230161920","6720","20123536","20551290","427754","2024-09"
"012600","청호ICT","116119947330","2490","46634517","46634517","0","2024-09"
"066360","체리부로","37402571700","780","47952015","47952015","0","2024-09"
"033250","체시스","43584000000","1362","32000000","32000000","0","2024-09"
"047820","초록뱀미디어","131865872400","5400","24419606","24453930","34324","2024-09"
"094360","칩스앤미디어","274081947500","13550","20227450","20823124","595674","2024-09"
"016920","카스","29046845058","1182","24574319","26493538","1919219","2024-09"
"284620","카이노스메드","144587081600","5200","27805208","28180793","375585","2024-09"
"035720","카카오","17291773421200","39400","438877498","443530908","4653410","2024-09"
"293490","카카오게임즈","1426824248480","17440","81813317","82667326","854009","2024-09"
"323410","카카오뱅크","10695882752350","22450","476431303","476963637","532334","2024-09"
"377300","카카오페이","3500015636000","26000","134615986","134615986","0","2024-09"
"140430","카티스","51818577120","3240","15993388","17922947","1929559","2024-09"
"042000","카페24","621378943300","25700","24178169","24253054","74885","2024-09"
"006380","카프로","618528628380","3660","168996893","168999996","3103","2024-09"
"313760","캐리","55909489440","7640","7317996","7417913","99917","2024-09"
"317530","캐리소프트","27742381040","4040","6866926","6971196","104270","2024-09"
"071850","캐스텍코리아","53010149530","2185","24260938","24529188","268250","2024-09"
"050110","캠시스","80709268902","1102","73238901","73824118","585217","2024-09"
"452300","캡스톤파트너스","39681309700","2815","14096380","14096380","0","2024-09"
"451760","컨텍","148722503460","10090","14739594","14940476","200882","2024-09"
"078340","컴투스","438596006400","38400","11421771","12737755","1315984","2024-09"
"063080","컴투스홀딩스","145088900000","22000","6594950","6595192","242","2024-09"
"307930","컴퍼니케이","79611000000","5100","15610000","15610000","0","2024-09"
"079190","케스피온","22900814912","608","37665814","38355514","689700","2024-09"
"263700","케어랩스","58199937000","3000","19399979","19414200","14221","2024-09"
"214370","케어젠","826042228860","16860","48994201","53715000","4720799","2024-09"
"221980","케이디켐","47185500600","12600","3744881","4034800","289919","2024-09"
"038530","케이바이오","31184147070","270","115496841","115714347","217506","2024-09"
"001620","케이비아이동국실업","63214441608","568","111293031","111293031","0","2024-09"
"424140","케이비제21호스팩","16692150000","2165","7710000","7710000","0","2024-09"
"192250","케이사인","65517422949","957","68461257","70671257","2210000","2024-09"
"431190","케이쓰리아이","44469465480","5940","7486442","7486442","0","2024-09"
"029460","케이씨","228756391930","19690","11617897","13554044","1936147","2024-09"
"115500","케이씨에스","83280000000","6940","12000000","12000000","0","2024-09"
"281820","케이씨텍","719063932400","35900","20029636","20861556","831920","2024-09"
"089150","케이씨티","39187750000","2285","17150000","17150000","0","2024-09"
"025880","케이씨피드","43961603760","2785","15785136","16715858","930722","2024-09"
"093320","케이아이엔엑스","357925938000","74000","4836837","4880000","43163","2024-09"
"093640","케이알엠","156078892800","4790","32584320","32584320","0","2024-09"
"073010","케이에스피","163483127520","4080","40069394","40191250","121856","2024-09"
"105330","케이엔더블유","66100228495","4165","15870403","16060028","189625","2024-09"
"053080","케이엔솔","206688011200","15950","12958496","12999807","41311","2024-09"
"199430","케이엔알시스템","86506995480","7960","10867713","10867713","0","2024-09"
"432470","케이엔에스","142522955080","16430","8674556","8674556","0","2024-09"
"272110","케이엔제이","133930258350","16730","8005395","8005395","0","2024-09"
"039420","케이엘넷","55675013430","2605","21372366","24154730","2782364","2024-09"
"083550","케이엠","38636340600","3350","11533236","12374226","840990","2024-09"
"032500","케이엠더블유","302240501970","7590","39820883","39820883","0","2024-09"
"225430","케이엠제약","20357518030","730","27887011","27887050","39","2024-09"
"102370","케이옥션","126852621000","4900","25888290","27229210","1340920","2024-09"
"068100","케이웨더","34118041530","3505","9734106","9939614","205508","2024-09"
"381970","케이카","627330590460","13020","48182073","48182073","0","2024-09"
"036030","케이티알파","207841157840","4240","49019141","49019283","142","2024-09"
"064820","케이프","145647020160","5220","27901728","30901728","3000000","2024-09"
"256940","케이피에스","108179756660","5770","18748658","18748658","0","2024-09"
"024880","케이피에프","81174869270","4195","19350386","20682798","1332412","2024-09"
"042040","케이피엠테크","54950563080","315","174446232","174460917","14685","2024-09"
"054410","케이피티유","22419028260","3915","5726444","5726444","0","2024-09"
"258610","케일럼","41968056942","1582","26528481","26787133","258652","2024-09"
"274090","켄코아에어로스페이스","128486598700","9950","12913226","12913226","0","2024-09"
"089010","켐트로닉스","298108620000","20000","14905431","15334346","428915","2024-09"
"220260","켐트로스","133322625840","5020","26558292","26558307","15","2024-09"
"052400","코나아이","197602727520","13530","14604784","14899999","295215","2024-09"
"402030","코난테크놀로지","171220675600","14950","11452888","11452888","0","2024-09"
"391710","코닉오토메이션","89433508540","2155","41500468","41503222","2754","2024-09"
"046070","코다코","144219271360","10280","14029112","14064588","35476","2024-09"
"047770","코데즈컴바인","53490700003","1417","37749259","37842602","93343","2024-09"
"080530","코디","68613136440","1590","43152916","43300427","147511","2024-09"
"104540","코렌텍","85280885800","6670","12785740","12785740","0","2024-09"
"027050","코리아나","79560000000","2600","30600000","40000000","9400000","2024-09"
"007810","코리아써키트","249907545580","10580","23620751","23620751","0","2024-09"
"190650","코리아에셋투자증권","36028320000","5640","6388000","6388000","0","2024-09"
"123410","코리아에프티","148949665650","5350","27841059","27841064","5","2024-09"
"003690","코리안리","1287118177240","8740","147267526","165367526","18100000","2024-09"
"036690","코맥스","45885746130","2885","15904938","15904938","0","2024-09"
"049430","코메론","100624944000","11200","8984370","9048000","63630","2024-09"
"183300","코미코","533766884000","51800","10304380","10460684","156304","2024-09"
"041960","코미팜","305884709900","4415","69283060","70622233","1339173","2024-09"
"089890","코세스","151861184960","9260","16399696","16584962","185266","2024-09"
"360350","코셈","43560729600","7680","5671970","5671970","0","2024-09"
"082660","코스나인","47827116000","480","99639825","99640869","1044","2024-09"
"192820","코스맥스","1637179026600","144300","11345662","11349509","3847","2024-09"
"044820","코스맥스비티아이","82649357350","8650","9554839","9603921","49082","2024-09"
"222040","코스맥스엔비티","61870056360","3010","20554836","20628000","73164","2024-09"
"241710","코스메카코리아","812748000000","76100","10680000","10680000","0","2024-09"
"005070","코스모신소재","3513141467600","108100","32498996","32510756","11760","2024-09"
"005420","코스모화학","847852333900","22100","38364359","38408228","43869","2024-09"
"355150","코스텍시스","61024935280","8080","7552591","7797350","244759","2024-09"
"071950","코아스","32479406400","9870","3290720","3290720","0","2024-09"
"166480","코아스템켐온","365645536290","15010","24360129","32870376","8510247","2024-09"
"045970","코아시아","112354477890","4530","24802313","26314876","1512563","2024-09"
"196450","코아시아씨엠","41819534133","923","45308271","45319582","11311","2024-09"
"384470","코어라인소프트","99189079650","7730","12831705","12832064","359","2024-09"
"029960","코엔텍","357554099200","7360","48580720","50000000","1419280","2024-09"
"002020","코오롱","183335705520","14520","12626426","12626426","0","2024-09"
"138490","코오롱ENP","223440000000","5880","38000000","38000000","0","2024-09"
"003070","코오롱글로벌","174438562750","9250","18858223","18932713","74490","2024-09"
"450140","코오롱모빌리티그룹","144435169110","2355","61331282","62777250","1445968","2024-09"
"102940","코오롱생명과학","237535159440","19120","12423387","12423387","0","2024-09"
"120110","코오롱인더","892768650950","32450","27512131","27519091","6960","2024-09"
"021240","코웨이","4839484650900","67300","71909133","73799619","1890486","2024-09"
"033290","코웰패션","131679712640","2485","52989824","56156301","3166477","2024-09"
"056360","코위버","45178395840","4880","9257868","9796800","538932","2024-09"
"282880","코윈테크","155977855320","14280","10922819","11141807","218988","2024-09"
"121850","코이즈","29243821608","963","30367416","30614175","246759","2024-09"
"448710","코츠테크놀로지","91651287350","20650","4438319","5166069","727750","2024-09"
"126730","코칩","107193839830","13090","8188987","8503460","314473","2024-09"
"015710","코콤","66889686110","4030","16597937","17530500","932563","2024-09"
"052330","코텍","99572909040","7920","12572337","15574552","3002215","2024-09"
"322780","코퍼스코리아","34496591250","935","36894750","37932613","1037863","2024-09"
"036420","콘텐트리중앙","201553076350","10550","19104557","19262308","157751","2024-09"
"200130","콜마비앤에이치","421321427240","14470","29116892","29415558","298666","2024-09"
"024720","콜마홀딩스","241102700770","7030","34296259","34296259","0","2024-09"
"031820","콤텍시스템","68394078290","565","121051466","121051466","0","2024-09"
"294570","쿠콘","142463028510","13970","10197783","10254685","56902","2024-09"
"192400","쿠쿠홀딩스","721018532000","23200","31078385","35562185","4483800","2024-09"
"284740","쿠쿠홈시스","523562573000","23350","22422380","22437330","14950","2024-09"
"317690","퀀타매트릭스","131307043340","7940","16537411","16537411","0","2024-09"
"078940","퀀타피아","151577916950","2855","53092090","53094278","2188","2024-09"
"227100","퀀텀온","18816736800","1200","15680614","15680614","0","2024-09"
"432720","퀄리타스반도체","140731970480","10190","13810792","13810792","0","2024-09"
"365270","큐라클","81440192160","5870","13873968","13873968","0","2024-09"
"348080","큐라티스","34185280110","811","42152010","42152010","0","2024-09"
"060280","큐렉소","291738929000","7100","41089990","41089990","0","2024-09"
"372320","큐로셀","459338075000","32600","14090125","14090125","0","2024-09"
"051780","큐로홀딩스","18871240202","139","135764318","136422450","658132","2024-09"
"115180","큐리언트","185006125860","5730","32287282","32292671","5389","2024-09"
"445680","큐리옥스바이오시스템즈","405637797600","25200","16096738","16096738","0","2024-09"
"182360","큐브엔터","193333460160","13920","13888898","14571557","682659","2024-09"
"405100","큐알티","165084150000","14000","11791725","12289301","497576","2024-09"
"066310","큐에스아이","63026964750","7050","8939995","9271621","331626","2024-09"
"016600","큐캐피탈","50436286358","289","174520022","178247112","3727090","2024-09"
"355390","크라우드웍스","51460219090","12190","4221511","4224606","3095","2024-09"
"264900","크라운제과","101656789740","8460","12016169","12523850","507681","2024-09"
"005740","크라운해태홀딩스","85289618550","5930","14382735","14847347","464612","2024-09"
"259960","크래프톤","15590183147000","343000","45452429","47897003","2444574","2024-09"
"096240","크레버스","133198234530","15790","8435607","11138180","2702573","2024-09"
"040350","크레오에스지","106781053632","704","151677633","152074086","396453","2024-09"
"110790","크리스에프앤씨","133874425370","6610","20253317","23430960","3177643","2024-09"
"045520","크린앤사이언스","32358930000","5290","6117000","6500000","383000","2024-09"
"036170","클라우드에어","53039983040","880","60272708","61365626","1092918","2024-09"
"214150","클래시스","3961570226100","61900","63999519","63999519","0","2024-09"
"352770","클리노믹스","24990638400","650","38447136","38886113","438977","2024-09"
"237880","클리오","451259042250","25750","17524623","18071353","546730","2024-09"
"139670","키네마스터","40591578750","2875","14118810","14118810","0","2024-09"
"020120","키다리스튜디오","135280650800","3650","37063192","37063766","574","2024-09"
"413600","키움제6호스팩","9363900000","2730","3430000","3430000","0","2024-09"
"433530","키움제7호스팩","9297825000","2265","4105000","4105000","0","2024-09"
"446840","키움제8호스팩","13083000000","2225","5880000","5880000","0","2024-09"
"039490","키움증권","3284278232100","136100","24131361","25526706","1395345","2024-09"
"054780","키이스트","86558943950","4430","19539265","19547793","8528","2024-09"
"219130","타이거일렉","134810091500","21350","6314290","6314290","0","2024-09"
"360070","탑머티리얼","283839074800","35450","8006744","8076743","69999","2024-09"
"065130","탑엔지니어링","63457151640","4090","15515196","17189982","1674786","2024-09"
"134580","탑코미디어","50867747500","2350","21645850","22025767","379917","2024-09"
"014580","태경비케이","124123950000","4500","27583100","27583100","0","2024-09"
"015890","태경산업","151989500000","5200","29228750","29228750","0","2024-09"
"006890","태경케미컬","127846380720","11280","11333899","11600000","266101","2024-09"
"023160","태광","348690422160","13480","25867242","26500000","632758","2024-09"
"003240","태광산업","552109936000","656000","841631","1113400","271769","2024-09"
"011280","태림포장","148004110150","2150","68839121","70805940","1966819","2024-09"
"323280","태성","1143858339000","44300","25820730","25820730","0","2024-09"
"053620","태양","50552546850","6350","7961031","8600000","638969","2024-09"
"004100","태양금속","112913966000","3100","36423860","36700000","276140","2024-09"
"009410","태영건설","1330097939940","4620","287899987","287905337","5350","2024-09"
"044490","태웅","295108869750","14750","20007381","20007381","0","2024-09"
"124560","태웅로직스","104334824840","2885","36164584","38416584","2252000","2024-09"
"001420","태원물산","28122465345","3835","7333107","7600000","266893","2024-09"
"191420","테고사이언스","120739015280","15080","8006566","8108834","102268","2024-09"
"073640","테라사이언스","59577565530","654","91097195","95587404","4490209","2024-09"
"066700","테라젠이텍스","118419902300","3700","32005379","32474435","469056","2024-09"
"095610","테스","292061412900","16650","17541226","19768226","2227000","2024-09"
"055490","테이팩스","81751801000","17140","4769650","4769650","0","2024-09"
"064520","테크엘","52288521480","2340","22345522","22351062","5540","2024-09"
"089030","테크윙","1345628846100","37650","35740474","37353645","1613171","2024-09"
"054450","텔레칩스","194406268320","13170","14761296","15144233","382937","2024-09"
"078000","텔코웨어","50607229400","9800","5164003","9240077","4076074","2024-09"
"200230","텔콘RF제약","69143885125","575","120250235","120250235","0","2024-09"
"214420","토니모리","197913950280","8280","23902651","24054799","152148","2024-09"
"393210","토마토시스템","102280025750","6650","15380455","15614544","234089","2024-09"
"215480","토박스코리아","23566041360","2630","8960472","9400000","439528","2024-09"
"051360","토비스","311573402400","20400","15273206","16167058","893852","2024-09"
"045340","토탈소프트","44330647200","5180","8558040","8558040","0","2024-09"
"108230","톱텍","200760089880","5510","36435588","38023245","1587657","2024-09"
"079970","투비소프트","9077156655","1085","8366043","9290500","924457","2024-09"
"199800","툴젠","433760308800","54600","7944328","7946828","2500","2024-09"
"417790","트루엔","95157674190","9090","10468391","10999650","531259","2024-09"
"290090","트윔","58812272400","8400","7001461","7432268","430807","2024-09"
"026150","특수건설","96504820500","5500","17546331","17546331","0","2024-09"
"464280","티디에스팜","85620815000","16190","5288500","5530000","241500","2024-09"
"322180","티라유텍","98621265750","5970","16519475","16519475","0","2024-09"
"117730","티로보틱스","137880473800","7730","17837060","17837060","0","2024-09"
"033830","티비씨","80071695550","847","94535650","100000000","5464350","2024-09"
"057680","티사이언티픽","69111045970","970","71248501","71248501","0","2024-09"
"204610","티쓰리","80297156310","1370","58611063","63851720","5240657","2024-09"
"064760","티씨케이","1025065000000","87800","11675000","11675000","0","2024-09"
"246710","티앤알바이오팹","152120605680","7060","21546828","21546828","0","2024-09"
"340570","티앤엘","598943216200","74200","8072011","8128000","55989","2024-09"
"043220","티에스넥스젠","80226238664","572","140255662","140255662","0","2024-09"
"277880","티에스아이","128626108160","6380","20160832","20160832","0","2024-09"
"131290","티에스이","560847040000","52000","10785520","11061429","275909","2024-09"
"019180","티에이치엔","58410000000","3245","18000000","18000000","0","2024-09"
"425420","티에프이","194436090000","17190","11311000","11381000","70000","2024-09"
"131100","티엔엔터테인먼트","42710270299","1523","28043513","28048252","4739","2024-09"
"356860","티엘비","122157875000","12500","9772630","9832630","60000","2024-09"
"062860","티엘아이","42843237000","5800","7386765","9872720","2485955","2024-09"
"363280","티와이홀딩스","122677406775","3465","35404735","50429268","15024533","2024-09"
"321550","티움바이오","165261880550","6350","26025493","26025493","0","2024-09"
"091810","티웨이항공","621851660650","2890","215173585","215378976","205391","2024-09"
"004870","티웨이홀딩스","67971211056","609","111611184","111611693","509","2024-09"
"425040","티이엠씨","196512233970","9290","21153093","21316062","162969","2024-09"
"241790","티이엠씨씨엔에스","57794950150","5950","9713437","10002634","289197","2024-09"
"104480","티케이케미칼","130889424960","1440","90895434","90895434","0","2024-09"
"081150","티플랙스","73897284090","3045","24268402","24268402","0","2024-09"
"130740","티피씨글로벌","21820373865","1935","11276679","11276679","0","2024-09"
"084730","팅크웨어","106888309200","10200","10479246","11109424","630178","2024-09"
"440110","파두","953073336600","19350","49254436","49334436","80000","2024-09"
"034230","파라다이스","913692238500","10580","86360325","91771623","5411298","2024-09"
"033540","파라텍","54673528851","1461","37421991","37751063","329072","2024-09"
"388870","파로스아이바이오","129180310380","9990","12930962","12930962","0","2024-09"
"043200","파루","22944209868","549","41792732","41804315","11583","2024-09"
"214450","파마리서치","2342961300000","226500","10344200","10464152","119952","2024-09"
"208340","파멥신","233760977175","2915","80192445","80201108","8663","2024-09"
"005690","파미셀","315021073500","5250","60004014","60016964","12950","2024-09"
"177830","파버나인","37362473780","3140","11898877","14288753","2389876","2024-09"
"037070","파세코","120432275550","6030","19972185","20000000","27815","2024-09"
"150900","파수","56475805000","5000","11295161","11676422","381261","2024-09"
"037030","파워넷","52277284990","2390","21873341","21878974","5633","2024-09"
"047310","파워로직스","191108141100","5220","36610755","36610755","0","2024-09"
"368770","파이버프로","136498389375","4175","32694225","32854225","160000","2024-09"
"170790","파이오링크","53507673090","8010","6680109","6856330","176221","2024-09"
"049120","파인디앤씨","55657663676","1193","46653532","46653532","0","2024-09"
"038950","파인디지털","32475773880","3960","8200953","10210765","2009812","2024-09"
"441270","파인엠텍","251044992870","6790","36972753","36987901","15148","2024-09"
"106240","파인테크닉스","16697198824","1052","15871862","15923057","51195","2024-09"
"131760","파인텍","34614971651","797","43431583","43431583","0","2024-09"
"065690","파커스","14130538820","1060","13330697","14049331","718634","2024-09"
"140860","파크시스템스","1453515609000","209500","6938022","6983609","45587","2024-09"
"091700","파트론","362818136100","7140","50814865","58918214","8103349","2024-09"
"032800","판타지오","37249153971","163","228522417","229785294","1262877","2024-09"
"318010","팜스빌","47527925700","6150","7728118","7929338","201220","2024-09"
"036580","팜스코","75990874120","2170","35018836","36727943","1709107","2024-09"
"027710","팜스토리","146326791303","1323","110602261","111416600","814339","2024-09"
"004720","팜젠사이언스","88506681200","4880","18136615","18178525","41910","2024-09"
"225590","패션플랫폼","22892552508","894","25606882","26636713","1029831","2024-09"
"054300","팬스타엔터프라이즈","32879214998","491","66963778","66985895","22117","2024-09"
"068050","팬엔터테인먼트","58005152205","2145","27042029","27694076","652047","2024-09"
"028670","팬오션","1897721767600","3550","534569512","534569512","0","2024-09"
"222110","팬젠","56388534020","4940","11414683","11414683","0","2024-09"
"271830","팸텍","64138020735","2235","28697101","29490202","793101","2024-09"
"010820","퍼스텍","143597743335","2955","48594837","48771938","177101","2024-09"
"016800","퍼시스","392411545200","43850","8948952","11500000","2551048","2024-09"
"263750","펄어비스","2309369816000","37600","61419410","64247855","2828445","2024-09"
"251970","펌텍코리아","455020766200","36700","12398386","12400000","1614","2024-09"
"001020","페이퍼코리아","137533305586","773","177921482","177983313","61831","2024-09"
"168360","펨트론","141141322920","6630","21288284","21288284","0","2024-09"
"087010","펩트론","1965713649500","95500","20583389","20657350","73961","2024-09"
"090080","평화산업","54737552223","997","54902259","54902259","0","2024-09"
"010770","평화홀딩스","40073256385","2785","14388961","14625466","236505","2024-09"
"064800","포니링크","188443494200","1495","126049160","127807298","1758138","2024-09"
"119500","포메탈","32698360320","2760","11847232","11847232","0","2024-09"
"389140","포바이포","63676554460","5770","11035798","11112735","76937","2024-09"
"105760","포스뱅크","65936095450","6970","9459985","9459985","0","2024-09"
"022100","포스코DX","4114390264900","27100","151822519","152034729","212210","2024-09"
"058430","포스코스틸리온","228840538000","38200","5990590","6000000","9410","2024-09"
"009520","포스코엠텍","677475624930","16270","41639559","41642703","3144","2024-09"
"047050","포스코인터내셔널","8760846631800","51400","170444487","175922788","5478301","2024-09"
"003670","포스코퓨처엠","18081134144000","233500","77435264","77463220","27956","2024-09"
"189690","포시에스","62412431730","2290","27254337","27321969","67632","2024-09"
"318020","포인트모바일","53966400760","4330","12463372","12662272","198900","2024-09"
"256630","포인트엔지니어링","76951881344","1352","56917072","57997072","1080000","2024-09"
"331380","포커스에이치엔에스","79988904880","3590","22281032","22725452","444420","2024-09"
"472850","폰드그룹","215034247050","6650","32335977","32343933","7956","2024-09"
"039980","폴라리스AI","169383734125","2375","71319467","72152777","833310","2024-09"
"041910","폴라리스AI파마","89731243140","7190","12480006","12698263","218257","2024-09"
"234100","폴라리스세원","72206333651","1327","54413213","54413213","0","2024-09"
"041020","폴라리스오피스","241463233980","4860","49683793","49725498","41705","2024-09"
"114630","폴라리스우노","40504157603","533","75992791","77757548","1764757","2024-09"
"290720","푸드나무","39654483175","3175","12489601","13403058","913457","2024-09"
"005670","푸드웰","48084110700","5100","9428257","10000000","571743","2024-09"
"094940","푸른기술","49642539640","6280","7904863","8361386","456523","2024-09"
"057880","푸른소나무","215672327790","8790","24536101","24580368","44267","2024-09"
"007330","푸른저축은행","102885093600","8780","11718120","15082800","3364680","2024-09"
"017810","풀무원","389645662350","10570","36863355","38120542","1257187","2024-09"
"093380","풍강","28141431570","2935","9588222","9879313","291091","2024-08"
"023900","풍국주정","129402000000","10270","12600000","12600000","0","2024-09"
"103140","풍산","1920193743400","70300","27314278","28024278","710000","2024-09"
"005810","풍산홀딩스","395607802000","28250","14003816","14417292","413476","2024-09"
"371950","풍원정밀","246173709600","11700","21040488","21040488","0","2024-09"
"370090","퓨런티어","124445634300","15210","8181830","8181830","0","2024-09"
"445180","퓨릿","112521251480","6710","16769188","16769188","0","2024-09"
"151910","퓨처코어","121645902080","640","190071722","190071722","0","2024-09"
"220100","퓨쳐켐","612084905600","27700","22096928","22102155","5227","2024-09"
"035200","프럼파스트","23827590020","2815","8464508","9730590","1266082","2024-09"
"334970","프레스티지바이오로직스","448345709010","7290","61501469","61501469","0","2024-09"
"321260","프로이천","61881556335","2195","28192053","28192084","31","2024-09"
"053610","프로텍","288450000000","32050","9000000","11000000","2000000","2024-09"
"303360","프로티아","37665853875","2925","12877215","12877215","0","2024-09"
"377220","프롬바이오","59026350000","2085","28310000","28310000","0","2024-09"
"335810","프리시젼바이오","41812293600","3600","11614526","11614526","0","2024-09"
"053160","프리엠스","66031306880","12320","5359684","6000000","640316","2024-09"
"405000","플라즈맵","51632151120","1980","26076844","26076844","0","2024-09"
"041590","플래스크","103917099150","789","131707350","131707350","0","2024-09"
"367000","플래티어","39785725090","4910","8102999","8388207","285208","2024-09"
"075130","플랜티넷","32307214650","2075","15569742","16622320","1052578","2024-09"
"009810","플레이그램","53005381865","349","151877885","151887500","9615","2024-09"
"237820","플레이디","71960255400","5610","12827140","12827140","0","2024-09"
"023770","플레이위드","39100017200","4460","8766820","8766820","0","2024-09"
"019570","플루토스","21405629424","408","52464778","52470042","5264","2024-09"
"300080","플리토","91797645500","16700","5496865","5501817","4952","2024-09"
"033790","피노","205006284000","9030","22702800","22822800","120000","2024-09"
"032580","피델릭스","54307611080","1640","33114397","33132064","17667","2024-09"
"051380","피씨디렉트","39619493240","2680","14783393","15340072","556679","2024-09"
"241820","피씨엘","63964896327","1081","59171967","59171967","0","2024-09"
"237750","피앤씨테크","30728918000","4730","6496600","6496600","0","2024-09"
"460940","피앤에스미캐닉스","84715076600","13090","6471740","6471740","0","2024-09"
"319660","피에스케이","614094336800","21200","28966714","28966714","0","2024-09"
"031980","피에스케이홀딩스","1071651031500","49700","21562395","21562395","0","2024-09"
"002230","피에스텍","59915649375","3625","16528455","19370673","2842218","2024-09"
"043370","피에이치에이","197090119170","10090","19533213","21000000","1466787","2024-09"
"239890","피엔에이치테크","74518162500","7500","9935755","9935755","0","2024-09"
"347740","피엔케이피부임상연구센타","72204477500","2500","28881791","30010576","1128785","2024-09"
"137400","피엔티","1234433541600","53100","23247336","23743086","495750","2024-09"
"257370","피엔티엠에스","67199765030","5470","12285149","12504861","219712","2024-09"
"147760","피엠티","37815431670","3495","10819866","10819866","0","2024-09"
"128660","피제이메탈","83463336685","3365","24803369","24803369","0","2024-09"
"006140","피제이전자","79081800000","5320","14865000","15000000","135000","2024-09"
"376180","피코그램","54545260770","2965","18396378","18491378","95000","2024-09"
"304840","피플바이오","80235622670","3815","21031618","21089464","57846","2024-09"
"087600","픽셀플러스","45295766190","6990","6480081","8166558","1686477","2024-09"
"291810","핀텔","23737618080","2090","11357712","11357712","0","2024-09"
"378340","필에너지","356538523500","16750","21285882","21285882","0","2024-09"
"161580","필옵틱스","512829391000","22450","22843180","22843180","0","2024-09"
"347770","핌스","52799767020","2310","22857042","22857042","0","2024-09"
"163730","핑거","112536695250","12250","9186669","9360608","173939","2024-09"
"417180","핑거스토리","46532960500","2780","16738475","16739405","930","2024-09"
"446750","하나26호스팩","12964500000","2150","6030000","6030000","0","2024-09"
"448370","하나27호스팩","11970600000","2130","5620000","5620000","0","2024-09"
"454750","하나28호스팩","15124200000","2100","7202000","7202000","0","2024-09"
"454640","하나29호스팩","11531135000","2135","5401000","5401000","0","2024-09"
"469880","하나30호스팩","15084825000","2065","7305000","7305000","0","2024-09"
"469900","하나31호스팩","11686425000","2085","5605000","5605000","0","2024-09"
"475240","하나32호스팩","6944000000","2170","3200000","3200000","0","2024-09"
"475250","하나33호스팩","7899500000","2135","3700000","3700000","0","2024-09"
"406760","하나금융21호스팩","15375750000","2075","7410000","7410000","0","2024-09"
"418170","하나금융22호스팩","13702800000","2280","6010000","6010000","0","2024-09"
"435620","하나금융25호스팩","44654760000","10380","4302000","4302000","0","2024-09"
"086790","하나금융지주","18028257013800","64900","277785162","287240880","9455718","2024-09"
"299030","하나기술","227854935000","28500","7994910","7994910","0","2024-09"
"067310","하나마이크론","729110896640","11090","65744896","65744896","0","2024-09"
"166090","하나머티리얼즈","572945847600","29400","19487954","19777674","289720","2024-09"
"293480","하나제약","190467340860","11010","17299486","17772946","473460","2024-09"
"039130","하나투어","774496600000","50000","15489932","16039185","549253","2024-09"
"136480","하림","301571596880","2840","106187182","106209702","22520","2024-09"
"003380","하림지주","508675976630","5230","97261181","112005621","14744440","2024-09"
"450330","하스","67624757670","8630","7836009","7836009","0","2024-09"
"101670","하이드로리튬","87917340060","1782","49336330","51086330","1750000","2024-09"
"365590","하이딥","128419284590","890","144291331","144447309","155978","2024-09"
"149980","하이로닉","119641631000","7160","16709725","18594363","1884638","2024-09"
"013030","하이록코리아","295308686000","24400","12102815","12856050","753235","2024-09"
"352820","하이브","8063857447100","194300","41502097","41652097","150000","2024-09"
"126700","하이비젼시스템","214993333590","16890","12729031","14942112","2213081","2024-09"
"106080","하이소닉","100227866830","6370","15734359","15735465","1106","2024-09"
"071090","하이스틸","66403882790","3290","20183551","20191471","7920","2024-09"
"450050","하이제8호스팩","10604610000","2115","5014000","5014000","0","2024-09"
"160190","하이젠알앤엠","232028160000","8320","27888000","30888000","3000000","2024-09"
"221840","하이즈항공","35044851314","1874","18700561","18700561","0","2024-09"
"106190","하이텍팜","158957340100","14950","10632598","10633173","575","2024-09"
"019490","하이트론","108708473300","3620","30029965","30044269","14304","2024-09"
"000080","하이트진로","1379853482700","20100","68649427","70133611","1484184","2024-09"
"000140","하이트진로홀딩스","195716434680","9160","21366423","23206765","1840342","2024-09"
"065650","하이퍼코퍼레이션","143790592500","1350","106511550","106681728","170178","2024-09"
"066130","하츠","64465835070","5370","12004811","12800000","795189","2024-09"
"004590","한국가구","55425000000","3695","15000000","15000000","0","2024-09"
"036460","한국가스공사","3565201478900","40850","87275434","92313000","5037566","2024-09"
"039340","한국경제TV","115045586780","5410","21265358","23000000","1734642","2024-09"
"005430","한국공항","171259816000","56000","3058211","3166355","108144","2024-09"
"071050","한국금융지주","4118877865300","78100","52738513","55725992","2987479","2024-09"
"034950","한국기업평가","380512296300","85300","4460871","4540514","79643","2024-09"
"010040","한국내화","78315995420","2210","35437102","41067062","5629960","2024-09"
"025540","한국단자","769499000000","74600","10315000","10415000","100000","2024-09"
"222980","한국맥널티","43663696320","4020","10861616","11031483","169867","2024-09"
"010100","한국무브넥스","111448537200","3660","30450420","30450420","0","2024-09"
"256840","한국비엔씨","361456186880","5440","66444152","67912443","1468291","2024-09"
"219750","한국비티비","63245329550","967","65403650","65426885","23235","2024-09"
"004090","한국석유","218022748300","17300","12602471","12694120","91649","2024-09"
"025550","한국선재","62275862160","2815","22122864","23300000","1177136","2024-09"
"002200","한국수출포장","98308611465","2645","37167717","40000000","2832283","2024-09"
"002960","한국쉘석유","419900000000","323000","1300000","1300000","0","2024-09"
"017890","한국알콜","189341455600","9200","20580593","21605760","1025167","2024-09"
"000240","한국앤컴퍼니","1567585283200","16550","94718144","94935240","217096","2024-09"
"080720","한국유니온제약","15410411825","2725","5655197","7912828","2257631","2024-09"
"123890","한국자산신탁","360370976975","2945","122367055","123977752","1610697","2024-09"
"015760","한국전력","13641736636250","21250","641964077","641964077","0","2024-09"
"063570","한국전자금융","154381573120","5090","30330368","34147728","3817360","2024-09"
"041460","한국전자인증","66056538750","3490","18927375","19000000","72625","2024-09"
"006200","한국전자홀딩스","32541068154","742","43855887","46803136","2947249","2024-09"
"101680","한국정밀기계","20502756360","2440","8402769","8404000","1231","2024-09"
"039740","한국정보공학","21248752050","2650","8018397","8018397","0","2024-09"
"053300","한국정보인증","164288972000","4000","41072243","42441361","1369118","2024-09"
"025770","한국정보통신","293520508020","8220","35708091","37444271","1736180","2024-09"
"458610","한국제12호스팩","9242550000","2185","4230000","4230000","0","2024-09"
"464440","한국제13호스팩","9309600000","2155","4320000","4320000","0","2024-09"
"477530","한국제14호스팩","10942750000","2275","4810000","4810000","0","2024-09"
"479880","한국제15호스팩","14014800000","2040","6870000","6870000","0","2024-09"
"027970","한국제지","190721172160","1003","190150720","190178237","27517","2024-09"
"023350","한국종합기술","46037323875","4425","10403915","10950000","546085","2024-09"
"025890","한국주강","22110918144","1984","11144616","11309259","164643","2024-09"
"000970","한국주철관","138745756500","6450","21510970","22800500","1289530","2024-09"
"104700","한국철강","274327944000","8000","34290993","42450000","8159007","2024-09"
"062970","한국첨단소재","20279580495","2055","9868409","9868409","0","2024-09"
"017960","한국카본","542379560920","11020","49217746","51908452","2690706","2024-09"
"023760","한국캐피탈","179200349475","573","312740575","315609576","2869001","2024-09"
"054040","한국컴퓨터","67772454360","5010","13527436","16071290","2543854","2024-09"
"161890","한국콜마","1671239451600","70800","23605077","23605077","0","2024-09"
"021650","한국큐빅","39812718050","2450","16250089","16350563","100474","2024-09"
"161390","한국타이어앤테크놀로지","4586777112800","37600","121988753","123875069","1886316","2024-09"
"034830","한국토지신탁","227296820265","1055","215447223","252489230","37042007","2024-09"
"007280","한국특강","94503885294","1554","60813311","60813311","0","2024-09"
"032300","한국파마","235039406550","21550","10906701","10906701","0","2024-09"
"037230","한국팩키지","59392051711","1993","29800327","29800327","0","2024-09"
"047810","한국항공우주","5429363459900","55700","97475107","97475107","0","2024-09"
"123690","한국화장품","112469497000","7000","16067071","16068000","929","2024-09"
"003350","한국화장품제조","296888073300","81900","3625007","4532000","906993","2024-09"
"030520","한글과컴퓨터","426266506050","17710","24069255","24179744","110489","2024-09"
"052600","한네트","48047173500","4155","11563700","11563700","0","2024-09"
"011500","한농화성","290892260400","19020","15294020","15637042","343022","2024-09"
"002390","한독","213610032160","15520","13763533","13763533","0","2024-09"
"256150","한독크린텍","55272782900","7100","7784899","8395000","610101","2024-09"
"092460","한라IMS","105253299200","6440","16343680","17109680","766000","2024-09"
"053690","한미글로벌","147996052500","14550","10171550","10957550","786000","2024-09"
"042700","한미반도체","9711154803000","101500","95676402","96993634","1317232","2024-09"
"008930","한미사이언스","2403836563000","35500","67713706","68391550","677844","2024-09"
"128940","한미약품","4381013937000","345500","12680214","12810991","130777","2024-09"
"452190","한빛레이저","114646400550","4950","23160889","23162757","1868","2024-09"
"047080","한빛소프트","34478260818","1389","24822362","24822362","0","2024-09"
"009240","한샘","853256550800","51400","16600322","23533928","6933606","2024-09"
"452280","한선엔지니어링","162373875000","9550","17002500","17002500","0","2024-09"
"020000","한섬","351148851900","16350","21476994","23398500","1921506","2024-09"
"003680","한성기업","29143963800","5160","5648055","6209515","561460","2024-09"
"066980","한성크린텍","113471966250","2185","51932250","51935125","2875","2024-09"
"105630","한세실업","628156282050","15950","39382839","40000000","617161","2024-09"
"069640","한세엠케이","43515185090","1586","27437065","30106502","2669437","2024-09"
"016450","한세예스24홀딩스","194436628650","4950","39280127","40000000","719873","2024-09"
"010420","한솔PNS","21661113684","1057","20493012","20493012","0","2024-09"
"009180","한솔로지스틱스","63393754840","2260","28050334","28057025","6691","2024-09"
"114810","한솔아이원스","197581119450","7150","27633723","29113174","1479451","2024-09"
"070590","한솔인티큐브","15616210068","1143","13662476","13879521","217045","2024-09"
"213500","한솔제지","223978096560","9420","23776868","23800576","23708","2024-09"
"014680","한솔케미칼","1463373674500","129100","11335195","11335195","0","2024-09"
"004710","한솔테크닉스","138237074800","4400","31417517","32109878","692361","2024-09"
"004150","한솔홀딩스","95181756080","2320","41026619","42008577","981958","2024-09"
"025750","한솔홈데코","57684646684","716","80565149","80565149","0","2024-09"
"226440","한송네오텍","100580954580","1530","65739186","65739186","0","2024-09"
"042520","한스바이오메드","120519165120","9280","12986979","13526367","539388","2024-09"
"004960","한신공영","80184964860","6930","11570702","11570702","0","2024-09"
"011700","한신기계","110462105665","3415","32346151","32446151","100000","2024-09"
"430690","한싹","54204137400","4975","10895304","10895327","23","2024-09"
"078350","한양디지텍","181018805400","12200","14837607","15244382","406775","2024-09"
"045100","한양이엔지","284892054540","16970","16787982","18000000","1212018","2024-09"
"001750","한양증권","159361245680","12520","12728534","12728534","0","2024-09"
"018880","한온시스템","2017266665400","3780","533668430","533800000","131570","2024-09"
"009420","한올바이오파마","2510158860000","49500","50710280","52240638","1530358","2024-09"
"320000","한울반도체","80261338010","2870","27965623","27965627","4","2024-09"
"091440","한울소재과학","72929828100","5190","14051990","14606671","554681","2024-09"
"014130","한익스프레스","41713000000","3535","11800000","12000000","200000","2024-09"
"024740","한일단조","71054510800","2275","31232752","31532546","299794","2024-09"
"005860","한일사료","166480569125","4225","39403685","39403685","0","2024-09"
"300720","한일시멘트","1000136637600","14440","69261540","69261540","0","2024-09"
"002220","한일철강","48683126260","1999","24353740","26697460","2343720","2024-09"
"006390","한일현대시멘트","264982383120","13710","19327672","19327672","0","2024-09"
"003300","한일홀딩스","411291462960","13340","30831444","30832884","1440","2024-09"
"007770","한일화학","42857100000","12210","3510000","3510000","0","2024-09"
"051600","한전KPS","2040750000000","45350","45000000","45000000","0","2024-09"
"052690","한전기술","2739132360000","72000","38043505","38220000","176495","2024-09"
"130660","한전산업","440100000000","13500","32600000","32600000","0","2024-09"
"198940","한주라이트메탈","38841110104","998","38918948","38922978","4030","2024-09"
"058450","한주에이알티","35809052320","2480","14439134","14452469","13335","2024-09"
"107640","한중엔시에스","382567441500","42750","8948946","8948946","0","2024-09"
"002320","한진","284465002820","19660","14469227","14947628","478401","2024-09"
"003480","한진중공업홀딩스","89617446240","3435","26089504","29529812","3440308","2024-09"
"180640","한진칼","6174600450900","93100","66322239","66762279","440040","2024-09"
"005110","한창","22551214950","1254","17983425","18606407","622982","2024-09"
"079170","한창산업","40169711190","7770","5169847","5200000","30153","2024-09"
"009460","한창제지","45347289360","760","59667486","59667486","0","2024-09"
"372910","한컴라이프케어","112634832420","4070","27674406","27674406","0","2024-09"
"054920","한컴위드","63440463150","2550","24878613","28217081","3338468","2024-09"
"002680","한탑","22394128878","722","31016799","32316799","1300000","2024-09"
"000880","한화","1904372078400","27450","69376032","74958735","5582703","2024-09"
"452260","한화갤러리아","264893472043","1367","193777229","193859610","82381","2024-09"
"088350","한화생명","2175274773750","2895","751390250","868530000","117139750","2024-09"
"000370","한화손해보험","576945925740","4990","115620426","116738915","1118489","2024-09"
"009830","한화솔루션","3615585756650","21350","169348279","171892536","2544257","2024-09"
"272210","한화시스템","3478074654600","18600","186993261","188919389","1926128","2024-09"
"012450","한화에어로스페이스","17345488062000","381500","45466548","45581161","114613","2024-09"
"082740","한화엔진","1326466006500","15900","83425535","83447142","21607","2024-09"
"042660","한화오션","9498312797000","31000","306397187","306413394","16207","2024-09"
"489790","한화인더스트리얼솔루션즈","1984875154800","39400","50377542","50488390","110848","2024-09"
"003530","한화투자증권","780626916200","3650","213870388","214547775","677387","2024-09"
"430460","한화플러스제3호스팩","12520800000","2115","5920000","5920000","0","2024-09"
"455310","한화플러스제4호스팩","10701900000","2115","5060000","5060000","0","2024-09"
"195870","해성디에스","487900000000","28700","17000000","17000000","0","2024-09"
"034810","해성산업","203586404400","6870","29634120","32556857","2922737","2024-09"
"059270","해성에어로보틱스","70744073650","6350","11140799","11140799","0","2024-09"
"076610","해성옵틱스","29463097783","1159","25421137","25453198","32061","2024-09"
"101530","해태제과식품","149824790300","5650","26517662","29116822","2599160","2024-09"
"220180","핸디소프트","60358880000","3110","19408000","19408000","0","2024-09"
"143210","핸즈코퍼레이션","42793966655","1991","21493705","21875747","382042","2024-09"
"214180","헥토이노베이션","154090388100","12450","12376738","13257185","880447","2024-09"
"234340","헥토파이낸셜","140188923980","16870","8309954","9453000","1143046","2024-09"
"084990","헬릭스미스","175668877720","3815","46046888","46092797","45909","2024-09"
"187660","현대ADM","80381130200","3800","21152929","21836250","683321","2024-09"
"000720","현대건설","3335105161750","29950","111355765","111355765","0","2024-09"
"170030","현대공업","81887021580","5460","14997623","15340000","342377","2024-09"
"453340","현대그린푸드","394359315250","11650","33850585","33880914","30329","2024-09"
"086280","현대글로비스","9090000000000","121200","75000000","75000000","0","2024-09"
"064350","현대로템","7170648650100","65700","109142293","109142293","0","2024-09"
"079430","현대리바트","162925036200","8100","20114202","20535282","421080","2024-09"
"012330","현대모비스","21962108892000","244000","90008643","92995094","2986451","2024-09"
"319400","현대무벡스","367864784380","3155","116597396","117741058","1143662","2024-09"
"048410","현대바이오","710775433200","17850","39819352","39821608","2256","2024-09"
"052260","현대바이오랜드","169500000000","5650","30000000","30000000","0","2024-09"
"069960","현대백화점","1015173389700","46450","21855186","23402441","1547255","2024-09"
"004560","현대비앤지스틸","195421390560","12960","15078811","15078811","0","2024-09"
"016790","현대사료","187340898626","994","188471729","188471729","0","2024-09"
"004310","현대약품","110815359520","4240","26135698","32000000","5864302","2024-08"
"041440","현대에버다임","139700604960","7830","17841712","17915944","74232","2024-09"
"039010","현대에이치티","45681720000","5880","7769000","8625000","856000","2024-09"
"017800","현대엘리베이","1608480512100","44550","36105062","39092385","2987323","2024-09"
"307950","현대오토에버","3803586189200","138700","27423116","27423982","866","2024-09"
"011210","현대위아","1281661200300","48100","26645763","27195083","549320","2024-09"
"090850","현대이지웰","120156586660","5060","23746361","23746361","0","2024-09"
"004020","현대제철","3512271231300","26700","131545739","133445785","1900046","2024-09"
"005440","현대지에프홀딩스","688317488915","4415","155904301","155904301","0","2024-09"
"005380","현대차","48309103797000","237000","203835881","209416191","5580310","2024-09"
"001500","현대차증권","286998686100","9050","31712562","31712562","0","2024-09"
"011760","현대코퍼레이션","220161006780","18330","12010966","13228966","1218000","2024-09"
"227840","현대코퍼레이션홀딩스","92892511530","10530","8821701","9100836","279135","2024-09"
"126560","현대퓨처넷","434554985475","3945","110153355","110202945","49590","2024-09"
"001450","현대해상","2383800800000","30400","78414500","89400000","10985500","2024-09"
"057050","현대홈쇼핑","547774837500","47850","11447750","12000000","552250","2024-09"
"460930","현대힘스","364645548720","10320","35333871","35333871","0","2024-09"
"092300","현우산업","54709791110","2990","18297589","18672816","375227","2024-09"
"138360","협진","41021087154","849","48316946","48348248","31302","2024-09"
"011080","형지I&C","15399702988","604","25496197","25503364","7167","2024-09"
"093240","형지엘리트","46184921332","1364","33859913","34164255","304342","2024-09"
"003010","혜인","53956581460","5020","10748323","12712747","1964424","2024-09"
"111110","호전실업","77066875440","8370","9207512","9749984","542472","2024-09"
"008770","호텔신라","1673801757100","45100","37113121","39248121","2135000","2024-09"
"060560","홈센타홀딩스","101805886416","802","126940008","127669525","729517","2024-09"
"064240","홈캐스트","94663852475","2755","34360745","35038012","677267","2024-09"
"039610","화성밸브","105665560000","10150","10410400","10410400","0","2024-09"
"378850","화승알앤에이","80520932640","4240","18990786","18993623","2837","2024-09"
"241590","화승엔터프라이즈","535003307080","8830","60589276","60589276","0","2024-09"
"006060","화승인더","203561819945","4115","49468243","55320000","5851757","2024-09"
"013520","화승코퍼레이션","84591986010","1905","44405242","50051252","5646010","2024-09"
"010690","화신","360341333170","10370","34748441","34920410","171969","2024-09"
"126640","화신정공","47185254860","1346","35055910","36373887","1317977","2024-09"
"133820","화인베스틸","27311940548","886","30826118","30826118","0","2024-09"
"127980","화인써키트","81338285580","6870","11839634","11840684","1050","2024-09"
"061250","화일약품","108377746008","1454","74537652","76877652","2340000","2024-09"
"010660","화천기계","62040000000","2820","22000000","22000000","0","2024-09"
"000850","화천기공","60720000000","27600","2200000","2200000","0","2024-09"
"016580","환인제약","207784822700","13610","15267070","18600070","3333000","2024-09"
"032560","황금에스티","91059871520","5360","16988782","17000000","11218","2024-09"
"004800","효성","819197876000","49000","16718324","16740407","22083","2024-09"
"094280","효성ITX","137317260600","12440","11038365","11558200","519835","2024-09"
"097870","효성오앤비","48760200000","6180","7890000","8490000","600000","2024-09"
"298040","효성중공업","3710728788500","398500","9311741","9324548","12807","2024-09"
"298020","효성티앤씨","1270970705000","294500","4315690","4327682","11992","2024-09"
"298000","효성화학","153068940000","40500","3779480","3791811","12331","2024-09"
"093370","후성","663909910840","6190","107255236","107255330","94","2024-09"
"081660","휠라홀딩스","2401708745700","40350","59521902","60095839","573937","2024-09"
"290270","휴네시온","33664325970","3630","9273919","9607672","333753","2024-09"
"005870","휴니드","102891251400","7860","13090490","14116015","1025525","2024-09"
"353190","휴럼","32210802362","818","39377509","39378420","911","2024-09"
"192410","휴림네트웍스","35267038400","2480","14220580","14235530","14950","2024-09"
"090710","휴림로봇","134121523392","1224","109576408","109623165","46757","2024-09"
"078590","휴림에이텍","30930590592","576","53698942","54210339","511397","2024-09"
"205470","휴마시스","179801451760","1589","113153840","129375009","16221169","2024-09"
"115160","휴맥스","74686304636","1732","43121423","43970124","848701","2024-09"
"028080","휴맥스홀딩스","33463847770","3065","10918058","12577506","1659448","2024-09"
"175140","휴먼테크놀로지","109082530440","5070","21515292","21515292","0","2024-09"
"200670","휴메딕스","323693776600","31400","10308719","11229930","921211","2024-09"
"079980","휴비스","92148896000","2800","32910320","34500000","1589680","2024-09"
"065510","휴비츠","99206402400","9120","10877895","12159371","1281476","2024-09"
"215090","휴센텍","149904424845","1505","99604269","99649272","45003","2024-09"
"005010","휴스틸","227280763375","4045","56188075","56188075","0","2024-09"
"263920","휴엠앤씨","49927946412","1018","49045134","49045134","0","2024-09"
"243070","휴온스","341919822900","28950","11810702","11979665","168963","2024-09"
"084110","휴온스글로벌","433063070800","35600","12164693","12621492","456799","2024-09"
"145020","휴젤","3151277103000","286500","10999222","12604033","1604811","2024-09"
"024060","흥구석유","253301032140","17420","14540817","15000000","459183","2024-09"
"010240","흥국","55076712600","4975","11070696","12322696","1252000","2024-09"
"189980","흥국에프엔비","68757899919","1777","38693247","40137827","1444580","2024-09"
"000540","흥국화재","217782566550","3390","64242645","64242645","0","2024-09"
"003280","흥아해운","482932332420","2010","240264842","240424899","160057","2024-09"
"037440","희림","60471450800","4790","12624520","13922475","1297955","2024-09"
"238490","힘스","49838730600","4490","11099940","11312236","212296","2024-09"