종목코드,종목명,자기주식 제외 시가총액(A*B),종가,자기주식 제외 발행주식수(B=C-D),총발행주식수(C),자기주식수(D),자기주식수 반영시점
"060310","3S","110598249930","2165","51084642","51084642","0","2024-09"
"095570","AJ네트웍스","214581284750","4795","44751050","45252759","501709","2024-09"
"006840","AK홀딩스","169330525100","12980","13045495","13247561","202066","2024-09"
"054620","APS","112650552800","6200","18169444","19894221","1724777","2024-09"
"265520","AP시스템","268710197260","17890","15020134","15281421","261287","2024-09"
"211270","AP위성","148451869230","10430","14233161","15082304","849143","2024-09"
"109960","AP헬스케어","62536619612","548","114117919","114153169","35250","2024-09"
"139050","BF랩스","24234697905","2805","8639821","8644551","4730","2024-09"
"027410","BGF","346465732920","3620","95708766","95716791","8025","2024-09"
"282330","BGF리테일","1984899223500","114900","17275015","17283906","8891","2024-09"
"126600","BGF에코머티리얼즈","212400006000","3430","61924200","62766899","842699","2024-09"
"138930","BNK금융지주","3018275760120","9480","318383519","320436727","2053208","2024-09"
"001460","BYC","205397003000","32900","6243070","6246150","3080","2024-09"
"013720","CBI","48583070160","1090","44571624","44628136","56512","2024-09"
"083790","CG인바이츠","187621804080","2440","76894182","76894182","0","2024-09"
"001040","CJ","2843843620500","105100","27058455","29176998","2118543","2024-09"
"079160","CJ CGV","922280616710","5570","165580003","165580003","0","2024-09"
"035760","CJ ENM","1293528225600","62400","20729619","21929154","1199535","2024-09"
"311690","CJ 바이오사이언스","106434023360","11680","9112502","9112502","0","2024-09"
"000120","CJ대한통운","1779105506800","89200","19945129","22812344","2867215","2024-09"
"011150","CJ씨푸드","113361588815","3155","35930773","35930773","0","2024-09"
"097950","CJ제일제당","4063687043500","276500","14696879","15054186","357307","2024-09"
"051500","CJ프레시웨이","215944149340","18190","11871586","11871586","0","2024-09"
"058820","CMG제약","295840479720","2130","138892244","138892244","0","2024-09"
"023460","CNH","8701027896","264","32958439","37200000","4241561","2024-09"
"056730","CNT85","56885012266","817","69626698","74111186","4484488","2024-09"
"000480","CR홀딩스","233099518800","5650","41256552","46890490","5633938","2024-09"
"065770","CS","19314074350","995","19411130","19411130","0","2024-09"
"083660","CSA 코스믹","49526724984","836","59242494","61247181","2004687","2024-09"
"000590","CS홀딩스","72676737200","69800","1041214","1154482","113268","2024-09"
"012030","DB","308323280262","1614","191030533","201173933","10143400","2024-09"
"456440","DB금융스팩11호","12091625000","2275","5315000","5315000","0","2024-09"
"477760","DB금융스팩12호","12059600000","2065","5840000","5840000","0","2024-09"
"016610","DB금융투자","223202531720","5480","40730389","42446389","1716000","2024-09"
"005830","DB손해보험","6935020669500","115500","60043469","70800000","10756531","2024-09"
"000990","DB하이텍","1534741811100","36900","41591919","44398588","2806669","2024-09"
"139130","DGB금융지주","1349445867520","8110","166392832","169145833","2753001","2024-09"
"099520","DGI","58000622016","1284","45171824","45281824","110000","2024-09"
"060900","DGP","30784123772","1219","25253588","25258229","4641","2024-09"
"290120","DH오토리드","41502994150","2675","15515138","15515138","0","2024-09"
"025440","DH오토웨어","33089814725","215","153906115","153906120","5","2024-09"
"001530","DI동일","723500089650","37350","19370819","25215672","5844853","2024-09"
"000210","DL","867578634150","41450","20930727","20955884","25157","2024-09"
"375500","DL이앤씨","1178828669200","30650","38460968","38693623","232655","2024-09"
"068790","DMS","129175835040","5490","23529296","24573061","1043765","2024-09"
"007340","DN오토모티브","884130479550","17590","50263245","59065865","8802620","2024-09"
"004840","DRB동일","88074703480","4570","19272364","19930000","657636","2024-09"
"241520","DSC인베스트먼트","75047056000","2870","26148800","27496125","1347325","2024-09"
"155660","DSR","61600000000","3850","16000000","16000000","0","2024-09"
"069730","DSR제강","51984000000","3610","14400000","14400000","0","2024-09"
"017860","DS단석","398575472000","68000","5861404","5861404","0","2024-09"
"180400","DXVX","117878776920","2395","49218696","49219432","736","2024-09"
"017940","E1","437678550700","75700","5781751","6860000","1078249","2024-09"
"245620","EDGC","57441040175","415","138412145","138493951","81806","2024-09"
"037370","EG","61582300080","7140","8624972","8624972","0","2024-09"
"050120","ES큐브","24109392600","1800","13394107","13564086","169979","2024-09"
"383220","F&F","2295697855100","60700","37820393","38307075","486682","2024-09"
"007700","F&F홀딩스","511815598300","13100","39069893","39114367","44474","2024-09"
"214270","FSN","70817204820","2130","33247514","33250463","2949","2024-09"
"130500","GH신소재","44216900320","3040","14545033","14545052","19","2024-09"
"114090","GKL","666804122600","10780","61855670","61855670","0","2024-09"
"078930","GS","3920189889000","42200","92895495","92915378","19883","2024-09"
"083450","GST","287199903200","15440","18601030","18618260","17230","2024-09"
"006360","GS건설","1533942332650","18070","84888895","85581490","692595","2024-09"
"001250","GS글로벌","277596354730","3365","82495202","82533764","38562","2024-09"
"007070","GS리테일","2172203376000","21000","103438256","104717922","1279666","2024-09"
"297890","HB솔루션","294757883420","4030","73140914","73140914","0","2024-09"
"440290","HB인베스트먼트","53048418570","1957","27107010","27107010","0","2024-09"
"078150","HB테크놀러지","213695356290","2405","88854618","92715916","3861298","2024-09"
"012630","HDC","541835578380","10830","50030986","59741721","9710735","2024-09"
"039570","HDC랩스","183105593410","7970","22974353","25957601","2983248","2024-09"
"089470","HDC현대EP","102383458850","3950","25919863","31900000","5980137","2024-09"
"294870","HDC현대산업개발","1334722064000","20800","64169330","65907330","1738000","2024-09"
"009540","HD한국조선해양","13916639184000","196800","70714630","70773116","58486","2024-09"
"267250","HD현대","5731209673000","81100","70668430","78993085","8324655","2024-09"
"267270","HD현대건설기계","943139532600","53400","17661789","18305586","643797","2024-09"
"443060","HD현대마린솔루션","5640705000000","126900","44450000","44450000","0","2024-09"
"071970","HD현대마린엔진","703870564750","20750","33921473","33921495","22","2024-09"
"010620","HD현대미포","4351376911800","109100","39884298","39942149","57851","2024-09"
"322000","HD현대에너지솔루션","247520000000","22100","11200000","11200000","0","2024-09"
"042670","HD현대인프라코어","1442506829680","7490","192591032","192655867","64835","2024-09"
"267260","HD현대일렉트릭","12183530304000","338500","35992704","36047135","54431","2024-09"
"329180","HD현대중공업","17585954279600","198100","88773116","88773116","0","2024-09"
"097230","HJ중공업","190268156900","2285","83268340","83274281","5941","2024-09"
"195940","HK이노엔","1325838898800","46800","28329891","28329891","0","2024-09"
"014790","HL D&I","96539432550","2550","37858601","37858601","0","2024-09"
"028300","HLB","8912329809600","68100","130871216","131127236","256020","2024-09"
"003580","HLB글로벌","195395553065","4115","47483731","47489591","5860","2024-09"
"278650","HLB바이오스텝","190281879720","2260","84195522","86730589","2535067","2024-09"
"067630","HLB생명과학","1078159000590","9090","118609351","118679271","69920","2024-09"
"024850","HLB이노베이션","338423395240","3710","91219244","91226268","7024","2024-09"
"047920","HLB제약","645528083900","20300","31799413","31799994","581","2024-09"
"115450","HLB테라퓨틱스","730197788550","9150","79803037","80139933","336896","2024-09"
"046210","HLB파나진","125000583050","2950","42373079","42373079","0","2024-09"
"204320","HL만도","1720978448000","36650","46957120","46957120","0","2024-09"
"060980","HL홀딩스","339090059700","35700","9498321","10169410","671089","2024-09"
"011200","HMM","12771123406800","17050","749039496","749039496","0","2024-09"
"403870","HPSP","2522589205500","31500","80082197","82934144","2851947","2024-09"
"036640","HRS","83904266250","5250","15981765","16354800","373035","2024-09"
"035000","HS애드","104215150920","6430","16207644","16567409","359765","2024-09"
"002460","HS화성","85087913710","8990","9464729","10150000","685271","2024-09"
"487570","HS효성","148619702700","40100","3706227","3725927","19700","2024-09"
"298050","HS효성첨단소재","1157217698000","259000","4468022","4479948","11926","2024-09"
"439730","IBKS제20호스팩","9395800000","2180","4310000","4310000","0","2024-09"
"442770","IBKS제21호스팩","9262000000","2200","4210000","4210000","0","2024-09"
"448760","IBKS제22호스팩","9746000000","2200","4430000","4430000","0","2024-09"
"467930","IBKS제23호스팩","9284850000","2195","4230000","4230000","0","2024-09"
"469480","IBKS제24호스팩","9284850000","2195","4230000","4230000","0","2024-09"
"003560","IHQ","63618682920","10760","5912517","5994566","82049","2024-09"
"095340","ISC","1264687065600","61800","20464192","21197058","732866","2024-09"
"175330","JB금융지주","3288796469700","17150","191766558","195083198","3316640","2024-09"
"234080","JW생명과학","172033394940","11110","15484554","15834554","350000","2024-09"
"067290","JW신약","81260066279","1603","50692493","50841502","149009","2024-09"
"001060","JW중외제약","656282247450","28550","22987119","23285930","298811","2024-09"
"096760","JW홀딩스","219455902680","3045","72070904","73924942","1854038","2024-09"
"035900","JYP Ent.","1752738821100","52900","33133059","35532492","2399433","2024-09"
"318000","KBG","49151389650","5650","8699361","8740223","40862","2024-09"
"024840","KBI메탈","97720817205","2805","34838081","34909199","71118","2024-09"
"105560","KB금융","35571439567000","94300","377215690","393528423","16312733","2024-09"
"024120","KB오토시스","41055000000","3570","11500000","11500000","0","2024-09"
"455250","KB제25호스팩","11365200000","2640","4305000","4305000","0","2024-09"
"458320","KB제26호스팩","12468825000","2265","5505000","5505000","0","2024-09"
"464680","KB제27호스팩","25745475000","1995","12905000","12905000","0","2024-09"
"476470","KB제28호스팩","11588025000","2105","5505000","5505000","0","2024-09"
"478390","KB제29호스팩","12688800000","2040","6220000","6220000","0","2024-09"
"486630","KB제30호스팩","10726200000","2020","5310000","5310000","0","2024-09"
"002380","KCC","1878990690500","255500","7354171","8886471","1532300","2024-09"
"021320","KCC건설","85765374800","4300","19945436","21400000","1454564","2024-09"
"344820","KCC글라스","628167320200","39400","15943333","15970512","27179","2024-09"
"036670","KCI","81024306000","7530","10760200","11270000","509800","2024-09"
"009070","KCTC","134725403750","4505","29905750","30000000","94250","2024-09"
"009440","KC그린홀딩스","19005357820","859","22124980","22434980","310000","2024-09"
"119650","KC코트렐","26713160864","416","64214329","64214329","0","2024-09"
"044180","KD","12046747141","451","26711191","26717799","6608","2024-09"
"092220","KEC","177474616644","884","200763141","200763141","0","2024-09"
"046440","KG모빌리언스","165108447900","4450","37103022","38825568","1722546","2024-09"
"003620","KG모빌리티","981039248730","4995","196404254","196404254","0","2024-09"
"016380","KG스틸","665815653360","6680","99673002","100008897","335895","2024-09"
"151860","KG에코솔루션","222811518780","5310","41960738","49603002","7642264","2024-09"
"035600","KG이니시스","248616677920","9340","26618488","27904434","1285946","2024-09"
"001390","KG케미칼","275930231200","4030","68469040","68469040","0","2024-09"
"226360","KH 건설","60474013950","2555","23668890","23756732","87842","2024-09"
"111870","KH 미래물산","43747975260","8910","4909986","4930249","20263","2024-09"
"033180","KH 필룩스","125157155370","6630","18877399","18903579","26180","2024-09"
"060720","KH바텍","200981471040","9120","22037442","23677442","1640000","2024-09"
"015590","KIB플러그에너지","94555634859","399","236981541","236981544","3","2024-09"
"001940","KISCO홀딩스","237686399560","18820","12629458","16176380","3546922","2024-09"
"058400","KNN","101176306080","764","132429720","132429720","0","2024-09"
"025000","KPX케미칼","223257625950","46950","4755221","4840000","84779","2024-09"
"092230","KPX홀딩스","222899550300","56700","3931209","4224646","293437","2024-09"
"000040","KR모터스","32224995360","536","60121260","60132868","11608","2024-09"
"044450","KSS해운","204552376500","9060","22577525","23085880","508355","2024-09"
"101000","KS인더스트리","67346450400","2235","30132640","30149619","16979","2024-09"
"030200","KT","10496760592500","42700","245825775","252021685","6195910","2024-09"
"033780","KT&G","11794474622500","107500","109716043","130322497","20606454","2024-09"
"058850","KTcs","110401701390","2910","37938729","42685000","4746271","2024-09"
"058860","KTis","81448620120","2660","30619782","34802000","4182218","2024-09"
"122450","KX","148429874450","3575","41518846","45335964","3817118","2024-09"
"052900","KX하이텍","54018651680","994","54344720","55107517","762797","2024-09"
"376190","LB루셈","110208000000","4480","24600000","24600000","0","2024-09"
"061970","LB세미콘","201409123200","4600","43784592","43784592","0","2024-09"
"309960","LB인베스트먼트","90831999850","3950","22995443","23217239","221796","2024-09"
"093050","LF","414993593040","14990","27684696","29240000","1555304","2024-09"
"003550","LG","11717380310000","77500","151192004","157300993","6108989","2024-09"
"034220","LG디스플레이","5350000000000","10700","500000000","500000000","0","2024-09"
"051900","LG생활건강","5189563890000","354000","14659785","15618197","958412","2024-09"
"373220","LG에너지솔루션","94302000000000","403000","234000000","234000000","0","2024-09"
"032640","LG유플러스","4255300684800","9900","429828352","436611361","6783009","2024-09"
"011070","LG이노텍","4725802047900","199700","23664507","23667107","2600","2024-09"
"066570","LG전자","16207021481000","99500","162884638","163647814","763176","2024-09"
"037560","LG헬로비전","200587380350","2590","77446865","77446865","0","2024-09"
"051910","LG화학","22907215303500","324500","70592343","70592343","0","2024-09"
"079550","LIG넥스원","5415898460000","248500","21794360","22000000","205640","2024-09"
"225190","LK삼양","134990850400","2660","50748440","50748440","0","2024-09"
"006260","LS","3060189502200","111900","27347538","32200000","4852462","2024-09"
"010120","LS ELECTRIC","4635083689800","156300","29655046","30000000","344954","2024-09"
"000680","LS네트웍스","263596081830","3345","78803014","78803016","2","2024-09"
"060370","LS마린솔루션","441878631900","16150","27360906","28706781","1345875","2024-09"
"417200","LS머트리얼즈","1072971171740","15860","67652659","67652659","0","2024-09"
"229640","LS에코에너지","862819537200","28450","30327576","30624879","297303","2024-09"
"078020","LS증권","221280987880","4390","50405692","55481190","5075498","2024-09"
"108320","LX세미콘","1014892320000","62400","16264300","16264300","0","2024-09"
"001120","LX인터내셔널","1062851504100","29550","35967902","38760000","2792098","2024-09"
"108670","LX하우시스","366046615500","40900","8949795","8967670","17875","2024-09"
"383800","LX홀딩스","538218598740","7060","76234929","76280690","45761","2024-09"
"476080","M83","104396850000","13410","7785000","7785000","0","2024-09"
"086960","MDS테크","99040847796","1067","92821788","92821788","0","2024-09"
"023150","MH에탄올","37591366740","5860","6414909","7378526","963617","2024-09"
"038340","MIT","39924432729","1233","32379913","32424892","44979","2024-09"
"035420","NAVER","26089752840000","172500","151244944","160784508","9539564","2024-09"
"160550","NEW","65858410160","2360","27906106","27906106","0","2024-09"
"053290","NE능률","57263653755","3465","16526307","16526307","0","2024-09"
"181710","NHN","528996759600","16070","32918280","33766123","847843","2024-09"
"060250","NHN KCP","281104124590","7270","38666317","40160611","1494294","2024-09"
"104200","NHN벅스","48809272140","3610","13520574","14827550","1306976","2024-09"
"005940","NH투자증권","4509959066400","13800","326808628","327492299","683671","2024-09"
"034310","NICE","396102727240","11320","34991407","37503477","2512070","2024-09"
"030190","NICE평가정보","656808405740","11210","58591294","60107670","1516376","2024-09"
"008260","NI스틸","111397455715","3895","28600117","28600117","0","2024-09"
"004250","NPC","167841456750","4950","33907365","36720000","2812635","2024-09"
"222160","NPX","79551289560","8040","9894439","9894439","0","2024-09"
"456040","OCI","695608861500","77700","8952495","8952495","0","2024-09"
"010060","OCI홀딩스","1252556756800","65600","19093853","19563983","470130","2024-09"
"178920","PI첨단소재","599072968800","20400","29366322","29366322","0","2024-09"
"024940","PN풍년","57331948000","6100","9398680","10000000","601320","2024-09"
"005490","POSCO홀딩스","25862306418000","342000","75620779","82624377","7003598","2024-09"
"218410","RFHIC","367122049610","14270","25726843","26484442","757599","2024-09"
"327260","RF머트리얼즈","56308970800","6800","8280731","8433231","152500","2024-09"
"091340","S&K폴리텍","26023557690","2430","10709283","11703721","994438","2024-09"
"010950","S-Oil","6608609890400","58700","112582792","112582792","0","2024-09"
"419530","SAMG엔터","107725386000","13560","7944350","8590930","646580","2024-09"
"019550","SBI인베스트먼트","110865973264","688","161142403","162066575","924172","2024-09"
"034120","SBS","283048492440","15260","18548394","18551238","2844","2024-09"
"036120","SCI평가정보","79296333130","2330","34032761","35500000","1467239","2024-09"
"246960","SCL사이언스","63729758750","8750","7283401","7283401","0","2024-09"
"099220","SDN","67118873829","1239","54171811","56171811","2000000","2024-09"
"036540","SFA반도체","591093821395","3605","163964999","164460303","495304","2024-09"
"255220","SG","261695958975","3135","83475585","94073791","10598206","2024-09"
"040610","SG&G","52643894160","1560","33746086","34087196","341110","2024-09"
"049470","SGA","18715652800","320","58486415","58862249","375834","2024-09"
"184230","SGA솔루션즈","31741879813","509","62361257","62599161","237904","2024-09"
"016250","SGC E&C","49945034080","15440","3234782","3243585","8803","2024-09"
"005090","SGC에너지","414928569600","28800","14407242","14409333","2091","2024-09"
"001380","SG글로벌","137590277580","3060","44964143","44964143","0","2024-09"
"004060","SG세계물산","66987928532","337","198777236","202424960","3647724","2024-09"
"001770","SHD","22608879580","18610","1214878","1214878","0","2024-09"
"002360","SH에너지화학","56406240408","518","108892356","111133730","2241374","2024-09"
"009160","SIMPAC","212193807560","3910","54269516","65429516","11160000","2024-09"
"033530","SJG세종","122952698955","4545","27052299","27820961","768662","2024-09"
"123700","SJM","51028016460","3270","15604898","15604898","0","2024-09"
"025530","SJM홀딩스","48719407645","3595","13551991","14934008","1382017","2024-09"
"034730","SK","8014491303000","147000","54520349","72502703","17982354","2024-09"
"011790","SKC","4932939248000","144800","34067260","37868298","3801038","2024-09"
"018670","SK가스","1658588500800","184800","8975046","9230244","255198","2024-09"
"001740","SK네트웍스","992914380800","5120","193928590","221277902","27349312","2024-09"
"006120","SK디스커버리","587962637600","33200","17709718","18785855","1076137","2024-09"
"210980","SK디앤디","152197824380","8180","18606091","18617382","11291","2024-09"
"302440","SK바이오사이언스","4528473535400","57800","78347293","78347293","0","2024-09"
"326030","SK바이오팜","9436746625000","120500","78313250","78313250","0","2024-09"
"402340","SK스퀘어","12279613241400","92100","133329134","134749960","1420826","2024-09"
"361610","SK아이이테크놀로지","2260017898000","31700","71293940","71297592","3652","2024-09"
"100090","SK오션플랜트","779605630560","13170","59195568","59195568","0","2024-09"
"096770","SK이노베이션","11064493582800","116200","95219394","95735590","516196","2024-09"
"475150","SK이터닉스","517156945920","15360","33669072","33691895","22823","2024-09"
"001510","SK증권","211092163530","510","413906203","472590171","58683968","2024-09"
"285130","SK케미칼","846506812900","49150","17222926","17253783","30857","2024-09"
"017670","SK텔레콤","12070655591400","56700","212886342","214790053","1903711","2024-09"
"000660","SK하이닉스","135051591276000","196000","689038731","728002365","38963634","2024-09"
"048550","SM C&C","163730495862","1706","95973327","96714620","741293","2024-09"
"063440","SM Life Design","63520232520","1380","46029154","46029154","0","2024-09"
"003570","SNT다이내믹스","597915821700","26700","22393851","33252697","10858846","2024-09"
"064960","SNT모티브","554292302800","46300","11971756","14623136","2651380","2024-09"
"100840","SNT에너지","264403625040","13380","19761108","20680783","919675","2024-09"
"036530","SNT홀딩스","334741175300","23150","14459662","16303886","1844224","2024-09"
"067160","SOOP","966531852000","90700","10656360","11494767","838407","2024-09"
"005610","SPC삼립","405261150000","50000","8105223","8629009","523786","2024-09"
"011810","STX","154125748750","4975","30980050","31017927","37877","2024-09"
"465770","STX그린로지스","80590975200","11280","7144590","7171032","26442","2024-09"
"077970","STX엔진","455852210740","19820","22999607","23008904","9297","2024-09"
"002820","SUN&L","37516564440","3110","12063204","12607989","544785","2024-09"
"289080","SV인베스트먼트","85174400000","1600","53234000","53234000","0","2024-09"
"084870","TBH글로벌","28865837496","1384","20856819","20856819","0","2024-09"
"002710","TCC스틸","1162577461950","44350","26213697","26213697","0","2024-09"
"089230","THE E&M","29442728386","1346","21874241","21882953","8712","2024-09"
"032540","TJ미디어","72862315070","5230","13931609","13931609","0","2024-09"
"022220","TKG애강","52364319369","1011","51794579","51794579","0","2024-09"
"069260","TKG휴켐스","755906276900","19700","38370877","40878588","2507711","2024-09"
"007980","TP","64953509190","1335","48654314","51175130","2520816","2024-09"
"048770","TPC","39087997590","2490","15697991","15697991","0","2024-09"
"246690","TS인베스트먼트","40877912640","1002","40796320","41477862","681542","2024-09"
"317240","TS트릴리온","29786621715","279","106762085","107240922","478837","2024-09"
"002900","TYM","133502742970","3110","42926927","45050956","2124029","2024-09"
"024070","WISCOM","32262151990","2105","15326438","15326438","0","2024-09"
"057030","YBM넷","57616275320","3560","16184347","16312697","128350","2024-09"
"037270","YG PLUS","316829902950","4995","63429410","63429410","0","2024-09"
"040300","YTN","133140000000","3170","42000000","42000000","0","2024-09"
"051390","YW","30318666060","3755","8074212","11355368","3281156","2024-09"
"052220","iMBC","58190000000","2530","23000000","23000000","0","2024-09"
"079940","가비아","176942957100","13650","12962854","13535684","572830","2024-09"
"078890","가온그룹","57684163080","3590","16068012","17410157","1342145","2024-09"
"000500","가온전선","274452948000","38500","7128648","7357946","229298","2024-09"
"399720","가온칩스","445172400000","38750","11488320","11488320","0","2024-09"
"036620","감성코퍼레이션","324412988900","3575","90744892","90744892","0","2024-09"
"000860","강남제비스코","166075000000","25550","6500000","6500000","0","2024-09"
"198440","강동씨앤엘","91289136000","1500","60859424","60931896","72472","2024-09"
"217730","강스템바이오텍","118274254390","2110","56054149","56054149","0","2024-09"
"035250","강원랜드","3290453937540","16230","202738998","213940500","11201502","2024-09"
"114190","강원에너지","333329964880","12760","26123038","26123038","0","2024-09"
"094480","갤럭시아머니트리","318938582940","8130","39229838","39229838","0","2024-09"
"011420","갤럭시아에스엠","66670138480","2420","27549644","27549644","0","2024-09"
"039240","경남스틸","74868401100","2775","26979604","26979604","0","2024-09"
"053950","경남제약","23562642130","662","35593115","35593402","287","2024-09"
"002100","경농","164354780000","9200","17864650","19522575","1657925","2024-09"
"009450","경동나비엔","1334005623600","92300","14452932","14568592","115660","2024-09"
"267290","경동도시가스","110740027600","18800","5890427","5895406","4979","2024-09"
"012320","경동인베스트","164398540800","75400","2180352","2365023","184671","2024-09"
"011040","경동제약","171888492600","6380","26941770","30768766","3826996","2024-09"
"000050","경방","151235688900","6070","24915270","27415270","2500000","2024-09"
"214390","경보제약","177867038400","7440","23906860","23906860","0","2024-09"
"012610","경인양행","123477038370","2985","41365842","41616365","250523","2024-09"
"009140","경인전자","27157896450","20850","1302537","1570797","268260","2024-09"
"024910","경창산업","81665004600","2295","35583880","35819005","235125","2024-09"
"013580","계룡건설","119491681530","13490","8857797","8930907","73110","2024-09"
"012200","계양전기","42887546358","1577","27195654","27222829","27175","2024-09"
"002140","고려산업","75247831000","3050","24671420","24939425","268005","2024-09"
"049720","고려신용정보","138559879200","9950","13925616","14300000","374384","2024-09"
"010130","고려아연","18004760004000","876000","20553379","20703283","149904","2024-09"
"002240","고려제강","483267204420","19340","24987963","25000000","12037","2024-09"
"014570","고려제약","52652706320","4880","10789489","11000000","210511","2024-09"
"348150","고바이오랩","141041628000","7280","19373850","19373850","0","2024-09"
"098460","고영","658590612680","10010","65793268","68654755","2861487","2024-09"
"035290","골드앤에스","21597445440","453","47676480","47676480","0","2024-09"
"215000","골프존","402942210000","67100","6005100","6275415","270315","2024-09"
"121440","골프존뉴딘홀딩스","160705658190","3945","40736542","42836818","2100276","2024-09"
"366030","공구우먼","97524824250","4305","22653850","22653850","0","2024-09"
"009290","광동제약","234872386320","5860","40080612","52420851","12340239","2024-09"
"014200","광림","87868591200","30200","2909556","3023556","114000","2024-09"
"017040","광명전기","64919747270","1498","43337615","43337615","0","2024-09"
"029480","광무","209990373640","3820","54971302","55009083","37781","2024-09"
"017900","광전자","92115322527","1829","50363763","57943763","7580000","2024-09"
"037710","광주신세계","223857498200","29350","7627172","7957190","330018","2024-09"
"026910","광진실업","13995809925","2185","6405405","6405405","0","2024-09"
"421800","교보12호스팩","15428400000","2580","5980000","5980000","0","2024-06"
"440790","교보13호스팩","8829000000","2180","4050000","4050000","0","2024-09"
"456490","교보14호스팩","9030000000","2150","4200000","4200000","0","2024-09"
"465320","교보15호스팩","8267700000","2170","3810000","3810000","0","2024-09"
"482520","교보16호스팩","12505000000","2050","6100000","6100000","0","2024-09"
"030610","교보증권","645612756360","5720","112869363","113962961","1093598","2024-09"
"339770","교촌에프앤비","244579066600","9790","24982540","24982540","0","2024-09"
"053270","구영테크","59731480640","2290","26083616","27410405","1326789","2024-09"
"007690","국도화학","280658969100","33650","8340534","9010616","670082","2024-09"
"005320","국동","32048076456","484","66215034","67327897","1112863","2024-09"
"001140","국보","33448047050","2110","15852155","15856388","4233","2024-09"
"066620","국보디자인","107008841160","16190","6609564","7500000","890436","2024-09"
"043650","국순당","77915306700","4950","15740466","17858304","2117838","2024-09"
"006050","국영지앤엠","63384104410","1870","33895243","34895243","1000000","2024-09"
"060480","국일신동","21481330000","1937","11090000","11090000","0","2024-09"
"078130","국일제지","901924696800","800","1127405871","1127405871","0","2024-09"
"307750","국전약품","216149614560","4405","49069152","49069269","117","2024-09"
"002720","국제약품","110772010880","5440","20362502","21159832","797330","2024-09"
"035080","그래디언트","150491286000","11000","13681026","14527584","846558","2024-09"
"453450","그리드위즈","163223512500","20550","7942750","7942750","0","2024-09"
"204020","그리티","55459989890","2770","20021657","20147430","125773","2024-09"
"402490","그린리소스","134734887200","16300","8265944","8265944","0","2024-09"
"114450","그린생명과학","39606500250","2075","19087470","20000000","912530","2024-09"
"083420","그린케미칼","135525942440","5810","23326324","24000000","673676","2024-09"
"186230","그린플러스","98809729600","9200","10740188","10820188","80000","2024-09"
"014530","극동유화","127102060500","3775","33669420","34869420","1200000","2024-09"
"204620","글로벌텍스프리","244461212000","4000","61115303","61116035","732","2024-09"
"019660","글로본","19239282538","553","34790746","34790746","0","2024-09"
"014280","금강공업","110981843210","4130","26872117","29329357","2457240","2024-09"
"053260","금강철강","77178925160","4855","15896792","18720000","2823208","2024-09"
"008870","금비","45181200000","55200","818500","1000000","181500","2024-09"
"001570","금양","2554510625100","44100","57925411","58050037","124626","2024-09"
"282720","금양그린파워","126823119000","10510","12066900","12119500","52600","2024-09"
"002990","금호건설","105891323800","2950","35895364","36953595","1058231","2024-09"
"011780","금호석유","3095109504400","134800","22960753","27334587","4373834","2024-09"
"214330","금호에이치티","125915759094","618","203747183","213914131","10166948","2024-09"
"001210","금호전기","37720136792","884","42669838","43535722","865884","2024-09"
"073240","금호타이어","1217983616880","4240","287260287","287260287","0","2024-09"
"036190","금화피에스시","161228067000","27300","5905790","6000000","94210","2024-09"
"049080","기가레인","59755518592","704","84879998","84883347","3349","2024-09"
"420770","기가비스","489918046700","38650","12675758","12675758","0","2024-09"
"035460","기산텔레콤","27186739100","1865","14577340","14577340","0","2024-09"
"092440","기신정기","75044000000","2570","29200000","29200000","0","2024-09"
"000270","기아","36440678157000","93000","391835249","399858417","8023168","2024-09"
"024110","기업은행","11546726554160","14480","797425867","797425869","2","2024-09"
"013700","까뮤이앤씨","79468603900","1330","59750830","59750830","0","2024-09"
"308100","까스텔바작","20381567080","3160","6449863","6624733","174870","2024-09"
"004540","깨끗한나라","77830026230","2090","37239247","37240693","1446","2024-09"
"407400","꿈비","72065158750","6110","11794625","12259474","464849","2024-09"
"187790","나노","31435070025","1025","30668361","30840830","172469","2024-09"
"286750","나노브릭","48837070640","2360","20693674","20694559","885","2024-09"
"121600","나노신소재","1022970906000","85500","11964572","12196078","231506","2024-09"
"247660","나노씨엠에스","35194704480","8240","4271202","4343920","72718","2024-09"
"039860","나노엔텍","148830230070","4635","32110082","32110082","0","2024-09"
"091970","나노캠텍","22840265752","632","36139661","37417493","1277832","2024-09"
"417010","나노팀","197637766560","10020","19724328","19724328","0","2024-09"
"405920","나라셀라","47491741260","3820","12432393","12878076","445683","2024-09"
"051490","나라엠앤디","70131055050","5310","13207355","14200000","992645","2024-09"
"137080","나래나노텍","38486788560","3480","11059422","11059422","0","2024-09"
"190510","나무가","189981244560","12020","15805428","16264384","458956","2024-09"
"242040","나무기술","56498769140","1705","33137108","34606264","1469156","2024-09"
"089600","나스미디어","177846038370","15730","11306169","11568163","261994","2024-09"
"293580","나우IB","88193583450","931","94729950","94929950","200000","2024-09"
"138610","나이벡","212011553800","20600","10291823","10291823","0","2024-09"
"130580","나이스디앤비","77154000000","5010","15400000","15400000","0","2024-09"
"036800","나이스정보통신","164455312500","18750","8770950","10000000","1229050","2024-09"
"267320","나인테크","100042220825","2305","43402265","43664104","261839","2024-09"
"001260","남광토건","61889398200","6300","9823714","9832572","8858","2024-09"
"008350","남선알미늄","179032697830","1387","129079090","129079090","0","2024-09"
"004270","남성","41846842632","1336","31322487","36212160","4889673","2024-09"
"003920","남양유업","390984615000","595000","657117","679731","22614","2024-09"
"025860","남해화학","311187030550","6490","47948695","49678843","1730148","2024-09"
"111710","남화산업","103557640000","5030","20588000","20588000","0","2024-09"
"091590","남화토건","46196900000","3935","11740000","11740000","0","2024-09"
"168330","내츄럴엔도텍","50990945715","1615","31573341","31754900","181559","2024-09"
"094860","네오리진","29531406194","1381","21384074","21399569","15495","2024-09"
"253590","네오셈","480239400600","11300","42499062","43869164","1370102","2024-09"
"212560","네오오토","67248716780","8540","7874557","7874963","406","2024-09"
"095660","네오위즈","401166410450","20150","19909003","22033719","2124716","2024-09"
"042420","네오위즈홀딩스","127243924730","19570","6501989","8856866","2354877","2024-09"
"311390","네오크레마","76776763050","7050","10890321","10979147","88826","2024-09"
"085910","네오티스","47221777220","3530","13377274","13934818","557544","2024-09"
"092730","네오팜","208810767600","26700","7820628","8207361","386733","2024-09"
"290660","네오펙트","40023037350","950","42129513","42129513","0","2024-09"
"306620","네온테크","91994778000","2250","40886568","42608149","1721581","2024-09"
"153460","네이블","40654833600","6350","6402336","6530014","127678","2024-09"
"007390","네이처셀","727879434360","11310","64357156","64357156","0","2024-09"
"033640","네패스","180324123980","7930","22739486","23059202","319716","2024-09"
"330860","네패스아크","158392585000","13000","12184045","12184045","0","2024-09"
"005720","넥센","219460425300","4530","48446010","53543977","5097967","2024-09"
"002350","넥센타이어","670259079220","6970","96163426","97667877","1504451","2024-09"
"089140","넥스턴바이오","44597145565","3955","11276143","11282627","6484","2024-09"
"389650","넥스트바이오메디컬","297590044800","36800","8086686","8086686","0","2024-09"
"137940","넥스트아이","32462195568","424","76561782","78320992","1759210","2024-09"
"396270","넥스트칩","230814874400","12760","18088940","18088940","0","2024-09"
"348210","넥스틴","685318303800","66300","10336626","10437250","100624","2024-09"
"092790","넥스틸","243118700000","9350","26002000","26002000","0","2024-09"
"225570","넥슨게임즈","951862692960","14880","63969267","65860174","1890907","2024-09"
"217270","넵튠","238245102810","5310","44867251","46676150","1808899","2024-09"
"251270","넷마블","4612916347300","56300","81934571","85953502","4018931","2024-09"
"104620","노랑풍선","74854045350","4725","15842126","15842126","0","2024-09"
"090350","노루페인트","171400000000","8570","20000000","20000000","0","2024-09"
"000320","노루홀딩스","138254868570","13490","10248693","13291151","3042458","2024-09"
"194700","노바렉스","185165179360","10460","17702216","18754848","1052632","2024-09"
"285490","노바텍","116144882100","11700","9926913","10575831","648918","2024-09"
"145170","노브랜드","110290303200","13300","8292504","9079834","787330","2024-09"
"106520","노블엠앤비","15902299386","411","38691726","38695952","4226","2024-09"
"376930","노을","109548032900","2965","36947060","36947060","0","2024-09"
"006280","녹십자","1888880959000","165500","11413178","11686538","273360","2024-09"
"142280","녹십자엠에스","89541069750","4125","21706926","21741926","35000","2024-09"
"234690","녹십자웰빙","205489022280","11580","17745166","17752276","7110","2024-09"
"005250","녹십자홀딩스","720295065700","16030","44934190","47028210","2094020","2024-09"
"004370","농심","2087526903000","361000","5782623","6082642","300019","2024-09"
"072710","농심홀딩스","315369720000","68000","4637790","4637790","0","2024-09"
"054050","농우바이오","116542178470","7270","16030561","16030561","0","2024-09"
"069140","누리플랜","17795536379","1361","13075339","13102743","27404","2024-09"
"040160","누리플렉스","27793043100","2460","11297985","12055535","757550","2024-09"
"332290","누보","38992888335","1185","32905391","33384803","479412","2024-09"
"348340","뉴로메카","228389530500","21650","10549170","10549170","0","2024-09"
"060260","뉴보텍","14009473800","1050","13342356","13512009","169653","2024-09"
"123840","뉴온","61861271066","238","259921307","292370108","32448801","2024-09"
"012340","뉴인텍","27131615069","533","50903593","50907162","3569","2024-09"
"214870","뉴지랩파마","64715071880","6920","9351889","9359221","7332","2024-09"
"270870","뉴트리","81673201680","9080","8994846","9200224","205378","2024-09"
"144960","뉴파워프라즈마","195854389720","4840","40465783","43692624","3226841","2024-09"
"085670","뉴프렉스","137166093240","5610","24450284","24450761","477","2024-09"
"064260","다날","208394144400","3120","66792995","68949040","2156045","2024-09"
"340360","다보링크","111073822720","2560","43388212","43388212","0","2024-09"
"039560","다산네트웍스","131716527540","3405","38683268","39505981","822713","2024-09"
"154040","다산솔루에타","29886906510","1665","17950094","17950094","0","2024-09"
"058730","다스코","59179936200","3255","18181240","18796941","615701","2024-09"
"030210","다올투자증권","173276739675","2925","59239911","60911106","1671195","2024-09"
"023590","다우기술","787071485760","18240","43150849","44866617","1715768","2024-09"
"032190","다우데이타","431258000000","11260","38300000","38300000","0","2024-09"
"323350","다원넥스뷰","50484406000","6650","7591640","7596111","4471","2024-09"
"068240","다원시스","413691657080","10840","38163437","38163437","0","2024-09"
"145210","다이나믹디자인","87785417520","2540","34561188","34581687","20499","2024-09"
"019680","대교","152959587060","2270","67383078","84702850","17319772","2024-09"
"006370","대구백화점","60664544190","7290","8321611","10821611","2500000","2024-09"
"008060","대덕","210457831500","6210","33890150","33890150","0","2024-09"
"353200","대덕전자","833663524750","16870","49416925","49416925","0","2024-09"
"000490","대동","192084799050","8150","23568687","25640788","2072101","2024-09"
"020400","대동금속","20123637460","6310","3189166","3189166","0","2024-09"
"008830","대동기어","64889894400","7220","8987520","8987520","0","2024-09"
"048470","대동스틸","35173678980","3740","9404727","10000000","595273","2024-09"
"008110","대동전자","105136322880","15040","6990447","10490447","3500000","2024-09"
"004780","대륙제관","64726019930","4070","15903199","15903199","0","2024-09"
"005750","대림B&Co","58186117600","3490","16672240","16672240","0","2024-09"
"017650","대림제지","58761750000","7050","8335000","9000000","665000","2024-09"
"006570","대림통상","40297462600","2675","15064472","15225000","160528","2024-09"
"007720","대명소노시즌","106344474750","1055","100800450","100800450","0","2024-09"
"389260","대명에너지","209885500000","12310","17050000","17050000","0","2024-09"
"317850","대모","78249548000","9400","8324420","8324420","0","2024-09"
"290670","대보마그네틱","123727576320","16560","7471472","7857660","386188","2024-09"
"078140","대봉엘에스","200789419460","18340","10948169","11086579","138410","2024-09"
"065150","대산F&B","18113400725","145","124920005","125282405","362400","2024-09"
"001680","대상","691574579000","19960","34648025","34648025","0","2024-09"
"084690","대상홀딩스","294045808560","8120","36212538","36212538","0","2024-09"
"036480","대성미생물","38646000000","10170","3800000","3800000","0","2024-09"
"128820","대성산업","129426421370","3455","37460614","45235478","7774864","2024-09"
"117580","대성에너지","255084841480","9380","27194546","27500000","305454","2024-09"
"027830","대성창투","79650000000","1475","54000000","54000000","0","2024-09"
"104040","대성파인텍","45659610220","980","46591439","47224987","633548","2024-09"
"129920","대성하이텍","58563276310","4270","13715053","13715053","0","2024-09"
"016710","대성홀딩스","127097680600","7900","16088314","16089459","1145","2024-09"
"438220","대신밸런스제13호스팩","14776800000","2620","5640000","5640000","0","2024-09"
"442310","대신밸런스제14호스팩","15164600000","2260","6710000","6710000","0","2024-09"
"457390","대신밸런스제15호스팩","16778475000","2385","7035000","7035000","0","2024-09"
"457630","대신밸런스제16호스팩","15643400000","2140","7310000","7310000","0","2024-09"
"471050","대신밸런스제17호스팩","12968400000","2140","6060000","6060000","0","2024-09"
"478780","대신밸런스제18호스팩","16334150000","2065","7910000","7910000","0","2024-09"
"020180","대신정보통신","34048018690","886","38428915","38428915","0","2024-09"
"003540","대신증권","631326370940","16820","37534267","50773400","13239133","2024-09"
"045390","대아티아이","186049715280","2640","70473377","70473377","0","2024-09"
"009190","대양금속","71156942640","1680","42355323","42359986","4663","2024-09"
"108380","대양전기공업","109630424320","11860","9243712","9567333","323621","2024-09"
"014160","대영포장","98497902162","1034","95259093","108394549","13135456","2024-09"
"047040","대우건설","1501787306600","3655","410885720","415622638","4736918","2024-09"
"003090","대웅","1038624034000","25400","40890710","58141980","17251270","2024-09"
"069620","대웅제약","1752404921000","152300","11506270","11586575","80305","2024-09"
"007680","대원","56744120280","4220","13446474","13446474","0","2024-09"
"000430","대원강업","236530000000","3815","62000000","62000000","0","2024-09"
"048910","대원미디어","98367129960","8140","12084414","12578946","494532","2024-09"
"005710","대원산업","117420336000","5860","20037600","20037600","0","2024-09"
"006340","대원전선","212191065250","2830","74979175","74979175","0","2024-09"
"003220","대원제약","314428550130","14670","21433439","22427583","994144","2024-09"
"024890","대원화성","45039349160","1105","40759592","41249152","489560","2024-09"
"290380","대유","56838037000","2300","24712190","24713612","1422","2024-09"
"002880","대유에이텍","50657652768","1084","46732152","46744020","11868","2024-09"
"000300","대유플러스","30475633069","241","126454909","126454909","0","2024-09"
"120240","대정화금","98774840070","13770","7173191","7190391","17200","2024-09"
"003310","대주산업","50115567600","1416","35392350","35392350","0","2024-09"
"078600","대주전자재료","1570837638000","104900","14974620","15480593","505973","2024-09"
"012800","대창","96544959390","1265","76320126","91140499","14820373","2024-09"
"015230","대창단조","131112488000","5200","25213940","28572230","3358290","2024-09"
"096350","대창솔루션","56818434603","357","159155279","163761009","4605730","2024-09"
"140520","대창스틸","47492631000","2250","21107836","21109243","1407","2024-09"
"131220","대한과학","36181387435","4855","7452397","7454490","2093","2024-09"
"010170","대한광통신","76522967482","1027","74511166","74511166","0","2024-09"
"054670","대한뉴팜","110177018650","7850","14035289","14354920","319631","2024-09"
"001070","대한방직","21132042750","5850","3612315","5300000","1687685","2024-09"
"023910","대한약품","149940000000","25500","5880000","6000000","120000","2024-09"
"006650","대한유화","633050250000","102500","6176100","6500000","323900","2024-09"
"001440","대한전선","2206794276720","11880","185757094","186447300","690206","2024-09"
"084010","대한제강","236399763350","13550","17446477","23414397","5967920","2024-09"
"001790","대한제당","260099389200","2940","88469180","89696580","1227400","2024-09"
"001130","대한제분","224075831400","136200","1645197","1690000","44803","2024-09"
"003490","대한항공","8579540282900","23300","368220613","368220661","48","2024-09"
"005880","대한해운","576115315300","1805","319177460","319177460","0","2024-09"
"003830","대한화섬","135601070000","121000","1120670","1328000","207330","2024-09"
"016090","대현","93657085650","2115","44282310","44282310","0","2024-09"
"069460","대호에이엘","72129128740","1069","67473460","67544896","71436","2024-09"
"021040","대호특수강","28317658396","1546","18316726","21704774","3388048","2024-09"
"067080","대화제약","321255361000","18340","17516650","18616650","1100000","2024-09"
"298540","더네이쳐홀딩스","147348174830","10090","14603387","14765856","162469","2024-09"
"032860","더라미","89039275650","2210","40289265","40395863","106598","2024-09"
"192080","더블유게임즈","1007138295600","50800","19825557","21495906","1670349","2024-09"
"393890","더블유씨피","544535730880","16160","33696518","33696518","0","2024-09"
"299170","더블유에스아이","44891782260","1495","30027948","30027963","15","2024-09"
"012510","더존비즈온","1401442650000","50000","28028853","30382784","2353931","2024-09"
"224060","더코디","21197833290","4490","4721121","4748398","27277","2024-09"
"043090","더테크놀로지","32071895681","431","74412751","74412751","0","2024-09"
"213420","덕산네오룩스","728290429750","29650","24562915","24831179","268264","2024-09"
"317330","덕산테코피아","780157850400","38100","20476584","20476584","0","2024-09"
"077360","덕산하이메탈","218097609600","4800","45437002","45437002","0","2024-09"
"004830","덕성","90376342750","6530","13840175","15680000","1839825","2024-09"
"090410","덕신이피씨","65208909525","1415","46084035","46084095","60","2024-09"
"024900","덕양산업","106362462400","3280","32427580","32564980","137400","2024-09"
"263600","덕우전자","96059769300","6030","15930310","15930310","0","2024-09"
"194480","데브시스터즈","376818929600","34900","10797104","12035480","1238376","2024-09"
"263800","데이타솔루션","70878690600","4370","16219380","16219380","0","2024-09"
"206560","덱스터","198725550700","7900","25155133","25411736","256603","2024-09"
"261200","덴티스","109542005250","7170","15277825","15809700","531875","2024-09"
"145720","덴티움","657140494200","76200","8623891","11068830","2444939","2024-09"
"067990","도이치모터스","138601200860","4670","29679058","30181550","502492","2024-09"
"002150","도화엔지니어링","224080902250","6730","33295825","33720000","424175","2024-09"
"006620","동구바이오제약","154565748600","5700","27116798","28464992","1348194","2024-09"
"100130","동국S&C","141842325035","2545","55733723","57143000","1409277","2024-09"
"005160","동국산업","334908671500","6500","51524411","54244482","2720071","2024-09"
"460850","동국씨엠","191925314880","6430","29848416","29898656","50240","2024-09"
"075970","동국알앤에스","46092000000","2505","18400000","18400000","0","2024-09"
"460860","동국제강","430094364560","8680","49550042","49608017","57975","2024-09"
"086450","동국제약","777799580800","17690","43968320","44460000","491680","2024-09"
"001230","동국홀딩스","249745390290","8030","31101543","31800483","698940","2024-09"
"023450","동남합성","113161635000","32650","3465900","3500000","34100","2024-09"
"004140","동방","113751638280","2380","47794806","47971766","176960","2024-09"
"099410","동방선기","42396007200","3040","13946055","14000000","53945","2024-09"
"007590","동방아그로","77411511840","6240","12405691","13617577","1211886","2024-09"
"005960","동부건설","94177131670","4105","22942054","22946345","4291","2024-09"
"026960","동서","2072122983000","21000","98672523","99700000","1027477","2024-09"
"002210","동성제약","102896946000","4500","22865988","26100970","3234982","2024-09"
"102260","동성케미컬","213577292130","4385","48706338","49689728","983390","2024-09"
"033500","동성화인텍","323138725770","11130","29033129","29989494","956365","2024-09"
"025950","동신건설","170940000000","20350","8400000","8400000","0","2024-09"
"000640","동아쏘시오홀딩스","767588784400","122800","6250723","6348913","98190","2024-09"
"170900","동아에스티","674235633800","75100","8977838","9167274","189436","2024-09"
"088130","동아엘텍","78596486430","8990","8742657","8742657","0","2024-09"
"028100","동아지질","175550310000","13250","13249080","14052646","803566","2024-09"
"041930","동아화성","102891525660","6930","14847262","15800000","952738","2024-09"
"001520","동양","142922459439","753","189804063","238684063","48880000","2024-09"
"084670","동양고속","21941690000","8410","2609000","2895569","286569","2024-09"
"082640","동양생명","887328546470","5690","155945263","161358585","5413322","2024-09"
"060380","동양에스텍","27985000000","1450","19300000","19700000","400000","2024-09"
"079960","동양이엔피","149625983820","19380","7720639","7860000","139361","2024-09"
"008970","동양철관","122175236462","778","157037579","157052160","14581","2024-09"
"228340","동양파일","40400000000","2020","20000000","20000000","0","2024-09"
"092780","동양피스톤","72696568320","5760","12620932","13168460","547528","2024-09"
"088910","동우팜투테이블","51340640944","1996","25721764","25831764","110000","2024-09"
"094170","동운아나텍","350177557280","18580","18847016","19067208","220192","2024-09"
"049770","동원F&B","613600716000","31800","19295620","19295620","0","2024-09"
"013120","동원개발","230198533500","2535","90808100","90808100","0","2024-09"
"018500","동원금속","57075406905","1221","46744805","46754933","10128","2024-09"
"006040","동원산업","1194125819250","33150","36021895","36021895","0","2024-09"
"030720","동원수산","26433612400","5680","4653805","4653805","0","2024-09"
"014820","동원시스템즈","1362590254000","47000","28991282","28991282","0","2024-09"
"111380","동인기연","116221965420","19580","5935749","6128000","192251","2024-09"
"163560","동일고무벨트","103555000000","7450","13900000","13900000","0","2024-09"
"109860","동일금속","73595257500","8700","8459225","9100000","640775","2024-09"
"032960","동일기연","41306787160","10930","3779212","3986323","207111","2024-09"
"004890","동일산업","86751143550","40050","2166071","2425215","259144","2024-09"
"002690","동일제강","28080572800","1480","18973360","20300360","1327000","2024-09"
"023790","동일철강","26050885299","1251","20824049","20841335","17286","2024-09"
"005290","동진쎄미켐","1406186410900","27350","51414494","51414494","0","2024-09"
"025900","동화기업","516416770620","11290","45741078","50557285","4816207","2024-09"
"000020","동화약품","211487805900","7630","27717930","27931470","213540","2024-09"
"000150","두산","2711355284500","200500","13522969","16523835","3000866","2024-09"
"454910","두산로보틱스","4323492666000","66700","64819980","64819980","0","2024-09"
"241560","두산밥캣","4088766737650","40850","100092209","100249166","156957","2024-09"
"034020","두산에너빌리티","12873349876800","20100","640465168","640561146","95978","2024-09"
"131970","두산테스나","499076899500","29500","16917861","17006566","88705","2024-09"
"336260","두산퓨얼셀","1134160000280","17320","65482679","65493726","11047","2024-09"
"016740","두올","108717820620","3490","31151238","32066680","915442","2024-09"
"073190","듀오백","28101132520","2540","11063438","11968040","904602","2024-09"
"030350","드래곤플라이","16930909412","244","69388973","69388973","0","2024-09"
"203650","드림시큐리티","160872356700","3300","48749199","50605754","1856555","2024-09"
"223250","드림씨아이에스","109595887020","4605","23799324","23799324","0","2024-09"
"060570","드림어스컴퍼니","171282862845","2265","75621573","75621573","0","2024-09"
"362990","드림인사이트","36155579040","2205","16397088","16800574","403486","2024-09"
"192650","드림텍","578624092290","8570","67517397","68883113","1365716","2024-09"
"217620","디딤이앤에프","21715711458","381","56996618","57747210","750592","2024-09"
"016670","디모아","19519356710","3955","4935362","4941846","6484","2024-09"
"187870","디바이스이엔지","90878546720","13520","6721786","7036609","314823","2024-09"
"024090","디씨엠","107277927840","12360","8679444","11400000","2720556","2024-09"
"003160","디아이","477928046530","18370","26016769","28300000","2283231","2024-09"
"092200","디아이씨","141034985000","3640","38745875","38888569","142694","2024-09"
"110990","디아이티","250732442400","13600","18436209","18900000","463791","2024-09"
"263690","디알젬","78148022760","7130","10960452","11325610","365158","2024-09"
"214680","디알텍","214545523440","2910","73726984","73727108","124","2024-09"
"347850","디앤디파마텍","479512169500","45500","10538729","10538729","0","2024-09"
"263720","디앤씨미디어","221068245710","17810","12412591","12524473","111882","2024-09"
"376300","디어유","583964787600","24600","23738406","23738406","0","2024-09"
"109740","디에스케이","130048666800","5160","25203230","25710390","507160","2024-09"
"196490","디에이테크놀로지","36209568780","203","178372260","178549360","177100","2024-09"
"066900","디에이피","42329185665","2405","17600493","22744503","5144010","2024-09"
"127120","디엔에이링크","79705223435","3545","22483843","22483843","0","2024-09"
"092070","디엔에프","124166036340","10730","11571858","11571858","0","2024-09"
"039840","디오","233833165840","16180","14451988","14981755","529767","2024-09"
"013570","디와이","114218354330","4630","24669191","26319633","1650442","2024-09"
"219550","디와이디","39799901037","507","78500791","78500791","0","2024-09"
"310870","디와이씨","24802858113","1199","20686287","20687271","984","2024-09"
"210540","디와이파워","138168854520","12520","11035851","11041708","5857","2024-09"
"104460","디와이피엔에프","103329775180","10690","9666022","10713625","1047603","2024-09"
"079810","디이엔티","163239362730","7470","21852659","22028094","175435","2024-09"
"113810","디젠스","28680056829","879","32628051","32628051","0","2024-09"
"043360","디지아이","18237246605","2045","8917969","9000000","82031","2024-09"
"197140","디지캡","34005646320","2680","12688674","13013154","324480","2024-09"
"068930","디지털대성","193644604000","7390","26203600","27675342","1471742","2024-09"
"033130","디지틀조선","62576340162","1686","37115267","37115267","0","2024-09"
"105740","디케이락","75653736720","7440","10168513","10168513","0","2024-09"
"263020","디케이앤디","50442627090","3390","14879831","15069831","190000","2024-09"
"290550","디케이티","170010455000","8500","20001230","20001230","0","2024-09"
"066670","디티씨","51409751350","3275","15697634","18691918","2994284","2024-09"
"187220","디티앤씨","38205152895","3315","11524933","11698021","173088","2024-09"
"383930","디티앤씨알오","90032109600","7050","12770512","12770512","0","2024-09"
"131180","딜리","28064729610","1010","27786861","29350000","1563139","2024-09"
"315640","딥노이드","140132925000","6250","22421268","22421268","0","2024-09"
"223310","딥마인드","53203471640","2330","22834108","22839375","5267","2024-09"
"317120","라닉스","33720015000","3500","9634290","9660000","25710","2024-09"
"462510","라메디텍","90832717500","10500","8650735","8650735","0","2024-09"
"042510","라온시큐어","104008630960","1924","54058540","56025871","1967331","2024-09"
"232680","라온테크","78427404440","6430","12197108","12534234","337126","2024-09"
"418420","라온텍","103159246740","3435","30031804","30108433","76629","2024-09"
"300120","라온피플","110140863360","5280","20860012","20860012","0","2024-09"
"171120","라이온켐텍","85592072500","2425","35295700","35901760","606060","2024-09"
"388790","라이콤","91383045495","3065","29815023","29913930","98907","2024-09"
"347700","라이프시맨틱스","72379789540","3620","19994417","19994417","0","2024-09"
"214260","라파스","160914014600","19160","8398435","8912435","514000","2024-09"
"115390","락앤락","374666722800","8650","43314072","43326411","12339","2024-09"
"200350","래몽래인","128948722500","12900","9996025","9996025","0","2024-09"
"171010","램테크놀러지","54621232640","3820","14298752","14298752","0","2024-09"
"084650","랩지노믹스","257612765300","3470","74239990","74239990","0","2024-09"
"217500","러셀","52359212570","1805","29007874","31812000","2804126","2024-09"
"038390","레드캡투어","130087995160","15560","8360411","8589480","229069","2024-09"
"294140","레몬","91745016710","4370","20994283","21000000","5717","2024-09"
"443250","레뷰코퍼레이션","92779293600","8610","10775760","11279386","503626","2024-09"
"228670","레이","139147380920","8980","15495254","15495254","0","2024-09"
"228850","레이언스","108896164800","6920","15736440","16591014","854574","2024-09"
"412350","레이저쎌","45467524120","5210","8726972","8726972","0","2024-09"
"199550","레이저옵텍","81587541000","7000","11655363","11656947","1584","2024-09"
"281740","레이크머티리얼즈","959008140900","14590","65730510","65730548","38","2024-09"
"277810","레인보우로보틱스","2490941767200","128400","19399858","19399858","0","2024-09"
"215100","로보로보","66717110575","3295","20247985","20348454","100469","2024-09"
"090360","로보스타","206700000000","21200","9750000","9750000","0","2024-09"
"108490","로보티즈","232254114420","18010","12895842","13051842","156000","2024-09"
"067730","로지시스","25442414860","2630","9673922","9673922","0","2024-09"
"071280","로체시스템즈","291609148950","19550","14916069","15296603","380534","2024-09"
"032350","롯데관광개발","736817089610","9670","76196183","76196183","0","2024-09"
"089860","롯데렌탈","1057030233300","29100","36324063","36634063","310000","2024-09"
"000400","롯데손해보험","695497567500","2250","309110030","310336320","1226290","2024-09"
"023530","롯데쇼핑","1809320960000","64000","28270640","28288755","18115","2024-09"
"020150","롯데에너지머티리얼즈","1696878728000","36800","46110835","46110835","0","2024-09"
"280360","롯데웰푸드","1153785343500","130500","8841267","9434574","593307","2024-09"
"286940","롯데이노베이트","344949567600","22800","15129367","15129367","0","2024-09"
"004000","롯데정밀화학","1161432000000","45600","25470000","25800000","330000","2024-09"
"004990","롯데지주","1688706405000","23850","70805300","104909237","34103937","2024-09"
"005300","롯데칠성","1100475642400","118600","9278884","9278884","0","2024-09"
"011170","롯데케미칼","3913111241600","92800","42167147","42775419","608272","2024-09"
"071840","롯데하이마트","185085696000","8000","23135712","23607712","472000","2024-09"
"328130","루닛","1143376819200","39600","28873152","28873152","0","2024-09"
"038060","루멘스","59407290215","1235","48103069","48103069","0","2024-09"
"474170","루미르","191103313440","11140","17154696","17154696",,"자료 없음"
"141080","리가켐바이오","4659057809200","127900","36427348","36567348","140000","2024-09"
"058470","리노공업","2855192472000","188100","15179120","15242370","63250","2024-09"
"016100","리더스코스메틱","48956658090","2670","18335827","19100894","765067","2024-09"
"012700","리드코프","111721528980","4365","25594852","26446135","851283","2024-09"
"302550","리메드","101871616000","3325","30638080","30638080","0","2024-09"
"073570","리튬포어스","61840382043","1709","36185127","36189497","4370","2024-09"
"377450","리파인","215152731000","14150","15205140","17330000","2124860","2024-09"
"277070","린드먼아시아","51311272500","4050","12669450","13692000","1022550","2024-09"
"042500","링네트","75356498880","4680","16101816","19070134","2968318","2024-09"
"193250","링크드","28242226142","446","63323377","63323377","0","2024-09"
"219420","링크제니시스","49689752155","4415","11254757","11469507","214750","2024-09"
"439090","마녀공장","314790157200","19220","16378260","16378260","0","2024-09"
"027740","마니커","58802127868","926","63501218","63511228","10010","2024-09"
"195500","마니커에프앤지","46575870000","2915","15978000","15978000","0","2024-09"
"377480","마음AI","66073615140","10590","6239246","6239246","0","2024-09"
"305090","마이크로디지탈","232508673400","14060","16536890","16536890","0","2024-09"
"098120","마이크로컨텍솔","45138319380","5430","8312766","8312766","0","2024-09"
"424980","마이크로투나노","49541109300","8370","5918890","5918890","0","2024-09"
"038290","마크로젠","181419256260","18180","9979057","10841400","862343","2024-09"
"001080","만호제강","94301886800","31900","2956172","4150000","1193828","2024-09"
"267980","매일유업","275677634400","38200","7216692","7843638","626946","2024-09"
"005990","매일홀딩스","104955690000","8400","12494725","13718304","1223579","2024-09"
"093520","매커스","87053568340","8870","9814382","16163092","6348710","2024-09"
"377030","맥스트","46089427110","2355","19570882","19570882","0","2024-09"
"100590","머큐리","55246780270","3490","15830023","15830023","0","2024-09"
"067280","멀티캠퍼스","180174081600","30400","5926779","5926779","0","2024-09"
"072870","메가스터디","125819232060","11030","11407002","11920959","513957","2024-09"
"215200","메가스터디교육","458330290200","42600","10758927","11461955","703028","2024-09"
"133750","메가엠디","44260344925","2005","22074985","23407077","1332092","2024-09"
"446540","메가터치","86615070000","4170","20771000","20771000","0","2024-09"
"235980","메드팩토","197118679650","5870","33580695","33580695","0","2024-09"
"041920","메디아나","86117704000","4640","18559850","18598223","38373","2024-09"
"014100","메디앙스","25935136335","2295","11300713","11800000","499287","2024-09"
"054180","메디콕스","23489619972","399","58871228","58878283","7055","2024-09"
"086900","메디톡스","1138262153600","169100","6731296","7298497","567201","2024-09"
"078160","메디포스트","226074944550","6630","34098785","34217785","119000","2024-09"
"138040","메리츠금융지주","19111638469300","103300","185011021","190720114","5709093","2024-09"
"408920","메쎄이상","93608341650","2175","43038318","43232455","194137","2024-09"
"021880","메이슨캐피탈","47633719704","313","152184408","152184408","0","2024-09"
"140410","메지온","895771648200","29900","29958918","29958918","0","2024-09"
"241770","메카로","74739868500","7590","9847150","10192640","345490","2024-09"
"090370","메타랩스","39792803142","1598","24901629","24904689","3060","2024-09"
"059210","메타바이오메드","89883454440","3930","22871108","23862351","991243","2024-09"
"118000","메타케어","57012222660","346","164775210","164777364","2154","2024-09"
"058110","멕아이씨에스","40293578000","2600","15497530","16050530","553000","2024-09"
"017180","명문제약","76049453025","2275","33428331","33953454","525123","2024-09"
"009900","명신산업","617048764080","11760","52470133","52470133","0","2024-09"
"012690","모나리자","111327559875","3045","36560775","36571255","10480","2024-09"
"005360","모나미","42802400355","2265","18897307","18897307","0","2024-09"
"070960","모나용평","183068349210","3870","47304483","48133333","828850","2024-09"
"434480","모니터랩","43351445500","3685","11764300","12253300","489000","2024-09"
"080420","모다이노칩","152587184508","1914","79721622","79721622","0","2024-09"
"417970","모델솔루션","60704683000","9490","6396700","6396700","0","2024-09"
"080160","모두투어","173815381560","10040","17312289","18900000","1587711","2024-09"
"087260","모바일어플라이언스","70639708370","2170","32552861","32552861","0","2024-09"
"101330","모베이스","73839022510","3190","23147029","23147029","0","2024-09"
"012860","모베이스전자","127844373296","1759","72680144","73233457","553313","2024-09"
"363260","모비데이즈","83599432900","2635","31726540","32163769","437229","2024-09"
"348030","모비릭스","49267494000","5130","9603800","9603800","0","2024-09"
"250060","모비스","105416163230","3290","32041387","32171314","129927","2024-09"
"288980","모아데이타","56534535432","1636","34556562","34556562","0","2024-09"
"142760","모아라이프플러스","49885420142","1322","37734811","37734811","0","2024-09"
"033200","모아텍","29638583380","3220","9204529","14331185","5126656","2024-09"
"333050","모코엠시스","29719636032","1293","22985024","24444326","1459302","2024-09"
"009680","모토닉","187078947600","8650","21627624","33000000","11372376","2024-09"
"118990","모트렉스","247950220000","10000","24795022","24861990","66968","2024-09"
"006920","모헨즈","28119000000","2575","10920000","10920000","0","2024-09"
"009580","무림P&P","175242216180","2810","62363778","62368324","4546","2024-09"
"001810","무림SP","35110075000","1586","22137500","22137500","0","2024-09"
"009200","무림페이퍼","84882992400","2040","41609310","41609310","0","2024-09"
"033920","무학","151504884960","5720","26486868","28500000","2013132","2024-09"
"008420","문배철강","43659959400","2280","19149105","20503505","1354400","2024-09"
"279600","미디어젠","52938025300","11300","4684781","4684781","0","2024-09"
"095500","미래나노텍","293654164050","10350","28372383","31009999","2637616","2024-09"
"254490","미래반도체","244724100000","16950","14438000","14438000","0","2024-09"
"025560","미래산업","31643995640","1016","31145665","31166865","21200","2024-09"
"218150","미래생명자원","92506474905","4745","19495569","20415802","920233","2024-09"
"007120","미래아이앤지","28334069218","1037","27323114","28878608","1555494","2024-09"
"442900","미래에셋드림스팩1호","76569600000","9970","7680000","7680000","0","2024-09"
"100790","미래에셋벤처투자","256572391740","4830","53120578","53124634","4056","2024-09"
"412930","미래에셋비전스팩1호","16366400000","2650","6176000","6176000","0","2024-09"
"446190","미래에셋비전스팩2호","10865250000","2195","4950000","4950000","0","2024-09"
"448830","미래에셋비전스팩3호","10701000000","2175","4920000","4920000","0","2024-09"
"477380","미래에셋비전스팩4호","16321500000","2015","8100000","8100000","0","2024-09"
"477470","미래에셋비전스팩5호","11343600000","2070","5480000","5480000","0","2024-09"
"478440","미래에셋비전스팩6호","13963950000","2015","6930000","6930000","0","2024-09"
"482680","미래에셋비전스팩7호","16347850000","1990","8215000","8215000","0","2024-09"
"085620","미래에셋생명","679800800000","5210","130480000","177016189","46536189","2024-09"
"006800","미래에셋증권","4051353935420","9020","449152321","595316408","146164087","2024-09"
"049950","미래컴퍼니","150051086970","18930","7926629","8817884","891255","2024-09"
"207760","미스터블루","116572956725","1415","82383715","83079783","696068","2024-09"
"002840","미원상사","923265966000","198800","4644195","4750000","105805","2024-09"
"268280","미원에스씨","717328712100","146900","4883109","5000000","116891","2024-09"
"107590","미원홀딩스","184309820000","79600","2315450","2320000","4550","2024-09"
"134380","미원화학","160003105800","79900","2002542","2199268","196726","2024-09"
"003650","미창석유","142976515500","94500","1512979","1739672","226693","2024-09"
"059090","미코","331968862380","10540","31496097","33416778","1920681","2024-09"
"214610","미코바이오메드","81935575623","1881","43559583","43568945","9362","2024-09"
"201490","미투온","65489782280","2140","30602702","31257770","655068","2024-09"
"452200","민테크","149447493000","6810","21945300","21945300","0","2024-09"
"418470","밀리의서재","118820060220","13980","8499289","8499289","0","2024-09"
"206640","바디텍메드","339535318200","15450","21976396","23486560","1510164","2024-09"
"018700","바른손","39935978880","1160","34427568","35119757","692189","2024-09"
"035620","바른손이앤에이","36019607035","485","74267231","74439675","172444","2024-09"
"053030","바이넥스","661785070400","21400","30924536","31761048","836512","2024-09"
"301300","바이브컴퍼니","52891689375","4275","12372325","12394861","22536","2024-09"
"377740","바이오노트","471936534400","4640","101710460","102056048","345588","2024-09"
"064550","바이오니아","642676245900","24900","25810291","25810291","0","2024-09"
"314930","바이오다인","563006116000","19100","29476760","29764103","287343","2024-09"
"208710","바이오로그디바이스","30380206104","461","65900664","65900664","0","2024-09"
"086820","바이오솔루션","130784973400","16300","8023618","8143426","119808","2024-09"
"038460","바이오스마트","83416818400","3620","23043320","23933216","889896","2024-09"
"251120","바이오에프디엔씨","141580553400","16600","8528949","8695700","166751","2024-09"
"199730","바이오인프라","43876590340","9020","4864367","4864367","0","2024-09"
"086040","바이오톡스텍","71686797840","4560","15720789","15958247","237458","2024-09"
"099430","바이오플러스","319232209590","5670","56301977","57930864","1628887","2024-09"
"032980","바이온","29456692580","658","44767010","44777990","10980","2024-09"
"308080","바이젠셀","62703473700","3255","19263740","19263740","0","2024-09"
"043150","바텍","349075016000","23500","14854256","14854256","0","2024-09"
"323990","박셀바이오","303131994000","13200","22964545","22993200","28655","2024-09"
"003610","방림","113969352980","3220","35394209","42314090","6919881","2024-09"
"267790","배럴","37312605000","4730","7888500","7888500","0","2024-09"
"001340","백광산업","423831427200","9600","44149107","44918407","769300","2024-09"
"046310","백금T&A","39159774705","2435","16082043","16418641","336598","2024-09"
"035150","백산","297345000000","13830","21500000","21500000","0","2024-09"
"331520","밸로프","34242807872","698","49058464","50864390","1805926","2024-09"
"199480","뱅크웨어글로벌","76570416040","7580","10101638","10101638","0","2024-09"
"438700","버넥트","39230012800","3520","11144890","11144890","0","2024-09"
"066410","버킷스튜디오","96977294204","1153","84108668","84109926","1258","2024-09"
"002410","범양건영","26642538496","1073","24829952","24831982","2030","2024-09"
"382900","범한퓨얼셀","124274600000","14480","8582500","8761000","178500","2024-09"
"206400","베노티앤알","129677720000","4000","32419430","32420452","1022","2024-09"
"019010","베뉴지","87837000000","2185","40200000","48200000","8000000","2024-09"
"177350","베셀","24174056631","271","89203161","89372043","168882","2024-09"
"424760","벨로크","20828722104","1074","19393596","19665002","271406","2024-09"
"007210","벽산","114482954825","2045","55981885","67560000","11578115","2024-09"
"225530","보광산업","143355583695","3945","36338551","36338727","176","2024-09"
"250000","보라티알","64313202920","9820","6549206","6750733","201527","2024-09"
"002760","보락","77211100000","1289","59900000","59900000","0","2024-09"
"003850","보령","731768038100","11110","65865710","68690000","2824290","2024-09"
"310210","보로노이","2061026326800","114800","17953191","18356592","403401","2024-09"
"006910","보성파워텍","160734471840","3285","48929824","49129824","200000","2024-09"
"000890","보해양조","58550824232","421","139075592","139120129","44537","2024-09"
"226340","본느","71864426940","1713","41952380","41952420","40","2024-09"
"003000","부광약품","348434275390","5090","68454671","68454671","0","2024-09"
"001270","부국증권","165998459900","27950","5939122","10369886","4430764","2024-09"
"026940","부국철강","50400000000","2520","20000000","20000000","0","2024-09"
"014470","부방","90696352890","1690","53666481","60052260","6385779","2024-09"
"011390","부산산업","58819200000","55700","1056000","1056000","0","2024-09"
"005030","부산주공","38288532168","486","78782988","78782988","0","2024-09"
"008470","부스타","32488880220","4020","8081811","8404800","322989","2024-09"
"338220","뷰노","427062672750","30750","13888217","13888217","0","2024-09"
"100120","뷰웍스","233220539400","25400","9181911","10001865","819954","2024-09"
"406820","뷰티스킨","49971325600","14140","3534040","3534040","0","2024-09"
"337930","브랜드엑스코퍼레이션","256769151720","8760","29311547","29311547","0","2024-09"
"099390","브레인즈컴퍼니","48606531150","6150","7903501","8208283","304782","2024-09"
"064480","브리지텍","59227219940","5110","11590454","11952500","362046","2024-09"
"288330","브릿지바이오테라퓨틱스","248273582580","5220","47561989","47561989","0","2024-09"
"365900","브이씨","24270196000","3320","7310300","7310300","0","2024-09"
"089970","브이엠","187476865840","8510","22030184","24075595","2045411","2024-09"
"251630","브이원텍","64637301575","4235","15262645","15942886","680241","2024-09"
"018290","브이티","1082522073500","30500","35492527","35798007","305480","2024-09"
"439580","블루엠텍","265851259800","23800","11170221","11170221","0","2024-09"
"033560","블루콤","59557712030","3490","17065247","17100000","34753","2024-09"
"369370","블리츠웨이스튜디오","79082969380","1660","47640343","49871911","2231568","2024-09"
"126340","비나텍","221097093800","37400","5911687","6085118","173431","2024-09"
"121800","비덴트","256296018720","3320","77197596","77201611","4015","2024-09"
"082800","비보존 제약","196485871440","4135","47517744","48242965","725221","2024-09"
"318410","비비씨","47164013070","8490","5555243","5555243","0","2024-09"
"002070","비비안","25205715540","846","29793990","29793990","0","2024-09"
"100220","비상교육","63340332550","5170","12251515","12996741","745226","2024-09"
"419540","비스토스","44256625875","1925","22990455","22992511","2056","2024-09"
"146320","비씨엔씨","177990966080","14020","12695504","12792923","97419","2024-09"
"200780","비씨월드제약","41602125450","4930","8438565","8892384","453819","2024-09"
"413640","비아이매트릭스","55997923800","7770","7206940","7206940","0","2024-09"
"141000","비아트론","74244141870","6730","11031819","12114710","1082891","2024-09"
"090460","비에이치","540087851310","17210","31382211","34464379","3082168","2024-09"
"083650","비에이치아이","323345300300","10450","30942134","30944375","2241","2024-09"
"445360","비엔케이제1호스팩","9051000000","2100","4310000","4310000","0","2024-09"
"473370","비엔케이제2호스팩","8483150000","2015","4210000","4210000","0","2024-09"
"065170","비엘팜텍","21441469232","241","88968752","88970559","1807","2024-09"
"086670","비엠티","81852810780","8970","9125174","9125174","0","2024-09"
"335890","비올","502363578000","8700","57742940","58419125","676185","2024-09"
"230980","비유테크놀러지","21370405721","229","93320549","93320557","8","2024-09"
"138580","비즈니스온","356042480800","15850","22463248","22556163","92915","2024-09"
"082920","비츠로셀","446923171800","19950","22402164","22872213","470049","2024-09"
"054220","비츠로시스","22023948352","448","49160599","49160599","0","2024-09"
"042370","비츠로테크","183662175250","7010","26200025","26200025","0","2024-09"
"050090","비케이홀딩스","15584088205","791","19701755","19784735","82980","2024-09"
"148780","비큐AI","33804154375","1075","31445725","31445725","0","2024-09"
"307870","비투엔","44301325662","978","45297879","45297879","0","2024-09"
"357880","비트나인","19937512004","1909","10443956","10443956","0","2024-09"
"032850","비트컴퓨터","78990234400","4900","16120456","16623293","502837","2024-09"
"238200","비피도","35010400000","4280","8180000","8180000","0","2024-09"
"093190","빅솔론","68328085060","4540","15050239","19238905","4188666","2024-09"
"065450","빅텍","143550528000","5010","28652800","28652800","0","2024-09"
"210120","빅텐츠","79558633000","25300","3144610","3144610","0","2024-09"
"044480","빌리언스","24804874080","610","40663728","40663728","0","2024-09"
"005180","빙그레","557033463000","63000","8841801","9851241","1009440","2024-09"
"069540","빛과전자","61593963320","1451","42449320","42449320","0","2024-09"
"072950","빛샘전자","31802177280","3970","8010624","8052610","41986","2024-09"
"451250","삐아","105006112290","11070","9485647","9682187","196540","2024-09"
"143240","사람인","180865324920","16660","10856262","11709263","853001","2024-09"
"003960","사조대림","363662576550","43550","8350461","9164467","814006","2024-09"
"008040","사조동아원","146302149372","1038","140946194","141144600","198406","2024-09"
"007160","사조산업","300079300000","60100","4993000","5000000","7000","2024-09"
"014710","사조씨푸드","115880794390","6730","17218543","17218543","0","2024-09"
"006090","사조오양","84145032480","8930","9422736","9422739","3","2024-09"
"452430","사피엔반도체","97144368000","12000","8095364","8096454","1090","2024-09"
"419120","산돌","47775967930","6530","7316381","7774326","457945","2024-09"
"062040","산일전기","1298935109250","42750","30384447","30445200","60753","2024-09"
"122350","삼기","59030238240","1555","37961568","38339428","377860","2024-09"
"419050","삼기이브이","130693408400","2285","57196240","57196240","0","2024-09"
"014970","삼륭물산","59249941600","3980","14886920","15125000","238080","2024-09"
"018310","삼목에스폼","336433122300","23650","14225502","14700000","474498","2024-09"
"053700","삼보모터스","94139628660","4235","22228956","22877190","648234","2024-09"
"009620","삼보산업","19331548694","262","73784537","73785902","1365","2024-09"
"023600","삼보판지","144527206440","9220","15675402","16170000","494598","2024-09"
"001470","삼부토건","104426721808","467","223611824","223611824","0","2024-09"
"028050","삼성E&A","3939600000000","20100","196000000","196000000","0","2024-09"
"006400","삼성SDI","21658369009000","331000","65433139","68764530","3331391","2024-09"
"006660","삼성공조","83717157900","10650","7860766","8126314","265548","2024-09"
"028260","삼성물산","21616938547300","133300","162167581","177784107","15616526","2024-09"
"207940","삼성바이오로직스","75373266000000","1059000","71174000","71174000","0","2024-09"
"032830","삼성생명","17795860598900","99100","179574779","200000000","20425221","2024-09"
"425290","삼성스팩6호","11674800000","2115","5520000","5520000","0","2024-09"
"439250","삼성스팩7호","36420800000","10400","3502000","3502000","0","2024-09"
"448740","삼성스팩8호","46873200000","10050","4664000","4664000","0","2024-09"
"468510","삼성스팩9호","22321000000","2020","11050000","11050000","0","2024-09"
"018260","삼성에스디에스","11238982025800","145300","77350186","77377800","27614","2024-09"
"009150","삼성전기","8919516499200","122700","72693696","74693696","2000000","2024-09"
"005930","삼성전자","352814148705000","59100","5969782550","5969782550","0","2024-09"
"001360","삼성제약","162451630896","1726","94120296","94162079","41783","2024-09"
"010140","삼성중공업","8659920689940","10140","854035571","880000000","25964429","2024-09"
"016360","삼성증권","4237285000000","47450","89300000","89300000","0","2024-09"
"068290","삼성출판사","143500000000","14350","10000000","10000000","0","2024-09"
"029780","삼성카드","4332454217000","40600","106710695","115858891","9148196","2024-09"
"000810","삼성화재","14557242188000","365500","39828296","47374837","7546541","2024-09"
"006110","삼아알미늄","737066991600","50100","14711916","14711916","0","2024-09"
"009300","삼아제약","133358022700","21850","6103342","6370000","266658","2024-09"
"145990","삼양사","481867547500","49850","9666350","10313449","647099","2024-09"
"003230","삼양식품","4057221632000","544000","7458128","7533015","74887","2024-09"
"002170","삼양통상","128183000000","47300","2710000","3000000","290000","2024-09"
"272550","삼양패키징","249847911810","16110","15508871","15788671","279800","2024-09"
"000070","삼양홀딩스","536102794500","72100","7435545","8564271","1128726","2024-09"
"003720","삼영","152885786450","4610","33163945","34000000","836055","2024-09"
"002810","삼영무역","223700639760","12690","17628104","18466948","838844","2024-09"
"361670","삼영에스앤씨","38043037560","6820","5578158","5667658","89500","2024-09"
"054540","삼영엠텍","49551050000","4085","12130000","13000000","870000","2024-09"
"065570","삼영이엔씨","28588100100","2100","13613381","13613381","0","2024-09"
"005680","삼영전자","194976847360","9760","19977136","20000000","22864","2024-09"
"023000","삼원강재","102926486040","2590","39739956","40000000","260044","2024-09"
"004380","삼익THK","187956000000","9080","20700000","21000000","300000","2024-09"
"002450","삼익악기","83481944670","1098","76030915","90530915","14500000","2024-09"
"032280","삼일","23173015680","1494","15510720","16213590","702870","2024-09"
"002290","삼일기업공사","35526000000","2865","12400000","12400000","0","2024-09"
"004440","삼일씨엔에스","53665156605","4215","12731947","12731947","0","2024-09"
"000520","삼일제약","357586119800","16900","21158942","21621100","462158","2024-09"
"009770","삼정펄프","66749225700","26700","2499971","2499971","0","2024-09"
"037460","삼지전자","134329230000","8750","15351912","16318522","966610","2024-09"
"032750","삼진","37634491860","4170","9025058","9031122","6064","2024-09"
"054090","삼진엘앤디","22432210565","905","24786973","24959232","172259","2024-09"
"005500","삼진제약","230378518200","18390","12527380","13900000","1372620","2024-09"
"000250","삼천당제약","2983933657600","128300","23257472","23457472","200000","2024-09"
"004690","삼천리","304738225000","89000","3424025","4055025","631000","2024-09"
"024950","삼천리자전거","49499912120","4090","12102668","13273577","1170909","2024-09"
"038500","삼표시멘트","324207727040","3020","107353552","107916306","562754","2024-09"
"437730","삼현","82122598530","7770","10569189","10569189","0","2024-09"
"017480","삼현철강","74357515350","4815","15442890","15702890","260000","2024-09"
"010960","삼호개발","70434000000","3150","22360000","25000000","2640000","2024-09"
"046390","삼화네트웍스","68489637780","1730","39589386","43172933","3583547","2024-09"
"004450","삼화왕관","56926264450","31550","1804319","2154379","350060","2024-09"
"009470","삼화전기","258600362000","39100","6613820","6613820","0","2024-09"
"011230","삼화전자","50026687680","2960","16900908","16902700","1792","2024-09"
"001820","삼화콘덴서","348360950000","33950","10261000","10395000","134000","2024-09"
"000390","삼화페인트","167965570400","7120","23590670","27203469","3612799","2024-09"
"027580","상보","68894333189","1223","56332243","59181279","2849036","2024-09"
"038540","상상인","89310018432","1632","54724276","55328313","604037","2024-09"
"415580","상상인제3호스팩","11097900000","2090","5310000","5310000","0","2024-09"
"452670","상상인제4호스팩","10466100000","2005","5220000","5220000","0","2024-09"
"001290","상상인증권","50794115998","478","106263841","108337120","2073279","2024-09"
"041650","상신브레이크","66502664850","3435","19360310","21471450","2111140","2024-09"
"091580","상신이디피","135014858470","10130","13328219","13428219","100000","2024-09"
"263810","상신전자","47066792535","3305","14241087","14244718","3631","2024-09"
"089980","상아프론테크","331299038750","21250","15590543","15989037","398494","2024-09"
"042940","상지건설","24431342440","6140","3979046","3981814","2768","2024-09"
"042600","새로닉스","165248497190","13510","12231569","12423574","192005","2024-09"
"075180","새론오토모티브","74880000000","3900","19200000","19200000","0","2024-09"
"107600","새빗켐","114077380500","22900","4981545","4981545","0","2024-09"
"411080","샌즈랩","104022761700","7150","14548638","15248638","700000","2024-09"
"252990","샘씨엔에스","328399914240","5760","57013874","58388063","1374189","2024-09"
"007540","샘표","89083685600","44200","2015468","2875800","860332","2024-09"
"248170","샘표식품","129462996600","28350","4566596","4568286","1690","2024-09"
"378800","샤페론","162169506780","5380","30143031","30143031","0","2024-09"
"294630","서남","88484203710","3690","23979459","23979459","0","2024-09"
"038070","서린바이오","61642616200","7300","8444194","8900676","456482","2024-09"
"006730","서부T&D","394707882240","6120","64494752","66426923","1932171","2024-09"
"079650","서산","24220000000","1211","20000000","20000000","0","2024-09"
"100660","서암기계공업","47502000000","3770","12600000","12600000","0","2024-09"
"007860","서연","151299783420","6970","21707286","23479844","1772558","2024-09"
"200880","서연이화","377507831470","13970","27022751","27028437","5686","2024-09"
"019770","서연탑메탈","42406000000","3640","11650000","11650000","0","2024-09"
"017390","서울가스","203070021600","52300","3882792","5000000","1117208","2024-09"
"043710","서울리거","32930113008","656","50198343","50198880","537","2024-09"
"092190","서울바이오시스","185886886830","4110","45227953","45868383","640430","2024-09"
"046890","서울반도체","527729342400","9360","56381340","58305400","1924060","2024-09"
"004410","서울식품","58836599213","157","374755409","374755559","150","2024-09"
"063170","서울옥션","117185645280","6960","16837018","17774267","937249","2024-09"
"027040","서울전자통신","18927981696","272","69588168","69588847","679","2024-09"
"018680","서울제약","47103648760","4040","11659319","11659319","0","2024-09"
"021050","서원","61147271920","1288","47474590","47474590","0","2024-09"
"093920","서원인텍","107508000000","5780","18600000","18600000","0","2024-09"
"189860","서전기전","50239680400","5180","9698780","9698780","0","2024-09"
"178320","서진시스템","1496195576400","26600","56247954","56247954","0","2024-09"
"122690","서진오토모티브","50934488080","2345","21720464","21844410","123946","2024-09"
"140070","서플러스글로벌","115410762900","3350","34450974","36988000","2537026","2024-09"
"011370","서한","78163112540","796","98194865","100894865","2700000","2024-09"
"065710","서호전기","106747100300","21650","4930582","5150000","219418","2024-09"
"008490","서흥","182242262070","16390","11119113","11569113","450000","2024-09"
"035890","서희건설","273724864320","1416","193308520","229808457","36499937","2024-09"
"357550","석경에이티","249650100000","45900","5439000","5455000","16000","2024-09"
"003100","선광","98061100000","15590","6290000","6600000","310000","2024-09"
"007610","선도전기","50907057000","3000","16969019","18000000","1030981","2024-09"
"067370","선바이오","85768171010","6970","12305333","12313555","8222","2024-09"
"171090","선익시스템","424199178450","48450","8755401","9494405","739004","2024-09"
"136490","선진","159796277760","6720","23779208","23779604","396","2024-09"
"086710","선진뷰티사이언스","123465472800","10280","12010260","12203280","193020","2024-09"
"014620","성광벤드","355010099340","13260","26773009","28600000","1826991","2024-09"
"037350","성도이엔지","66256995000","4665","14203000","15470000","1267000","2024-09"
"014910","성문전자","25365368054","1222","20757257","22460985","1703728","2024-09"
"003080","성보화학","51516495230","2630","19588021","20020000","431979","2024-09"
"004980","성신양회","191956172120","7960","24115097","24516073","400976","2024-09"
"011300","성안머티리얼스","38241641828","467","81887884","81887884","0","2024-09"
"081580","성우전자","73058578695","4805","15204699","15508143","303444","2024-09"
"045300","성우테크론","26283840900","2685","9789140","10151583","362443","2024-09"
"015750","성우하이텍","505546867760","6320","79991593","80000000","8407","2024-09"
"365340","성일하이텍","655416738000","54000","12137347","12137347","0","2024-09"
"000180","성창기업지주","100442304000","1440","69751600","69751600","0","2024-09"
"080470","성창오토텍","30185500000","4135","7300000","7300000","0","2024-09"
"043260","성호전자","95468425785","1565","61002189","61002189","0","2024-09"
"148150","세경하이테크","229388299920","6480","35399429","35860429","461000","2024-09"
"002420","세기상사","32130141440","5780","5558848","5558848","0","2024-09"
"188260","세니젠","21081953970","2970","7098301","7228470","130169","2024-09"
"053060","세동","20552610648","1164","17656882","17657419","537","2024-09"
"340440","세림B&G","36664839828","1292","28378359","28378364","5","2024-09"
"017510","세명전기","79584120000","5220","15246000","15246000","0","2024-09"
"004360","세방","216324127440","12060","17937324","19308690","1371366","2024-09"
"004490","세방전지","947122416000","72000","13154478","14000000","845522","2024-09"
"011560","세보엠이씨","95705052300","9650","9917622","10530000","612378","2024-09"
"396300","세아메카닉스","78175657500","2985","26189500","26489500","300000","2024-09"
"001430","세아베스틸지주","706125123110","19690","35862119","35862119","0","2024-09"
"306200","세아제강","322011500000","115000","2800100","2836300","36200","2024-09"
"003030","세아제강지주","655766820300","162300","4040461","4141657","101196","2024-09"
"019440","세아특수강","114074359230","13670","8344869","8570000","225131","2024-09"
"058650","세아홀딩스","366966367800","94200","3895609","4000000","104391","2024-09"
"013000","세우글로벌","35103745763","1223","28702981","28705031","2050","2024-09"
"100700","세운메디칼","119266980500","2755","43291100","43800000","508900","2024-09"
"024830","세원물산","53440000000","6400","8350000","8350000","0","2024-09"
"091090","세원이앤씨","54828158060","1270","43171778","43180255","8477","2024-09"
"021820","세원정공","71000000000","7100","10000000","10000000","0","2024-09"
"067830","세이브존I&C","80711711420","2140","37715753","41040895","3325142","2024-09"
"258830","세종메디칼","22974088612","412","55762351","55786351","24000","2024-09"
"036630","세종텔레콤","94023153180","495","189945764","200000000","10054236","2024-09"
"039310","세중","30100088887","1661","18121667","18121667","0","2024-09"
"075580","세진중공업","429213392800","7550","56849456","56849456","0","2024-09"
"067770","세진티에스","20863657835","2515","8295689","8396593","100904","2024-09"
"053450","세코닉스","78115105980","5340","14628297","14792803","164506","2024-09"
"222810","세토피아","81189010800","1080","75175010","75659350","484340","2024-09"
"252500","세화피앤씨","38789774650","935","41486390","41486390","0","2024-09"
"321370","센서뷰","58746551350","2230","26343745","26343745","0","2024-09"
"347000","센코","80576300475","2475","32556081","33004976","448895","2024-09"
"331920","셀레믹스","32942337180","4035","8164148","8164148","0","2024-09"
"049180","셀루메드","153655825470","3010","51048447","51057455","9008","2024-09"
"299660","셀리드","105303855230","4990","21102977","21102977","0","2024-09"
"268600","셀리버리","248384003120","6680","37183234","37183234","0","2024-09"
"108860","셀바스AI","282599898000","10500","26914276","26914790","514","2024-09"
"208370","셀바스헬스케어","109299710750","4250","25717579","25740564","22985","2024-09"
"318160","셀바이오휴먼텍","30409931475","3465","8776315","9260901","484586","2024-09"
"308430","셀비온","234015595330","18370","12739009","12739009","0","2024-09"
"068270","셀트리온","38271823487100","185700","206094903","217021190","10926287","2024-09"
"068760","셀트리온제약","2620026309300","63300","41390621","41600387","209766","2024-09"
"068940","셀피글로벌","29334496224","778","37705008","38260597","555589","2024-09"
"060230","소니드","39083058924","854","45764706","46066730","302024","2024-09"
"290690","소룩스","425526738720","9340","45559608","45564340","4732","2024-09"
"032680","소프트센","42650277872","409","104279408","105590764","1311356","2024-09"
"258790","소프트캠프","21341000280","890","23978652","24991284","1012632","2024-09"
"066910","손오공","54736920875","1625","33684259","33784259","100000","2024-09"
"336370","솔루스첨단소재","857292158580","12210","70212298","70217344","5046","2024-09"
"248070","솔루엠","997755828000","20500","48671016","50005551","1334535","2024-09"
"035610","솔본","99844416050","3890","25666945","27345997","1679052","2024-09"
"357780","솔브레인","1545531143200","199600","7743142","7778566","35424","2024-09"
"036830","솔브레인홀딩스","1020682694200","49400","20661593","20964056","302463","2024-09"
"304100","솔트룩스","235454324880","19410","12130568","12130568","0","2024-09"
"328380","솔트웨어","38266397113","1117","34258189","34262778","4589","2024-09"
"004430","송원산업","304080000000","12670","24000000","24000000","0","2024-09"
"086980","쇼박스","263488360000","4220","62438000","62638000","200000","2024-09"
"050960","수산아이앤티","67510000000","10000","6751000","6751000","0","2024-09"
"126720","수산인더스트리","312446685000","22200","14074175","14286000","211825","2024-09"
"017550","수산중공업","106515314910","1707","62399130","62399130","0","2024-09"
"084180","수성웹툰","71539518057","609","117470473","117470473","0","2024-09"
"253840","수젠텍","93725664840","6130","15289668","16743200","1453532","2024-09"
"298830","슈어소프트테크","249223465900","4775","52193396","52619061","425665","2024-09"
"236200","슈프리마","183525263600","26600","6899446","7193273","293827","2024-09"
"094840","슈프리마에이치큐","54006346200","5900","9153618","10471840","1318222","2024-09"
"192440","슈피겐코리아","129339896400","21450","6029832","6216363","186531","2024-09"
"424960","스마트레이더시스템","168667272000","10800","15617340","15617340","0","2024-09"
"099440","스맥","120991421540","3245","37285492","40243394","2957902","2024-09"
"053210","스카이라이프","237414534640","5020","47293732","47522955","229223","2024-09"
"276040","스코넥","39483820730","3145","12554474","12554474","0","2024-09"
"159910","스킨앤스킨","26699002380","738","36177510","36410098","232588","2024-09"
"060240","스타코링크","17168208650","565","30386210","31136323","750113","2024-09"
"115570","스타플렉스","24104004990","3055","7890018","7984508","94490","2024-09"
"330730","스톤브릿지벤처스","66863593160","3835","17435096","18150830","715734","2024-09"
"352090","스톰테크","90024543300","3350","26872998","26872998","0","2024-09"
"253450","스튜디오드래곤","1167772647300","38850","30058498","30058498","0","2024-09"
"408900","스튜디오미르","152737258170","4670","32706051","32706134","83","2024-09"
"204630","스튜디오산타클로스","23613109200","4650","5078088","5089941","11853","2024-09"
"415380","스튜디오삼익","33653429000","8300","4054630","4225498","170868","2024-09"
"026890","스틱인베스트먼트","294581635400","8060","36548590","41678175","5129585","2024-09"
"013810","스페코","72324744450","4935","14655470","14655470","0","2024-09"
"203690","스피어파워","67168229100","5100","13170241","13337850","167609","2024-09"
"049830","승일","41352682000","7000","5907526","6132112","224586","2024-09"
"020710","시공테크","66587325450","3530","18863265","20047970","1184705","2024-09"
"033170","시그네틱스","82213457921","959","85728319","85728319","0","2024-09"
"048870","시너지이노베이션","237786489000","2875","82708344","82708344","0","2024-09"
"025320","시노펙스","557597382160","6680","83472662","83817936","345274","2024-09"
"134790","시디즈","50032948400","29800","1678958","2000000","321042","2024-09"
"269620","시스웍","131663951937","889","148103433","148582691","479258","2024-09"
"429270","시지트로닉스","31228312500","6930","4506250","4506250","0","2024-09"
"418250","시큐레터","52279100100","6550","7981542","7981542","0","2024-09"
"131090","시큐브","34716228180","894","38832470","44000000","5167530","2024-09"
"232830","시큐센","24878378000","2125","11707472","11707472","0","2024-09"
"462870","시프트업","3435915008000","58900","58334720","58334720","0","2024-09"
"016590","신대양제지","177285506740","5780","30672233","40297820","9625587","2024-09"
"290520","신도기연","34226156700","2175","15736164","15929362","193198","2024-09"
"029530","신도리코","349222549500","40500","8622779","10080029","1457250","2024-09"
"004970","신라교역","148852550000","9430","15785000","16000000","215000","2024-09"
"001000","신라섬유","25976967800","1070","24277540","24277540","0","2024-09"
"025870","신라에스지","24720000000","6180","4000000","4000000","0","2024-09"
"215600","신라젠","334992785000","2440","137292125","137367125","75000","2024-09"
"065350","신성델타테크","1251820805400","46050","27183948","27483948","300000","2024-09"
"416180","신성에스티","237252857000","26500","8952938","9039778","86840","2024-09"
"011930","신성이엔지","303109772511","1489","203565999","205848151","2282152","2024-09"
"005390","신성통상","325499503350","2265","143708390","143708390","0","2024-09"
"004170","신세계","1358125932800","147200","9226399","9845181","618782","2024-09"
"035510","신세계 I&C","133167055300","10130","13145810","17200000","4054190","2024-09"
"034300","신세계건설","138122020400","18200","7589122","7760554","171432","2024-09"
"031430","신세계인터내셔날","439442010000","12690","34629000","35700000","1071000","2024-09"
"031440","신세계푸드","136885486850","35350","3872291","3872480","189","2024-09"
"006880","신송홀딩스","69593571450","6450","10789701","11828858","1039157","2024-09"
"162300","신스틸","106035541920","2585","41019552","41471382","451830","2024-09"
"290560","신시웨이","24027690800","6200","3875434","3877972","2538","2024-09"
"002800","신신제약","90264475000","5950","15170500","15170500","0","2024-09"
"472220","신영스팩10호","10060050000","2145","4690000","4690000","0","2024-09"
"430220","신영스팩8호","14838200000","2195","6760000","6760000","0","2024-09"
"445970","신영스팩9호","11738400000","2190","5360000","5360000","0","2024-09"
"005800","신영와코루","81900000000","9100","9000000","9000000","0","2024-09"
"001720","신영증권","627775592000","81500","7702768","16440000","8737232","2024-09"
"009270","신원","93815445000","1250","75052356","102586356","27534000","2024-09"
"017000","신원종합개발","34762070970","3105","11195514","11668027","472513","2024-09"
"002700","신일전자","103328987160","1470","70291828","71047521","755693","2024-09"
"012790","신일제약","86581111890","7490","11559561","11986415","426854","2024-09"
"138070","신진에스엠","40301460140","2395","16827332","17503204","675872","2024-09"
"226330","신테카바이오","72020002000","4720","15258475","15258475","0","2024-09"
"002870","신풍","25462163220","919","27706380","34958700","7252320","2024-09"
"019170","신풍제약","579920011330","11770","49271029","52984990","3713961","2024-09"
"418210","신한제10호스팩","7887300000","2155","3660000","3660000","0","2024-09"
"452980","신한제11호스팩","36883655000","1951","18905000","18905000","0","2024-09"
"474660","신한제12호스팩","11812800000","2140","5520000","5520000","0","2024-09"
"474930","신한제13호스팩","7764900000","2145","3620000","3620000","0","2024-09"
"055550","신한지주","28343971741200","56300","503445324","509393214","5947890","2024-09"
"056700","신화인터텍","48564566334","1674","29011091","29135091","124000","2024-09"
"187270","신화콘텍","30539328760","3320","9198593","10143845","945252","2024-09"
"004080","신흥","135129401550","14310","9443005","9500000","56995","2024-09"
"243840","신흥에스이씨","293568953350","7610","38576735","38919035","342300","2024-09"
"257720","실리콘투","2273615289900","37350","60873234","60873234","0","2024-09"
"222800","심텍","538195321300","16900","31845877","31854143","8266","2024-09"
"036710","심텍홀딩스","74694744280","1612","46336690","48350145","2013455","2024-09"
"160980","싸이맥스","117943739120","11540","10220428","10924243","703815","2024-09"
"356890","싸이버원","35744760000","3000","11914920","11916325","1405","2024-09"
"217330","싸이토젠","170483952330","7390","23069547","23129547","60000","2024-09"
"102280","쌍방울","70634046631","269","262580099","262592129","12030","2024-09"
"010280","쌍용정보통신","39660378366","609","65123774","65123786","12","2024-09"
"004770","써니전자","57847801928","1592","36336559","36702884","366325","2024-09"
"208640","썸에이지","34670823246","249","139240254","139240254","0","2024-09"
"222420","쎄노텍","37141006276","817","45460228","45460231","3","2024-09"
"037760","쎄니트","47246139234","1554","30402921","33832921","3430000","2024-09"
"099320","쎄트렉아이","418338819600","38200","10951278","10951278","0","2024-09"
"049960","쎌바이오텍","94651137000","13830","6843900","9400000","2556100","2024-09"
"088280","쏘닉스","41795173350","2415","17306490","17306490","0","2024-09"
"403550","쏘카","582703859520","17760","32809902","32809902","0","2024-09"
"050890","쏠리드","268460383340","4430","60600538","61095231","494693","2024-09"
"109670","씨싸이트","54851810600","9400","5835299","5836602","1303","2024-09"
"066790","씨씨에스","99135178879","1639","60485161","65152039","4666878","2024-09"
"222080","씨아이에스","619024092010","8630","71729327","71729327","0","2024-09"
"004920","씨아이테크","63583557110","1270","50065793","50065793","0","2024-09"
"352480","씨앤씨인터내셔널","709794384000","71000","9997104","10013941","16837","2024-09"
"264660","씨앤지하이테크","120699376920","12940","9327618","9627896","300278","2024-09"
"352700","씨앤투스","75228443640","2940","25587906","27276899","1688993","2024-09"
"458870","씨어스테크놀로지","163297356800","13010","12551680","12551680","0","2024-09"
"297090","씨에스베어링","146985300000","5390","27270000","27270000","0","2024-09"
"112610","씨에스윈드","2336622728400","56400","41429481","42171403","741922","2024-09"
"359090","씨엔알리서치","70450124160","1248","56450420","56450891","471","2024-09"
"115530","씨엔플러스","31059091000","457","67963000","67963000","0","2024-09"
"115480","씨유메디칼","37633404356","782","48124558","48224558","100000","2024-09"
"340810","씨유박스","36244691460","3420","10597863","10597863","0","2024-09"
"376290","씨유테크","55091400000","3120","17657500","17657500","0","2024-09"
"189330","씨이랩","41305685520","6780","6092284","6092284","0","2024-09"
"096530","씨젠","1085397038000","23500","46187108","52225994","6038886","2024-09"
"101240","씨큐브","50968588080","4930","10338456","10340947","2491","2024-09"
"060590","씨티씨바이오","186727532750","7810","23908775","24181020","272245","2024-09"
"308170","씨티알모빌리티","46666200000","5420","8610000","8610000","0","2024-09"
"260930","씨티케이","105148342620","5580","18843789","19341591","497802","2024-09"
"052300","씨티프라퍼티","62733856428","372","168639399","168651433","12034","2024-09"
"413630","씨피시스템","95874882110","2590","37017329","38703425","1686096","2024-09"
"013990","아가방컴퍼니","132243922800","4400","30055437","32887536","2832099","2024-09"
"123860","아나패스","224161943350","18490","12123415","12123415","0","2024-09"
"025980","아난티","438715916100","4950","88629478","88629478","0","2024-09"
"008700","아남전자","100489092990","1303","77121330","77124820","3490","2024-09"
"125210","아모그린텍","105249520200","6380","16496790","16496790","0","2024-09"
"002790","아모레G","1769512140000","23200","76272075","82458180","6186105","2024-09"
"090430","아모레퍼시픽","7226800163000","123700","58421990","58492759","70769","2024-09"
"357580","아모센스","79215063840","7060","11220264","11220264","0","2024-09"
"052710","아모텍","57208117590","3915","14612546","14615109","2563","2024-09"
"074430","아미노로직스","104777424892","1193","87826844","87826844","0","2024-09"
"092040","아미코젠","246947062090","4505","54816218","55018347","202129","2024-09"
"083930","아바코","212673918150","14650","14516991","14912798","395807","2024-09"
"149950","아바텍","161857975500","11700","13834015","15607500","1773485","2024-09"
"036010","아비코전자","69787903500","5250","13292934","13292934","0","2024-09"
"002030","아세아","434424243000","258500","1680558","2115648","435090","2024-09"
"183190","아세아시멘트","406386594700","10820","37558835","38501886","943051","2024-09"
"002310","아세아제지","330049363000","8260","39957550","42782510","2824960","2024-09"
"050860","아세아텍","43257594310","2185","19797526","22500000","2702474","2024-09"
"012170","아센디오","48056195104","464","103569386","103569488","102","2024-09"
"136410","아셈스","88112594490","8290","10628781","11019106","390325","2024-09"
"246720","아스타","64105492500","4725","13567300","13567300","0","2024-09"
"067390","아스트","191647321415","557","344070595","344203992","133397","2024-09"
"159010","아스플로","82072416500","6350","12924790","13334739","409949","2024-09"
"127710","아시아경제","45689443338","1309","34904082","34904082","0","2024-09"
"267850","아시아나IDT","195027000000","17570","11100000","11100000","0","2024-09"
"020560","아시아나항공","726258816640","9760","74411764","74411764","0","2024-09"
"154030","아시아종묘","27877201560","2405","11591352","11591352","0","2024-09"
"227610","아우딘퓨쳐스","49840432122","1406","35448387","35583547","135160","2024-09"
"143160","아이디스","150905908350","14970","10080555","10716390","635835","2024-09"
"054800","아이디스홀딩스","80191009720","9080","8831609","10347756","1516147","2024-09"
"332370","아이디피","47868057930","3795","12613454","13273726","660272","2024-09"
"122900","아이마켓코리아","262727239000","8350","31464340","33428840","1964500","2024-09"
"339950","아이비김영","76363598970","1761","43363770","44946655","1582885","2024-09"
"469750","아이비젼웍스","52127804502","1539","33871218","33936481","65263","2024-09"
"460470","아이빔테크놀로지","76628599600","5080","15084370","15084370","0","2024-09"
"099190","아이센스","537481027700","19450","27633986","27637273","3287","2024-09"
"461300","아이스크림미디어","169795130510","13270","12795413","13063433","268020","2024-09"
"289010","아이스크림에듀","30947111650","2470","12529195","12864037","334842","2024-09"
"214430","아이쓰리시스템","225604665000","32500","6941682","7106760","165078","2024-09"
"040910","아이씨디","85471479240","5240","16311351","18574275","2262924","2024-09"
"368600","아이씨에이치","63076521210","3670","17187063","17538346","351283","2024-09"
"456010","아이씨티케이","92421053040","6990","13221896","13221896","0","2024-09"
"052860","아이앤씨","26502298297","1633","16229209","17862854","1633645","2024-09"
"464500","아이언디바이스","69768173930","5110","13653263","13653263","0","2024-09"
"010780","아이에스동서","635435844800","21050","30186976","30186976","0","2024-09"
"038880","아이에이","63676157699","209","304670611","315334702","10664091","2024-09"
"307180","아이엘사이언스","85995121380","3180","27042491","27042828","337","2024-09"
"101390","아이엠","31383182565","2985","10513629","10548085","34456","2024-09"
"461030","아이엠비디엑스","220919740000","15760","14017750","14017750","0","2024-09"
"451220","아이엠티","73548866740","9340","7874611","7874611","0","2024-09"
"090150","아이윈","35783968236","901","39715836","41875293","2159457","2024-09"
"123010","아이윈플러스","23441111061","723","32422007","32658542","236535","2024-09"
"031310","아이즈비전","44193828393","1809","24429977","25334636","904659","2024-09"
"185490","아이진","78116075760","2890","27029784","27029784","0","2024-09"
"059100","아이컴포넌트","30354965170","4595","6606086","7070860","464774","2024-09"
"262840","아이퀘스트","41308029860","2195","18819148","19290000","470852","2024-09"
"175250","아이큐어","95292696750","2550","37369685","37558368","188683","2024-09"
"052460","아이크래프트","28579467040","2390","11957936","14607936","2650000","2024-09"
"119830","아이텍","117740900060","5530","21291302","21434297","142995","2024-09"
"052770","아이톡시","64457608936","1316","48979946","48979946","0","2024-09"
"124500","아이티센","148044882260","6380","23204527","23204527","0","2024-09"
"372800","아이티아이즈","33379233300","5670","5886990","6026990","140000","2024-09"
"084850","아이티엠반도체","382741338500","18500","20688721","22682934","1994213","2024-09"
"114840","아이패밀리에스씨","353049852000","20500","17221944","17221944","0","2024-09"
"027360","아주IB투자","236110154152","1994","118410308","120945406","2535098","2024-09"
"139990","아주스틸","136300433160","5140","26517594","26517744","150","2024-09"
"032080","아즈텍WB","23655762683","1127","20990029","21491029","501000","2024-09"
"013310","아진산업","107098879920","2760","38803942","38806582","2640","2024-09"
"059120","아진엑스텍","73057163340","7980","9155033","9748596","593563","2024-09"
"009320","아진전자부품","53293051370","1081","49299770","49299770","0","2024-09"
"158430","아톤","88266046120","4130","21371924","22602474","1230550","2024-09"
"321820","아티스트유나이티드","217076994400","16240","13366810","13366810","0","2024-09"
"001540","안국약품","81376013400","7160","11365365","13042420","1677055","2024-09"
"053800","안랩","570268858800","58200","9798434","11126506","1328072","2024-09"
"065660","안트로젠","150933595230","15510","9731373","9731373","0","2024-09"
"297570","알로이스","38602658070","1115","34621218","34621218","0","2024-09"
"001780","알루코","230455714160","2380","96830132","96830132","0","2024-09"
"260660","알리코제약","57276086665","3815","15013391","15327021","313630","2024-09"
"354320","알멕","199091518150","31150","6391381","6391381","0","2024-09"
"361570","알비더블유","65002110570","2270","28635291","28635291","0","2024-09"
"131370","알서포트","150012800640","2880","52087778","53267083","1179305","2024-09"
"140670","알에스오토메이션","100145166560","10840","9238484","9303140","64656","2024-09"
"096610","알에프세미","51550708615","2965","17386411","17386411","0","2024-09"
"061040","알에프텍","95849538360","3070","31221348","32089259","867911","2024-09"
"148250","알엔투테크놀로지","29701705500","4140","7174325","7391186","216861","2024-09"
"347860","알체라","50314941380","2285","22019668","22019668","0","2024-09"
"196170","알테오젠","20213994010000","380500","53124820","53148528","23708","2024-09"
"123750","알톤","20471925576","1608","12731297","12746297","15000","2024-09"
"085810","알티캐스트","39517220556","1332","29667583","30447327","779744","2024-09"
"043100","알파녹스","22390349760","2810","7968096","7975920","7824","2024-09"
"117670","알파홀딩스","37743429465","945","39940137","39940137","0","2024-09"
"314140","알피바이오","54753499860","6330","8649842","8666361","16519","2024-09"
"291650","압타머사이언스","44148655200","2600","16980252","16980252","0","2024-09"
"293780","압타바이오","199078110000","8050","24730200","24730200","0","2024-09"
"018250","애경산업","428957500920","16690","25701468","26409935","708467","2024-09"
"161000","애경케미칼","511253705340","10590","48277026","48648709","371683","2024-09"
"196300","애니젠","78044031000","13000","6003387","6003387","0","2024-09"
"310200","애니플러스","123667760680","2780","44484806","45520979","1036173","2024-09"
"299910","애닉","32483121920","6880","4721384","4721384","0","2024-09"
"179530","애드바이오텍","30894700720","3380","9140444","9140444","0","2024-09"
"205500","액션스퀘어","55925039745","1077","51926685","51928120","1435","2024-09"
"052790","액토즈소프트","68824646100","6300","10924547","11330638","406091","2024-09"
"290740","액트로","51607768310","5530","9332327","10065011","732684","2024-09"
"238090","앤디포스","91042184000","4000","22760546","23541303","780757","2024-09"
"092600","앤씨앤","28995451968","1184","24489402","25083517","594115","2024-09"
"129890","앱코","55367230368","1156","47895528","50643410","2747882","2024-09"
"174900","앱클론","281415542650","16150","17425111","17425111","0","2024-09"
"255440","야스","120564005310","9990","12068469","13058000","989531","2024-09"
"030960","양지사","129805861500","9450","13736070","15980000","2243930","2024-09"
"102120","어보브반도체","166142452780","10070","16498754","17780753","1281999","2024-09"
"263540","어스앤에어로스페이스","85022108500","5950","14289430","14294091","4661","2023-12"
"238120","얼라인드","43064793520","2995","14378896","14378896","0","2024-09"
"019990","에너토크","61818433820","6460","9569417","9756088","186671","2024-09"
"011090","에넥스","32912921355","555","59302561","59991641","689080","2024-09"
"270660","에브리봇","194233710960","15880","12231342","12231342","0","2024-09"
"038680","에스넷","66805109175","3675","18178261","19549677","1371416","2024-09"
"137310","에스디바이오센서","1103574143320","9020","122347466","124477353","2129887","2024-09"
"217480","에스디생명공학","54756837359","499","109733141","109733141","0","2024-09"
"121890","에스디시스템","18302321142","1377","13291446","13291446","0","2024-09"
"304360","에스바이오메딕스","378214631200","32200","11745796","11745796","0","2024-09"
"389500","에스비비테크","89310969720","14980","5962014","6174904","212890","2024-09"
"042110","에스씨디","71721072976","1484","48329564","48329564","0","2024-09"
"298060","에스씨엠생명과학","40532468410","1981","20460610","20467248","6638","2024-09"
"065420","에스아이리소스","18323131904","256","71574734","71577299","2565","2024-09"
"103230","에스앤더블류","25524000000","3545","7200000","7200000","0","2024-09"
"260970","에스앤디","100667839200","34800","2892754","2892754","0","2024-09"
"101490","에스앤에스텍","484997130000","23150","20950200","21451447","501247","2024-09"
"095910","에스에너지","28656178436","1537","18644228","19504503","860275","2024-09"
"275630","에스에스알","17503963880","3235","5410808","6017989","607181","2024-09"
"031330","에스에이엠티","311168763730","3190","97545067","99995067","2450000","2024-09"
"060540","에스에이티","39382331538","1507","26132934","26133306","372","2024-09"
"351320","에스에이티이엔지","35731442148","1623","22015676","22015886","210","2024-09"
"056190","에스에프에이","644003687000","20500","31414814","35908760","4493946","2024-09"
"080000","에스엔유","59091076902","1727","34216026","34322870","106844","2024-09"
"005850","에스엘","1545160750100","33550","46055462","46448520","393058","2024-09"
"214310","에스엘에너지","22487615640","6120","3674447","3679130","4683","2024-09"
"246250","에스엘에스바이오","44279574310","2885","15348206","15348206","0","2024-09"
"041510","에스엠","1639259804000","71600","22894690","23353627","458937","2024-09"
"010580","에스엠벡셀","137438453516","1237","111106268","111251760","145492","2024-09"
"007820","에스엠코어","95714685990","4895","19553562","20033946","480384","2024-09"
"464080","에스오에스랩","100079157800","5660","17681830","17681830","0","2024-09"
"109610","에스와이","189838089750","3975","47758010","48907400","1149390","2024-09"
"365330","에스와이스틸텍","175089200000","5720","30610000","30610000","0","2024-09"
"012750","에스원","2136807104800","63200","33810239","37999178","4188939","2024-09"
"031860","에스유홀딩스","18131025334","1207","15021562","15026356","4794","2024-09"
"306040","에스제이그룹","57337934640","6090","9415096","9865828","450732","2024-09"
"457940","에스케이증권제10호스팩","7066850000","2135","3310000","3310000","0","2024-09"
"472230","에스케이증권제11호스팩","8642400000","2080","4155000","4155000","0","2024-09"
"473000","에스케이증권제12호스팩","6951000000","2100","3310000","3310000","0","2024-09"
"473950","에스케이증권제13호스팩","9105200000","2060","4420000","4420000","0","2024-09"
"435870","에스케이증권제8호스팩","7812000000","2100","3720000","3720000","0","2024-09"
"455910","에스케이증권제9호스팩","10717700000","2135","5020000","5020000","0","2024-09"
"096630","에스코넥","58111642725","745","78002205","79052205","1050000","2024-09"
"069510","에스텍","90912100000","10810","8410000","10910000","2500000","2024-09"
"234300","에스트래픽","115584903000","4200","27520215","27809848","289633","2024-09"
"039440","에스티아이","302109463500","20500","14737047","15830000","1092953","2024-09"
"098660","에스티오","35804881600","2950","12137248","12500976","363728","2024-09"
"052020","에스티큐브","279865494000","6000","46644249","46694249","50000","2024-09"
"237690","에스티팜","1994682848000","99200","20107690","20107690","0","2024-09"
"050760","에스폴리텍","24723873169","1601","15442769","16334678","891909","2024-09"
"288620","에스퓨얼셀","75237026480","10780","6979316","6979316","0","2024-09"
"443670","에스피소프트","155119423180","6410","24199598","24201392","1794","2024-09"
"317830","에스피시스템스","53803098220","5290","10170718","10773818","603100","2024-09"
"058610","에스피지","474595504000","21400","22177360","22177360","0","2024-09"
"043340","에쎈테크","45220000000","476","95000000","95000000","0","2024-09"
"023960","에쓰씨엔지니어링","61059015882","1797","33978306","33978308","2","2024-09"
"298690","에어부산","275716392160","2365","116581984","116640000","58016","2024-09"
"054630","에이디칩스","12594094838","158","79709461","79709461","0","2024-09"
"200710","에이디테크놀로지","200019657040","15440","12954641","13440822","486181","2024-09"
"096690","에이루트","42609947656","1273","33472072","33477189","5117","2024-09"
"078520","에이블씨엔씨","183139672320","7040","26014158","26014161","3","2024-09"
"298380","에이비엘바이오","1847437487050","38450","48047789","48047789","0","2024-09"
"203400","에이비온","214662809720","8510","25224772","25224772","0","2024-09"
"195990","에이비프로바이오","145475519966","511","284687906","284689721","1815","2024-09"
"003800","에이스침대","288204598500","27300","10556945","11090000","533055","2024-09"
"088800","에이스테크","132193667627","1043","126743689","127068928","325239","2024-09"
"241840","에이스토리","64308217050","6930","9279685","9539994","260309","2024-09"
"453860","에이에스텍","133272834750","23650","5635215","5657215","22000","2024-09"
"312610","에이에프더블류","32876929224","1623","20256888","20256888","0","2024-09"
"015260","에이엔피","33519061534","743","45113138","45116894","3756","2024-09"
"172670","에이엘티","83008127250","9370","8858925","8960259","101334","2024-09"
"445090","에이직랜드","334999434600","31100","10771686","10771686","0","2024-09"
"295310","에이치브이엠","173768192600","14600","11901931","11901931","0","2024-09"
"072990","에이치시티","73698198780","10410","7079558","7287341","207783","2024-09"
"239610","에이치엘사이언스","82964171790","16290","5092951","5392115","299164","2024-09"
"462020","에이치엠씨제6호스팩","8863800000","2040","4345000","4345000","0","2024-09"
"477340","에이치엠씨제7호스팩","14982450000","1995","7510000","7510000","0","2024-09"
"148930","에이치와이티씨","44575645100","4585","9722060","10175213","453153","2024-09"
"044780","에이치케이","23682314070","1290","18358383","18505787","147404","2024-09"
"357230","에이치피오","122156864560","2960","41269211","42089487","820276","2024-09"
"355690","에이텀","34970220600","6470","5404980","5404980","0","2024-09"
"071670","에이테크솔루션","63200000000","6320","10000000","10000000","0","2024-09"
"045660","에이텍","112248083520","14880","7543554","8260000","716446","2024-09"
"224110","에이텍모빌리티","65105128030","13270","4906189","5340000","433811","2024-09"
"021080","에이티넘인베스트","119125949250","2590","45994575","48000000","2005425","2024-09"
"200470","에이팩트","119881712070","2830","42361029","42362093","1064","2024-09"
"262260","에이프로","103431138180","7180","14405451","14468152","62701","2024-09"
"007460","에이프로젠","288711002650","1085","266093090","286851768","20758678","2024-09"
"003060","에이프로젠바이오로직스","162009700920","820","197572806","198407845","835039","2024-09"
"397030","에이프릴바이오","493132860000","22500","21917016","21917016","0","2024-09"
"244920","에이플러스에셋","93595849020","4140","22607693","22607693","0","2024-09"
"278470","에이피알","1984308631500","266500","7445811","7622678","176867","2024-09"
"230240","에치에프알","136356011860","10390","13123774","13309000","185226","2024-09"
"230360","에코마케팅","321603256380","10220","31468029","31468029","0","2024-09"
"038870","에코바이오","55560605295","3965","14012763","14014949","2186","2024-09"
"097780","에코볼트","59264045750","875","67730338","67730338","0","2024-09"
"448280","에코아이","190725700330","19310","9877043","9877043","0","2024-09"
"101360","에코앤드림","691377252400","39400","17547646","17786114","238468","2024-09"
"128540","에코캡","33658881130","1295","25991414","26690460","699046","2024-09"
"086520","에코프로","10539527600000","80000","131744095","133138340","1394245","2024-09"
"450080","에코프로머티","7777349334800","112600","69070598","69070598","0","2024-09"
"247540","에코프로비엠","15840465138200","162200","97660081","97801344","141263","2024-09"
"383310","에코프로에이치엔","682261901000","44750","15246076","15304932","58856","2024-09"
"038110","에코플라스틱","115714765440","2880","40178738","41169370","990632","2024-09"
"073540","에프알텍","14056200000","1233","11400000","11400000","0","2024-09"
"064850","에프앤가이드","123231585600","10800","11410332","11410332","0","2024-09"
"036810","에프에스티","361802134960","18130","19955992","21756789","1800797","2024-09"
"173940","에프엔씨엔터","55233196700","3700","14927891","15392808","464917","2024-09"
"083500","에프엔에스테크","77775782000","9730","7993400","8575722","582322","2024-09"
"054940","엑사이엔씨","23685913272","714","33173548","33173548","0","2024-09"
"373110","엑셀세라퓨틱스","67366910540","6170","10918462","10918462","0","2024-09"
"205100","엑셈","127940285648","1778","71957416","71963431","6015","2024-09"
"356680","엑스게이트","138957570340","4870","28533382","28543492","10110","2024-09"
"070300","엑스큐어","38667991340","4630","8351618","8351618","0","2024-09"
"317770","엑스페릭스","71569386720","3120","22938906","22938906","0","2024-09"
"373200","엑스플러스","47466957252","627","75704876","75705657","781","2024-09"
"069920","엑시온그룹","48411660528","1383","35004816","35194116","189300","2024-09"
"092870","엑시콘","147153353930","11770","12502409","13050797","548388","2024-09"
"317870","엔바이오니아","159756765000","18780","8506750","8506750","0","2024-09"
"067570","엔브이에이치코리아","104486352500","2500","41794541","42170000","375459","2024-09"
"236810","엔비티","58866287500","3650","16127750","16975426","847676","2024-09"
"333620","엔시스","102598835370","9930","10332209","10556344","224135","2024-09"
"101400","엔시트론","27226625748","438","62161246","62162413","1167","2024-09"
"036570","엔씨소프트","4205943665000","210500","19980730","21954022","1973292","2024-09"
"078860","엔에스이엔엠","94913040200","9020","10522510","10531054","8544","2024-09"
"422040","엔에이치스팩23호","15071800000","2105","7160000","7160000","0","2024-09"
"437780","엔에이치스팩24호","10613300000","2110","5030000","5030000","0","2024-09"
"438580","엔에이치스팩25호","6583600000","2180","3020000","3020000","0","2024-09"
"439410","엔에이치스팩26호","18392000000","2090","8800000","8800000","0","2024-09"
"440820","엔에이치스팩27호","16185000000","2075","7800000","7800000","0","2024-09"
"451700","엔에이치스팩29호","28700000000","2000","14350000","14350000","0","2024-09"
"466910","엔에이치스팩30호","18190900000","1999","9100000","9100000","0","2024-09"
"481890","엔에이치스팩31호","12785175000","2015","6345000","6345000","0","2024-09"
"265740","엔에프씨","54751934000","6130","8931800","8931800","0","2024-09"
"354200","엔젠바이오","41078067160","2990","13738484","13738484","0","2024-09"
"455900","엔젤로보틱스","350469184450","23450","14945381","14945381","0","2024-09"
"419080","엔젯","90981331170","9010","10097817","10517817","420000","2024-09"
"208860","엔지스테크널러지","41831348265","2205","18971133","18971133","0","2024-09"
"183490","엔지켐생명과학","118638143098","1486","79837243","85065562","5228319","2024-09"
"085310","엔케이","62315454380","790","78880322","79983352","1103030","2024-09"
"182400","엔케이맥스","172744574320","2020","85517116","85518831","1715","2024-09"
"348370","엔켐","3804006909000","183000","20786923","20786923","0","2024-09"
"069410","엔텔스","35449392550","3575","9915914","10244824","328910","2024-09"
"227950","엔투텍","43605298130","421","103575530","103575530","0","2024-09"
"291230","엔피","93042059930","2110","44095763","44095775","12","2024-09"
"198080","엔피디","54160990275","2515","21535185","21535185","0","2024-09"
"048830","엔피케이","21780137505","1165","18695397","18723923","28526","2024-09"
"096870","엘디티","15226752000","2280","6678400","6678400","0","2024-09"
"290650","엘앤씨바이오","431239777910","19010","22684891","22684891","0","2024-09"
"066970","엘앤에프","3288657246000","98000","33557727","36296338","2738611","2024-09"
"156100","엘앤케이바이오","131582437800","6600","19936733","19936743","10","2024-09"
"073110","엘엠에스","38294237360","6620","5784628","8895755","3111127","2024-09"
"083310","엘오티베큠","160020387910","9890","16180019","17810033","1630014","2024-09"
"037950","엘컴텍","106267666413","1259","84406407","84447519","41112","2024-09"
"170920","엘티씨","89710195220","9670","9277166","9805620","528454","2024-09"
"058630","엠게임","119056473600","6400","18602574","19543877","941303","2024-09"
"058970","엠로","546456399800","46100","11853718","11853718","0","2024-09"
"019590","엠벤처투자","104963185182","921","113966542","113966542","0","2024-09"
"169330","엠브레인","39065219600","2200","17756918","18256918","500000","2024-09"
"097520","엠씨넥스","299249795560","17330","17267732","17977732","710000","2024-09"
"373170","엠아이큐브솔루션","38842440300","7710","5037930","5037930","0","2024-09"
"179290","엠아이텍","279963114700","8650","32365678","32365678","0","2024-09"
"009780","엠에스씨","90288000000","5130","17600000","17600000","0","2024-09"
"123040","엠에스오토텍","171895115625","3125","55006437","69172213","14165776","2024-09"
"323230","엠에프엠코리아","6967193212","161","43274492","43274492","0","2024-06"
"032790","엠젠솔루션","59918364800","1400","42798832","42798832","0","2024-09"
"033160","엠케이전자","179768638000","8600","20903330","22066331","1163001","2024-09"
"347890","엠투아이","92099131940","5630","16358638","16913204","554566","2024-09"
"033310","엠투엔","80550297960","2035","39582456","40342231","759775","2024-09"
"259630","엠플러스","117823705760","9760","12072101","12282402","210301","2024-09"
"105550","엣지파운드리","130908433950","2290","57165255","57165255","0","2024-09"
"060850","영림원소프트랩","55778660000","6860","8131000","8131000","0","2024-09"
"014440","영보화학","65910000000","3380","19500000","20000000","500000","2024-09"
"143540","영우디에스피","32328232000","740","43686800","44599895","913095","2024-09"
"111770","영원무역","1736380678200","40600","42767997","44311468","1543471","2024-09"
"009970","영원무역홀딩스","1047922289400","90300","11604898","13635592","2030694","2024-09"
"003520","영진약품","445343125490","2435","182892454","182892731","277","2024-09"
"000670","영풍","651930786000","379000","1720134","1842040","121906","2024-09"
"036560","영풍정밀","315000000000","20000","15750000","15750000","0","2024-09"
"006740","영풍제지","55518604065","1257","44167545","46482148","2314603","2024-09"
"012280","영화금속","38579682810","762","50629505","51664505","1035000","2024-09"
"265560","영화테크","94315610200","8890","10609180","10690180","81000","2024-09"
"012160","영흥","32380893925","475","68170303","101310372","33140069","2024-09"
"036000","예림당","44225811840","1920","23034277","23034277","0","2024-09"
"250930","예선테크","17876160749","547","32680367","33000440","320073","2024-09"
"053280","예스24","158658890200","6350","24985652","25000000","14348","2024-09"
"015360","예스코홀딩스","220043400000","51400","4281000","6000000","1719000","2024-09"
"122640","예스티","382366433750","18970","20156375","20930108","773733","2024-09"
"045060","오공","45828039670","2705","16941974","16941974","0","2024-09"
"080520","오디텍","35912723360","3470","10349488","11746609","1397121","2024-09"
"007310","오뚜기","1401525752500","407500","3439327","4007830","568503","2024-09"
"039830","오로라","55347544000","5600","9883490","10762890","879400","2024-09"
"322310","오로스테크놀로지","150875229960","16380","9210942","9366542","155600","2024-09"
"046120","오르비텍","67394551840","2485","27120544","27449486","328942","2024-09"
"014940","오리엔탈정공","164881186180","3620","45547289","45573661","26372","2024-09"
"002630","오리엔트바이오","53829929204","454","118568126","118583005","14879","2024-09"
"065500","오리엔트정공","38008411692","1198","31726554","31742912","16358","2024-09"
"271560","오리온","3830339557200","96900","39528788","39536132","7344","2024-09"
"001800","오리온홀딩스","978147177780","16260","60156653","62645422","2488769","2024-09"
"010470","오리콤","72181451700","6220","11604735","11975050","370315","2024-09"
"417860","오브젠","43464323340","9810","4430614","4430614","0","2024-09"
"352910","오비고","85431541520","6760","12637802","12637802","0","2024-09"
"053980","오상자이엘","70395163540","3730","18872698","18982783","110085","2024-09"
"036220","오상헬스케어","174000419730","12690","13711617","14489416","777799","2024-09"
"052420","오성첨단소재","141919350027","1703","83334909","86315192","2980283","2024-09"
"039200","오스코텍","1288828731200","33700","38244176","38244176","0","2024-09"
"226400","오스테오닉","115049149390","5810","19801919","20661601","859682","2024-09"
"031510","오스템","35126050743","1341","26193923","28000000","1806077","2024-09"
"368970","오에스피","30935789600","3310","9346160","9346160","0","2024-09"
"138080","오이솔루션","105196713600","10320","10193480","10624095","430615","2024-09"
"080580","오킨스전자","100636292250","5850","17202785","17679298","476513","2024-09"
"067170","오텍","49364769275","3475","14205689","15391605","1185916","2024-09"
"353590","오토앤","62510892350","4855","12875570","12875570","0","2024-09"
"173130","오파스넷","98344853360","7540","13043084","13046473","3389","2024-09"
"440320","오픈놀","43779325000","4465","9805000","9805000","0","2024-09"
"049480","오픈베이스","67794431360","2260","29997536","31422383","1424847","2024-09"
"394280","오픈엣지테크놀로지","264832023240","12120","21850827","21850827","0","2024-09"
"309930","오하임앤컴퍼니","42507505890","2070","20535027","21290990","755963","2024-09"
"244460","올리패스","18290883206","454","40288289","40290730","2441","2024-09"
"226950","올릭스","537832557600","31200","17238223","17238223","0","2024-09"
"057540","옴니시스템","47297242918","797","59344094","61449355","2105261","2024-09"
"131030","옵투스제약","99435452130","6510","15274263","16153162","878899","2024-09"
"082210","옵트론텍","60541478830","2170","27899299","28566538","667239","2024-09"
"109080","옵티시스","32819208300","6900","4756407","5636000","879593","2024-09"
"380540","옵티코어","34277951388","1194","28708502","29779596","1071094","2024-09"
"153710","옵티팜","77457378240","5280","14669958","14669958","0","2024-09"
"432430","와이랩","84410724800","5140","16422320","16422320","0","2024-09"
"338840","와이바이오로직스","166452445320","11270","14769516","14769516","0","2024-09"
"122990","와이솔","172947081250","6250","27671533","28186941","515408","2024-09"
"232140","와이씨","920974895120","11480","80224294","82045350","1821056","2024-09"
"112290","와이씨켐","172081475900","17020","10110545","10110545","0","2024-09"
"065530","와이어블","69366200550","1450","47838759","52860000","5021241","2024-09"
"067900","와이엔텍","115837817600","6400","18099659","18199659","100000","2024-09"
"007530","와이엠","52125527100","2740","19023915","19174452","150537","2024-09"
"155650","와이엠씨","75525516200","4175","18089944","19474358","1384414","2024-09"
"273640","와이엠텍","120881274800","11440","10566545","10966000","399455","2024-09"
"251370","와이엠티","133941749440","8210","16314464","16314464","0","2024-09"
"066430","와이오엠","22195284174","567","39145122","39153476","8354","2024-09"
"209640","와이제이링크","209483770290","14730","14221573","14221573",,"자료 없음"
"273060","와이즈버즈","46977864325","931","50459575","50459582","7","2024-09"
"019210","와이지-원","173912382420","5180","33573819","33573819","0","2024-09"
"122870","와이지엔터테인먼트","773404812600","41700","18546878","18691049","144171","2024-09"
"011690","와이투솔루션","95078781200","2600","36568762","36574394","5632","2024-09"
"332570","와이팜","105618657280","2560","41257288","42233850","976562","2024-09"
"079000","와토스코리아","36031268130","5070","7106759","7200000","93241","2024-09"
"403490","우듬지팜","85674437575","1895","45210785","45212464","1679","2024-09"
"316140","우리금융지주","12318698054040","16590","742537556","742591501","53945","2024-09"
"032820","우리기술","366166445300","2305","158857460","158859048","1588","2024-09"
"041190","우리기술투자","639322190760","8210","77871156","84000000","6128844","2024-09"
"115440","우리넷","80865377470","7730","10461239","10754239","293000","2024-09"
"046970","우리로","50343022120","1160","43399157","43824999","425842","2024-09"
"082850","우리바이오","167822228790","3555","47207378","48456578","1249200","2024-09"
"215360","우리산업","109494634370","11990","9132163","9132163","0","2024-09"
"072470","우리산업홀딩스","57123280225","3025","18883729","18887341","3612","2024-09"
"073560","우리손에프앤지","97140413129","1403","69237643","69237643","0","2024-09"
"037400","우리엔터프라이즈","32617374420","1345","24250836","26223346","1972510","2024-09"
"153490","우리이앤엘","43498026000","860","50579100","51480000","900900","2024-09"
"101170","우림피티에스","69256566480","5240","13216902","13500000","283098","2024-09"
"006980","우성","41222101360","16060","2566756","3090000","523244","2024-09"
"066590","우수AMS","119128045960","3080","38677937","39073104","395167","2024-09"
"017370","우신시스템","128274316500","8250","15548402","18314054","2765652","2024-09"
"103840","우양","63992733480","3910","16366428","16366428","0","2024-09"
"046940","우원개발","43468811750","2405","18074350","18074350","0","2024-09"
"215380","우정바이오","33248933640","2115","15720536","15879576","159040","2024-09"
"065680","우주일렉트로","119612448480","14880","8038471","9530000","1491529","2024-09"
"105840","우진","165081074480","8330","19817656","20323614","505958","2024-09"
"018620","우진비앤지","29089381197","1007","28887171","28889293","2122","2024-09"
"010400","우진아이엔에스","23354373735","3465","6740079","7622000","881921","2024-09"
"457550","우진엔텍","209995828350","22650","9271339","9271339","0","2024-09"
"049800","우진플라임","45200000000","2260","20000000","20000000","0","2024-09"
"016880","웅진","69710755062","897","77715446","79927080","2211634","2024-09"
"095720","웅진씽크빅","195505159415","1735","112683089","115505985","2822896","2024-09"
"396470","워트","152817600000","9480","16120000","16120000","0","2024-09"
"005820","원림","32847575100","15970","2056830","2297970","241140","2024-09"
"307280","원바이오젠","46611361692","1314","35472878","36959013","1486135","2024-09"
"032940","원익","70680508185","3885","18193181","18193230","49","2024-09"
"240810","원익IPS","1418313363500","29150","48655690","49083901","428211","2024-09"
"074600","원익QnC","641427200000","24400","26288000","26288000","0","2024-09"
"104830","원익머트리얼즈","276745600000","21950","12608000","12608000","0","2024-09"
"014190","원익큐브","55039335405","1555","35395071","35399906","4835","2024-09"
"217820","원익피앤이","128744097780","2910","44241958","47454559","3212601","2024-09"
"030530","원익홀딩스","177972401650","2330","76383005","77237981","854976","2024-09"
"012620","원일특강","32560000000","7400","4400000","4400000","0","2024-09"
"382840","원준","218573753590","14390","15189281","15271581","82300","2024-09"
"336570","원텍","536020956000","6000","89336826","89340619","3793","2024-09"
"376980","원티드랩","40855385925","4575","8930139","9754994","824855","2024-09"
"008370","원풍","53408144790","4890","10921911","12000000","1078089","2024-09"
"008290","원풍물산","21735735968","544","39955397","40693679","738282","2024-09"
"101160","월덱스","319983044340","19380","16510993","16510993","0","2024-09"
"336060","웨이버스","66502331200","1381","48155200","48155200","0","2024-09"
"095270","웨이브일렉트로","61380207980","4810","12760958","14971256","2210298","2024-09"
"010600","웰바이오텍","49552926545","545","90922801","90923407","606","2024-09"
"065950","웰크론","63348161325","2325","27246521","28231302","984781","2024-09"
"076080","웰크론한텍","32998957095","1495","22072881","22594156","521275","2024-09"
"043590","웰킵스하이텍","20001092272","749","26703728","27136762","433034","2024-09"
"196700","웹스","19161768096","1334","14364144","14364144","0","2024-09"
"069080","웹젠","476773066700","16180","29466815","34950884","5484069","2024-09"
"053580","웹케시","92323273540","7220","12787157","13636248","849091","2024-09"
"071460","위니아","21802751835","613","35567295","35967295","400000","2024-09"
"377460","위니아에이드","26030247855","1691","15393405","15393405","0","2024-09"
"044340","위닉스","97218609600","6150","15807904","17873425","2065521","2024-09"
"330350","위더스제약","94773702400","7180","13199680","13202139","2459","2024-09"
"348350","위드텍","76918232000","7870","9773600","10183600","410000","2024-09"
"112040","위메이드","1116022017200","33200","33615121","33948483","333362","2024-09"
"101730","위메이드맥스","330465725590","10010","33013559","33295292","281733","2024-09"
"123420","위메이드플레이","78631869960","7560","10401041","11469842","1068801","2024-09"
"065370","위세아이텍","31322373940","4510","6945094","7383954","438860","2024-09"
"038620","위즈코프","37894058253","603","62842551","66546465","3703914","2024-09"
"299900","위지윅스튜디오","220261449200","1300","169431884","171048884","1617000","2024-09"
"036090","위지트","83269477110","706","117945435","118392284","446849","2024-09"
"136540","윈스","153790047360","12440","12362544","13644162","1281618","2024-09"
"097800","윈팩","192608678766","1654","116450229","116450229","0","2024-09"
"192390","윈하이텍","41077966160","3760","10924991","10924991","0","2024-09"
"008600","윌비스","28688534040","436","65799390","67236039","1436649","2024-09"
"335870","윙스풋","18983458236","1138","16681422","16681422","0","2024-09"
"033270","유나이티드제약","307465522100","20900","14711269","16333822","1622553","2024-09"
"014830","유니드","448127707500","67500","6638929","6767600","128671","2024-09"
"446070","유니드비티플러스","44581937400","4360","10225215","10611215","386000","2024-09"
"036200","유니셈","211795581600","7200","29416053","30664223","1248170","2024-09"
"018000","유니슨","116695353852","693","168391564","168391564","0","2024-09"
"000910","유니온","69471704550","4450","15611619","15611619","0","2024-09"
"047400","유니온머티리얼","102480000000","2440","42000000","42000000","0","2024-09"
"203450","유니온커뮤니티","32571119835","2645","12314223","14079007","1764784","2024-09"
"011330","유니켐","138186228614","1538","89848003","96997167","7149164","2024-09"
"077500","유니퀘스트","97416460020","4510","21600102","21794015","193913","2024-09"
"011320","유니크","77669193900","4020","19320695","19320695","0","2024-09"
"086390","유니테스트","205564779870","10110","20332817","21134126","801309","2024-09"
"241690","유니테크노","89073369840","3640","24470706","24470706","0","2024-09"
"142210","유니트론텍","91805441450","4850","18928957","19246092","317135","2024-09"
"088340","유라클","52740228240","12180","4330068","4330068","0","2024-09"
"048430","유라테크","76620248880","6690","11452952","11520000","67048","2024-09"
"206650","유바이오로직스","472753932580","12940","36534307","36534307","0","2024-09"
"089850","유비벨록스","99646470500","6850","14546930","14730199","183269","2024-09"
"084440","유비온","16341911200","829","19712800","19712800","0","2024-09"
"032620","유비케어","190792333920","3760","50742642","52197139","1454497","2024-09"
"264450","유비쿼스","136354025190","13710","9945589","10245706","300117","2024-09"
"078070","유비쿼스홀딩스","158523974400","9600","16512914","18150700","1637786","2024-09"
"002920","유성기업","52577375000","2050","25647500","25947500","300000","2024-09"
"024800","유성티엔에스","66296872080","1985","33398928","37051812","3652884","2024-09"
"000700","유수홀딩스","127639352360","5210","24498916","26041812","1542896","2024-09"
"054930","유신","66900000000","22300","3000000","3000000","0","2024-09"
"069330","유아이디","17944474152","1272","14107291","14191091","83800","2024-09"
"049520","유아이엘","105962357880","4955","21384936","21784936","400000","2024-09"
"435380","유안타제10호스팩","12004350000","2095","5730000","5730000","0","2024-09"
"444920","유안타제11호스팩","10794400000","2060","5240000","5240000","0","2024-09"
"446150","유안타제12호스팩","9778500000","2050","4770000","4770000","0","2024-09"
"449020","유안타제13호스팩","19654600000","2020","9730000","9730000","0","2024-09"
"450940","유안타제14호스팩","9624800000","2120","4540000","4540000","0","2024-09"
"473050","유안타제15호스팩","14125150000","2015","7010000","7010000","0","2024-09"
"474490","유안타제16호스팩","11157750000","2025","5510000","5510000","0","2024-09"
"430700","유안타제9호스팩","11030200000","2105","5240000","5240000","0","2024-09"
"003470","유안타증권","557808898185","2895","192680103","199596576","6916473","2024-09"
"263770","유에스티","50081963670","2130","23512659","23700172","187513","2024-09"
"072130","유엔젤","57259104360","4790","11953884","13195454","1241570","2024-09"
"000220","유유제약","73307508690","4530","16182673","17032351","849678","2024-09"
"388720","유일로보틱스","383117367300","33450","11453434","11453434","0","2024-09"
"340930","유일에너테크","78610757250","2305","34104450","34204450","100000","2024-09"
"023410","유진기업","237829694990","3470","68538817","77310863","8772046","2024-09"
"056080","유진로봇","209317808160","5580","37512152","37512152","0","2024-09"
"468760","유진스팩10호","9031200000","2130","4240000","4240000","0","2024-09"
"442130","유진스팩9호","7785000000","2250","3460000","3460000","0","2024-09"
"084370","유진테크","806315637500","36250","22243190","22916042","672852","2024-09"
"240600","유진테크놀로지","44634480450","6510","6856295","6928151","71856","2024-09"
"001200","유진투자증권","369193362900","4020","91839145","96866418","5027273","2024-09"
"221800","유투바이오","36852694940","3265","11287196","11287196","0","2024-09"
"179900","유티아이","346492886700","21900","15821593","16286895","465302","2024-09"
"263050","유틸렉스","83708352000","2275","36794880","36798858","3978","2024-09"
"000100","유한양행","10707499968500","145100","73793935","80209064","6415129","2024-09"
"003460","유화증권","101349551075","2215","45756005","56702415","10946410","2024-09"
"191410","육일씨엔에쓰","18935190950","1690","11204255","11204255","0","2024-09"
"372170","윤성에프앤씨","418102115200","52400","7979048","7979048","0","2024-09"
"146060","율촌","30041437689","1251","24013939","24015595","1656","2024-09"
"008730","율촌화학","646040000000","26050","24800000","24800000","0","2024-09"
"072770","율호","143286017760","2040","70238244","70238244","0","2024-09"
"008250","이건산업","51326307280","5020","10224364","10952635","728271","2024-09"
"039020","이건홀딩스","71042244880","3280","21659221","22584709","925488","2024-09"
"025820","이구산업","151152366280","4520","33440789","33442000","1211","2024-09"
"067920","이글루","52249137310","4990","10470769","10996119","525350","2024-09"
"044960","이글벳","62601974700","5100","12274897","12641883","366986","2024-09"
"303530","이노뎁","53409542900","7510","7111790","7339299","227509","2024-09"
"296640","이노룰스","28966020960","5730","5055152","5178252","123100","2024-09"
"302430","이노메트리","91395982500","9300","9827525","9833208","5683","2024-09"
"214320","이노션","800000000000","20000","40000000","40000000","0","2024-09"
"462350","이노스페이스","171668957140","18310","9375694","9375694","0","2024-09"
"274400","이노시뮬레이션","39881112600","5100","7819826","7819826","0","2024-09"
"056090","이노시스","122216057775","1299","94084725","94084725","0","2024-09"
"073490","이노와이어리스","131698612720","17320","7603846","7603846","0","2024-09"
"215790","이노인스트루먼트","19214718156","477","40282428","40283149","721","2024-09"
"344860","이노진","22481040000","1880","11958000","12030000","72000","2024-09"
"088390","이녹스","108124807680","11520","9385834","9385844","10","2024-09"
"272290","이녹스첨단소재","453888358050","23550","19273391","20227658","954267","2024-09"
"053350","이니텍","67084516000","4000","16771129","19790916","3019787","2024-09"
"452400","이닉스","110580707320","12190","9071428","9071428","0","2024-09"
"264850","이랜시스","166317419880","5490","30294612","30294612","0","2024-09"
"054210","이랜텍","138122189550","5550","24886881","25291210","404329","2024-09"
"009730","이렘","46274701395","1005","46044479","46056774","12295","2024-09"
"065440","이루온","35080675506","1327","26436078","27275020","838942","2024-09"
"139480","이마트","1682308568400","62800","26788353","27875819","1087466","2024-09"
"115610","이미지스","57914306625","3675","15758995","15758995","0","2024-09"
"478110","이베스트스팩6호","10115300000","2015","5020000","5020000","0","2024-09"
"131400","이브이첨단소재","127215413990","2135","59585674","59589882","4208","2024-09"
"351330","이삭엔지니어링","67137012000","8100","8288520","8288520","0","2024-09"
"080010","이상네트웍스","50845672880","5360","9486133","9835071","348938","2024-09"
"457190","이수스페셜티케미컬","1261906299750","42150","29938465","30208280","269815","2024-09"
"086890","이수앱지스","235877013810","6570","35902133","35902133","0","2024-09"
"007660","이수페타시스","2890361348300","45700","63246419","63246419","0","2024-09"
"005950","이수화학","173981779280","7880","22078906","22722739","643833","2024-09"
"015020","이스타코","25706923899","661","38890959","42851600","3960641","2024-09"
"047560","이스트소프트","128160537230","12470","10277509","11603992","1326483","2024-09"
"239340","이스트에이드","48023620360","1780","26979562","26979634","72","2024-09"
"067010","이씨에스","31832394750","2795","11389050","12294000","904950","2024-09"
"093230","이아이디","354065768064","1392","254357592","254384360","26768","2024-09"
"418620","이에이트","138001821100","14300","9650477","9650477","0","2024-09"
"456070","이엔셀","248753504250","23350","10653255","10653255","0","2024-09"
"102710","이엔에프테크놀로지","255323629320","17870","14287836","14287836","0","2024-09"
"074610","이엔플러스","112410084828","1532","73374729","73374729","0","2024-09"
"041520","이엘씨","64807590340","5540","11698121","12188730","490609","2024-09"
"063760","이엘피","21146077700","2395","8829260","9325130","495870","2024-09"
"123570","이엠넷","54984307175","2575","21353129","22276078","922949","2024-09"
"083470","이엠앤아이","28722189012","1346","21338922","21340329","1407","2024-09"
"095190","이엠코리아","104462074460","2305","45319772","45319772","0","2024-09"
"091120","이엠텍","440514762400","26800","16437118","17132936","695818","2024-09"
"102460","이연제약","293089036180","15980","18340991","18586811","245820","2024-09"
"039030","이오테크닉스","2085200961900","172300","12102153","12319550","217397","2024-09"
"294090","이오플로우","185048806720","6080","30435659","30435659","0","2024-09"
"088290","이원컴포텍","36218916908","1156","31331243","31331669","426","2024-09"
"084680","이월드","246591900742","1739","141800978","141806193","5215","2024-09"
"353810","이지바이오","118402804800","3540","33447120","34191720","744600","2024-09"
"099750","이지케어텍","112440891220","16730","6720914","6834776","113862","2024-09"
"377330","이지트로닉스","47850176000","6050","7909120","8139954","230834","2024-09"
"035810","이지홀딩스","168062145495","2605","64515219","65145845","630626","2024-09"
"160600","이큐셀","106346383500","3100","34305285","34482552","177267","2024-09"
"092130","이크레더블","153315028000","12730","12043600","12043600","0","2024-09"
"096040","이트론","245561522409","271","906131079","906131295","216","2024-09"
"134060","이퓨쳐","15713311980","4085","3846588","4769250","922662","2024-09"
"001840","이화공영","49509415000","2500","19803766","19805760","1994","2024-09"
"000760","이화산업","33152000000","11840","2800000","2800000","0","2024-09"
"024810","이화전기","196810080587","899","218921113","218948640","27527","2024-09"
"014990","인디에프","56708042450","755","75109990","75112995","3005","2024-09"
"041830","인바디","306130904500","23500","13026847","13683782","656935","2024-09"
"352940","인바이오","24832763050","2285","10867730","10867730","0","2024-09"
"101140","인바이오젠","93257770480","9340","9984772","10044216","59444","2024-09"
"079950","인베니아","17214100000","790","21790000","23200000","1410000","2024-09"
"389470","인벤티지랩","195826084480","19520","10032074","10032074","0","2024-09"
"277410","인산가","52393522980","1390","37693182","38356789","663607","2024-09"
"060150","인선이엔티","253698129060","5660","44822991","46563612","1740621","2024-09"
"033230","인성정보","99161952879","1979","50107101","50515380","408279","2024-09"
"450520","인스웨이브시스템즈","49113290520","3340","14704578","14704578","0","2024-09"
"006490","인스코비","202219947891","1707","118465113","119368998","903885","2024-09"
"465480","인스피언","136555788840","13470","10137772","10137772",,"자료 없음"
"037330","인지디스플레","62910700320","1560","40327372","43885224","3557852","2024-09"
"100030","인지소프트","46536043400","16940","2747110","3283714","536604","2024-09"
"023800","인지컨트롤스","95107730190","6270","15168697","15809197","640500","2024-09"
"034590","인천도시가스","105523174400","25600","4121999","4374754","252755","2024-09"
"211050","인카금융서비스","248603596390","5090","48841571","51379800","2538229","2024-09"
"083640","인콘","26217799840","340","77111176","77720351","609175","2024-09"
"064090","인크레더블버즈","207916025680","4180","49740676","49742745","2069","2024-09"
"216050","인크로스","88353790800","7320","12070190","12843222","773032","2024-09"
"049070","인탑스","321315400600","20200","15906703","17200000","1293297","2024-09"
"119610","인터로조","312050211300","24900","12532137","13216478","684341","2024-09"
"017250","인터엠","20852831010","1030","20245467","21045467","800000","2024-09"
"129260","인터지스","62212161060","2205","28214132","29747874","1533742","2024-09"
"051370","인터플렉스","237940214400","10200","23327472","23327472","0","2024-09"
"064290","인텍플러스","167914635200","13550","12392224","12863962","471738","2024-09"
"189300","인텔리안테크","541221296400","51900","10428156","10733334","305178","2024-09"
"150840","인트로메딕","251537720850","5850","42997901","42997901","0","2024-09"
"048530","인트론바이오","191740225500","5860","32720175","34150762","1430587","2024-09"
"023810","인팩","72400000000","7240","10000000","10000000","0","2024-09"
"115310","인포바인","42572488370","19870","2142551","3192883","1050332","2024-09"
"039290","인포뱅크","50546526660","6060","8341011","8693978","352967","2024-09"
"071200","인피니트헬스케어","106768864140","4380","24376453","24396458","20005","2024-09"
"101930","인화정공","222390277200","23400","9503858","9615733","111875","2024-09"
"249420","일동제약","388259887400","13900","27932366","28062501","130135","2024-09"
"000230","일동홀딩스","89433352800","7920","11292090","11540400","248310","2024-09"
"013360","일성건설","65478154560","1212","54024880","54024880","0","2024-09"
"003120","일성아이에스","105915558420","15540","6815673","13300000","6484327","2024-09"
"333430","일승","90968213235","2965","30680679","30726747","46068","2024-09"
"068330","일신바이오","51470796130","1235","41676758","44216140","2539382","2024-09"
"003200","일신방직","173388593400","8140","21300810","23280000","1979190","2024-09"
"007110","일신석재","105690598650","1365","77429010","77456610","27600","2024-09"
"007570","일양약품","232748070800","12950","17972824","19085664","1112840","2024-09"
"178780","일월지엠엘","124101377000","8650","14346980","14349195","2215","2024-09"
"008500","일정실업","13990345280","11840","1181617","1200000","18383","2024-09"
"019540","일지테크","54504144750","4125","13213126","13513500","300374","2024-09"
"081000","일진다이아","173927092500","12250","14198130","14202975","4845","2024-09"
"020760","일진디스플","46923227184","912","51450907","51513741","62834","2024-09"
"103590","일진전기","1156173773250","24250","47677269","47685390","8121","2024-09"
"094820","일진파워","159834315400","10600","15078709","15078709","0","2024-09"
"271940","일진하이솔루스","733526438000","20200","36313190","36313190","0","2024-09"
"015860","일진홀딩스","185091786425","4025","45985537","49347483","3361946","2024-09"
"226320","잇츠한불","208933884100","11860","17616685","21929315","4312630","2024-09"
"049550","잉크테크","75484166450","3850","19606277","19606277","0","2024-09"
"389020","자람테크놀로지","201462414300","32850","6132798","6197730","64932","2024-09"
"254120","자비스","58660244700","1910","30712170","30754270","42100","2024-09"
"043910","자연과환경","69847903664","616","113389454","113391457","2003","2024-09"
"234920","자이글","47861982365","3565","13425521","13530910","105389","2024-09"
"289220","자이언트스텝","151312735800","6840","22121745","22121745","0","2024-09"
"317400","자이에스앤디","152450080000","4000","38112520","38782520","670000","2024-09"
"033240","자화전자","332534420400","15770","21086520","22155870","1069350","2024-09"
"174880","장원테크","11454988050","2650","4322637","4381265","58628","2024-09"
"049630","재영솔루텍","56215631136","672","83654213","83654213","0","2024-09"
"417840","저스템","59078492480","8330","7092256","7249175","156919","2024-09"
"000950","전방","22253849100","19530","1139470","1680000","540530","2024-09"
"079900","전진건설로봇","264455089200","18210","14522520","15360574","838054","2024-09"
"110020","전진바이오팜","21514559750","2375","9058762","9058762","0","2024-09"
"208140","정다운","85142434780","2605","32684236","32684246","10","2024-09"
"040420","정상제이엘에스","97101823000","6500","14938742","15677552","738810","2024-09"
"045510","정원엔시스","27230162805","865","31479957","32209292","729335","2024-09"
"217190","제너셈","72608760720","8280","8769174","8769174","0","2024-09"
"095700","제넥신","400221166400","8800","45479678","45540494","60816","2024-09"
"072520","제넨바이오","28838655818","389","74135362","74163194","27832","2024-09"
"122310","제노레이","81428755280","6040","13481582","14553844","1072262","2024-09"
"361390","제노코","111086685090","14810","7500789","7500789","0","2024-09"
"187420","제노포커스","73867126320","3120","23675361","23675361","0","2024-09"
"225220","제놀루션","52362472500","2900","18056025","19190021","1133996","2024-09"
"123330","제닉","174099263500","22250","7824686","7968680","143994","2024-09"
"381620","제닉스","115656328000","26450","4372640","4372640","0","2024-09"
"159580","제로투세븐","84838213460","4235","20032636","20032636","0","2024-09"
"147830","제룡산업","120082908330","6270","19151979","20000000","848021","2024-09"
"033100","제룡전기","918769794800","57200","16062409","16062409","0","2024-09"
"079370","제우스","374638953810","12210","30682961","31016990","334029","2024-09"
"054950","제이브이엠","233814750400","20300","11517968","12089892","571924","2024-09"
"023440","제이스코홀딩스","94486891100","1610","58687510","58687510","0","2024-09"
"090470","제이스텍","97161125600","5600","17350201","17476594","126393","2024-09"
"287410","제이시스메디칼","960860460300","12900","74485307","75692193","1206886","2024-06"
"137950","제이씨케미칼","99825680875","4625","21583931","22267814","683883","2024-09"
"033320","제이씨현시스템","80290791750","4250","18891951","19114432","222481","2024-09"
"417500","제이아이테크","112822510080","3570","31602944","32784744","1181800","2024-09"
"204270","제이앤티씨","1349672886650","23650","57068621","57848466","779845","2024-09"
"194370","제이에스코퍼레이션","214429299000","16100","13318590","13335601","17011","2024-09"
"026040","제이에스티나","25254126997","1763","14324519","16503790","2179271","2024-09"
"452160","제이엔비","55296007750","5750","9616697","9617527","830","2024-09"
"126880","제이엔케이글로벌","90355679700","3900","23168123","23204903","36780","2024-09"
"322510","제이엘케이","176721751680","11140","15863712","16195712","332000","2024-09"
"033050","제이엠아이","30024486304","943","31839328","32579342","740014","2024-09"
"094970","제이엠티","55233602870","3305","16712134","16748240","36106","2024-09"
"418550","제이오","511650492900","17300","29575173","31772273","2197100","2024-09"
"025620","제이준코스메틱","22774482220","5090","4474358","4484846","10488","2024-09"
"420570","제이투케이바이오","87764828160","15360","5713856","5732807","18951","2024-09"
"089790","제이티","43410820000","4750","9139120","10315513","1176393","2024-09"
"030000","제일기획","1863528540000","18400","101278725","115041225","13762500","2024-09"
"052670","제일바이오","56184286080","2080","27011676","29129064","2117388","2024-09"
"271980","제일약품","213327008880","14640","14571517","14704872","133355","2024-09"
"412540","제일엠앤에스","221663155400","10760","20600665","20600665","0","2024-09"
"001560","제일연마","57102340000","8390","6806000","9900000","3094000","2024-09"
"199820","제일일렉트릭","203313000000","9150","22220000","22220000","0","2024-09"
"038010","제일테크노스","55218240000","6640","8316000","9000000","684000","2024-09"
"002620","제일파마홀딩스","134936388750","8790","15351125","15973355","622230","2024-09"
"276730","제주맥주","30035616050","2530","11871785","11886605","14820","2024-09"
"080220","제주반도체","425080772480","12620","33683104","34442833","759729","2024-09"
"006220","제주은행","265383673240","8260","32128774","32128774","0","2024-09"
"089590","제주항공","713860043460","8860","80571111","80640985","69874","2024-09"
"216080","제테마","333601618120","18680","17858759","17858759","0","2024-09"
"229000","젠큐릭스","36356951925","2385","15244005","15244005","0","2024-09"
"082270","젬백스","729316856080","18380","39679916","39994174","314258","2024-09"
"044060","조광ILI","70075958688","732","95732184","95732184","0","2024-09"
"004910","조광페인트","63044877280","6160","10234558","12800000","2565442","2024-09"
"004700","조광피혁","182975534500","51500","3552923","6649138","3096215","2024-09"
"001550","조비","55085295080","10610","5191828","5192239","411","2024-09"
"462520","조선내화","195036745640","16460","11849134","11855168","6034","2024-09"
"120030","조선선재","90465839000","93400","968585","1257651","289066","2024-09"
"034940","조아제약","42721181433","1379","30979827","30979827","0","2024-09"
"067000","조이시티","112963968736","1616","69903446","69903446","0","2024-09"
"018470","조일알미늄","208942339650","1650","126631721","126631721","0","2024-09"
"002600","조흥","103200000000","172000","600000","600000","0","2024-09"
"185750","종근당","1376425565300","109100","12616183","13174420","558237","2024-09"
"063160","종근당바이오","161835790500","29500","5485959","5485962","3","2024-09"
"001630","종근당홀딩스","274208140800","57600","4760558","5009861","249303","2024-09"
"033340","좋은사람들","65732478324","678","96950558","96950558","0","2024-09"
"036930","주성엔지니어링","1347147148500","28500","47268321","47268321","0","2024-09"
"109070","주성코퍼레이션","216476814300","4100","52799223","52810230","11007","2024-09"
"044380","주연테크","23019095463","357","64479259","66403852","1924593","2024-09"
"072020","중앙백신","101507437440","10590","9585216","9658687","73471","2024-09"
"000440","중앙에너비스","101534821500","22900","4433835","6227130","1793295","2024-09"
"051980","중앙첨단소재","1237708247500","12410","99734750","99961003","226253","2024-09"
"228760","지노믹트리","399675265920","16660","23990112","24362333","372221","2024-09"
"314130","지놈앤컴퍼니","120166909640","3880","30970853","30970853","0","2024-09"
"013890","지누스","474574791750","23250","20411819","20735204","323385","2024-09"
"389030","지니너스","49027212150","1470","33351845","33351845","0","2024-09"
"043610","지니뮤직","153424756320","2640","58115438","58115438","0","2024-09"
"263860","지니언스","83939435370","9730","8626869","9444600","817731","2024-09"
"303030","지니틱스","43848258504","1227","35736152","35745668","9516","2024-09"
"036180","지더블유바이텍","53929030348","577","93464524","93464524","0","2024-09"
"208350","지란지교시큐리티","23474484000","3000","7824828","8838549","1013721","2024-09"
"144510","지씨셀","537971647800","35800","15027141","15800344","773203","2024-09"
"358570","지아이이노베이션","642926971940","14540","44217811","44217811","0","2024-09"
"382480","지아이텍","91809633150","2350","39067929","39357140","289211","2024-09"
"382800","지앤비에스 에코","106596608170","3370","31631041","31631041","0","2024-09"
"051160","지어소프트","137860565700","9490","14526930","15474430","947500","2024-09"
"053050","지에스이","113353116660","3780","29987597","29987597","0","2024-09"
"119850","지엔씨에너지","78750920160","5280","14914947","16448909","1533962","2024-09"
"065060","지엔코","34839289694","323","107861578","108008044","146466","2024-09"
"204840","지엘팜텍","83783052740","1090","76865186","76865206","20","2024-09"
"013870","지엠비코리아","72760748200","3815","19072280","19072280","0","2024-09"
"071320","지역난방공사","553463963200","47800","11578744","11578744","0","2024-09"
"270520","지오릿에너지","158790786000","1000","158790786","158790786","0","2024-09"
"311320","지오엘리먼트","88301920000","7000","12614560","12614560","0","2024-09"
"388050","지투파워","130586967000","7000","18655281","18709437","54156","2024-09"
"088790","진도","22854057984","1836","12447744","12447744","0","2024-09"
"018120","진로발효","116869712240","17660","6617764","6621120","3356","2024-09"
"109820","진매트릭스","67578691755","3385","19964163","20393640","429477","2024-09"
"086060","진바이오텍","29792631020","3460","8610587","8610587","0","2024-09"
"036890","진성티이씨","172474795960","8630","19985492","22482268","2496776","2024-09"
"363250","진시스템","65467298400","9650","6784176","7006491","222315","2024-09"
"003780","진양산업","84110000000","6470","13000000","13000000","0","2024-09"
"007370","진양제약","66513789360","5860","11350476","12574867","1224391","2024-09"
"010640","진양폴리","68600000000","6860","10000000","10000000","0","2024-09"
"100250","진양홀딩스","177747028560","3180","55895292","55895292","0","2024-09"
"051630","진양화학","41791000000","2645","15800000","15800000","0","2024-09"
"272450","진에어","544710511380","10570","51533634","52200000","666366","2024-09"
"285800","진영","46839035360","2680","17477252","17477270","18","2024-09"
"011000","진원생명과학","182011421880","2280","79829571","80039035","209464","2024-09"
"002780","진흥기업","111968482780","770","145413614","145471745","58131","2024-09"
"085660","차바이오텍","975929297190","17330","56314443","56314443","0","2024-09"
"261780","차백신연구소","107701363220","4015","26824748","26824748","0","2024-09"
"351870","차이커뮤니케이션","103061392400","9260","11129740","11131089","1349","2024-09"
"009310","참엔지니어링","32070633520","380","84396404","84867419","471015","2024-09"
"094850","참좋은여행","62978386985","4705","13385417","14000000","614583","2024-09"
"004650","창해에탄올","71017605360","9360","7587351","9190885","1603534","2024-09"
"278280","천보","544164000000","54800","9930000","10000000","70000","2024-09"
"000650","천일고속","58152450500","40750","1427054","1429220","2166","2024-09"
"362320","청담글로벌","132412866880","6580","20123536","20551290","427754","2024-09"
"012600","청호ICT","116119947330","2490","46634517","46634517","0","2024-09"
"066360","체리부로","35580395130","742","47952015","47952015","0","2024-09"
"033250","체시스","43456000000","1358","32000000","32000000","0","2024-09"
"047820","초록뱀미디어","131865872400","5400","24419606","24453930","34324","2024-09"
"094360","칩스앤미디어","277318339500","13710","20227450","20823124","595674","2024-09"
"016920","카스","28776527549","1171","24574319","26493538","1919219","2024-09"
"284620","카이노스메드","135411362960","4870","27805208","28180793","375585","2024-09"
"035720","카카오","16545681674600","37700","438877498","443530908","4653410","2024-09"
"293490","카카오게임즈","1412097851420","17260","81813317","82667326","854009","2024-09"
"323410","카카오뱅크","10338559275100","21700","476431303","476963637","532334","2024-09"
"377300","카카오페이","3244245262600","24100","134615986","134615986","0","2024-09"
"140430","카티스","49099701160","3070","15993388","17922947","1929559","2024-09"
"042000","카페24","604454225000","25000","24178169","24253054","74885","2024-09"
"006380","카프로","618528628380","3660","168996893","168999996","3103","2024-09"
"313760","캐리","50274632520","6870","7317996","7417913","99917","2024-09"
"317530","캐리소프트","29321774020","4270","6866926","6971196","104270","2024-09"
"071850","캐스텍코리아","51311883870","2115","24260938","24529188","268250","2024-09"
"050110","캠시스","80343074397","1097","73238901","73824118","585217","2024-09"
"452300","캡스톤파트너스","37637334600","2670","14096380","14096380","0","2024-09"
"451760","컨텍","145479792780","9870","14739594","14940476","200882","2024-09"
"078340","컴투스","430029678150","37650","11421771","12737755","1315984","2024-09"
"063080","컴투스홀딩스","142121172500","21550","6594950","6595192","242","2024-09"
"307930","컴퍼니케이","77191450000","4945","15610000","15610000","0","2024-09"
"079190","케스피온","22599488400","600","37665814","38355514","689700","2024-09"
"263700","케어랩스","56162939205","2895","19399979","19414200","14221","2024-09"
"214370","케어젠","823102576800","16800","48994201","53715000","4720799","2024-09"
"221980","케이디켐","46960807740","12540","3744881","4034800","289919","2024-09"
"038530","케이바이오","30029178660","260","115496841","115714347","217506","2024-09"
"001620","케이비아이동국실업","63437027670","570","111293031","111293031","0","2024-09"
"424140","케이비제21호스팩","16692150000","2165","7710000","7710000","0","2024-09"
"192250","케이사인","65517422949","957","68461257","70671257","2210000","2024-09"
"431190","케이쓰리아이","42672719400","5700","7486442","7486442","0","2024-09"
"029460","케이씨","224109233130","19290","11617897","13554044","1936147","2024-09"
"115500","케이씨에스","77520000000","6460","12000000","12000000","0","2024-09"
"281820","케이씨텍","717060968800","35800","20029636","20861556","831920","2024-09"
"089150","케이씨티","38587500000","2250","17150000","17150000","0","2024-09"
"025880","케이씨피드","44829786240","2840","15785136","16715858","930722","2024-09"
"093320","케이아이엔엑스","353572784700","73100","4836837","4880000","43163","2024-09"
"093640","케이알엠","127078848000","3900","32584320","32584320","0","2024-09"
"073010","케이에스피","160678269940","4010","40069394","40191250","121856","2024-09"
"105330","케이엔더블유","66020876480","4160","15870403","16060028","189625","2024-09"
"053080","케이엔솔","203189217280","15680","12958496","12999807","41311","2024-09"
"199430","케이엔알시스템","84007421490","7730","10867713","10867713","0","2024-09"
"432470","케이엔에스","139400114920","16070","8674556","8674556","0","2024-09"
"272110","케이엔제이","132249125400","16520","8005395","8005395","0","2024-09"
"039420","케이엘넷","56102460750","2625","21372366","24154730","2782364","2024-09"
"083550","케이엠","37829014080","3280","11533236","12374226","840990","2024-09"
"032500","케이엠더블유","312593931550","7850","39820883","39820883","0","2024-09"
"225430","케이엠제약","19381472645","695","27887011","27887050","39","2024-09"
"102370","케이옥션","113261268750","4375","25888290","27229210","1340920","2024-09"
"068100","케이웨더","34507405770","3545","9734106","9939614","205508","2024-09"
"381970","케이카","622512383160","12920","48182073","48182073","0","2024-09"
"036030","케이티알파","201713765215","4115","49019141","49019283","142","2024-09"
"064820","케이프","142577830080","5110","27901728","30901728","3000000","2024-09"
"256940","케이피에스","102742645840","5480","18748658","18748658","0","2024-09"
"024880","케이피에프","79530086460","4110","19350386","20682798","1332412","2024-09"
"042040","케이피엠테크","52857208296","303","174446232","174460917","14685","2024-09"
"054410","케이피티유","22504924920","3930","5726444","5726444","0","2024-09"
"258610","케일럼","41119145550","1550","26528481","26787133","258652","2024-09"
"274090","켄코아에어로스페이스","129648789040","10040","12913226","12913226","0","2024-09"
"089010","켐트로닉스","296170913970","19870","14905431","15334346","428915","2024-09"
"220260","켐트로스","125620721160","4730","26558292","26558307","15","2024-09"
"052400","코나아이","199355301600","13650","14604784","14899999","295215","2024-09"
"402030","코난테크놀로지","164692529440","14380","11452888","11452888","0","2024-09"
"391710","코닉오토메이션","88603499180","2135","41500468","41503222","2754","2024-09"
"046070","코다코","144219271360","10280","14029112","14064588","35476","2024-09"
"047770","코데즈컴바인","54585428514","1446","37749259","37842602","93343","2024-09"
"080530","코디","65765043984","1524","43152916","43300427","147511","2024-09"
"104540","코렌텍","81317306400","6360","12785740","12785740","0","2024-09"
"027050","코리아나","77112000000","2520","30600000","40000000","9400000","2024-09"
"007810","코리아써키트","246364432930","10430","23620751","23620751","0","2024-09"
"190650","코리아에셋투자증권","35581160000","5570","6388000","6388000","0","2024-09"
"123410","코리아에프티","144773506800","5200","27841059","27841064","5","2024-09"
"003690","코리안리","1322462383480","8980","147267526","165367526","18100000","2024-09"
"036690","코맥스","45885746130","2885","15904938","15904938","0","2024-09"
"049430","코메론","98378851500","10950","8984370","9048000","63630","2024-09"
"183300","코미코","535827760000","52000","10304380","10460684","156304","2024-09"
"041960","코미팜","304152633400","4390","69283060","70622233","1339173","2024-09"
"089890","코세스","150877203200","9200","16399696","16584962","185266","2024-09"
"360350","코셈","41632259800","7340","5671970","5671970","0","2024-09"
"082660","코스나인","47827116000","480","99639825","99640869","1044","2024-09"
"192820","코스맥스","1604276606800","141400","11345662","11349509","3847","2024-09"
"044820","코스맥스비티아이","82936002520","8680","9554839","9603921","49082","2024-09"
"222040","코스맥스엔비티","68961474780","3355","20554836","20628000","73164","2024-09"
"241710","코스메카코리아","780708000000","73100","10680000","10680000","0","2024-09"
"005070","코스모신소재","3409144680400","104900","32498996","32510756","11760","2024-09"
"005420","코스모화학","842097680050","21950","38364359","38408228","43869","2024-09"
"355150","코스텍시스","59363365260","7860","7552591","7797350","244759","2024-09"
"071950","코아스","33170457600","10080","3290720","3290720","0","2024-09"
"166480","코아스템켐온","364427529840","14960","24360129","32870376","8510247","2024-09"
"045970","코아시아","114338662930","4610","24802313","26314876","1512563","2024-09"
"196450","코아시아씨엠","40550902545","895","45308271","45319582","11311","2024-09"
"384470","코어라인소프트","98675811450","7690","12831705","12832064","359","2024-09"
"029960","코엔텍","350752798400","7220","48580720","50000000","1419280","2024-09"
"002020","코오롱","182830648480","14480","12626426","12626426","0","2024-09"
"138490","코오롱ENP","217740000000","5730","38000000","38000000","0","2024-09"
"003070","코오롱글로벌","171232664840","9080","18858223","18932713","74490","2024-09"
"450140","코오롱모빌리티그룹","144128512700","2350","61331282","62777250","1445968","2024-09"
"102940","코오롱생명과학","242131812630","19490","12423387","12423387","0","2024-09"
"120110","코오롱인더","888641831300","32300","27512131","27519091","6960","2024-09"
"021240","코웨이","4789148257800","66600","71909133","73799619","1890486","2024-09"
"033290","코웰패션","130619916160","2465","52989824","56156301","3166477","2024-09"
"056360","코위버","44761791780","4835","9257868","9796800","538932","2024-09"
"282880","코윈테크","154994801610","14190","10922819","11141807","218988","2024-09"
"121850","코이즈","29000882280","955","30367416","30614175","246759","2024-09"
"448710","코츠테크놀로지","98308765850","22150","4438319","5166069","727750","2024-09"
"126730","코칩","104245804510","12730","8188987","8503460","314473","2024-09"
"015710","코콤","74524737130","4490","16597937","17530500","932563","2024-09"
"052330","코텍","98818568820","7860","12572337","15574552","3002215","2024-09"
"322780","코퍼스코리아","40842488250","1107","36894750","37932613","1037863","2024-09"
"036420","콘텐트리중앙","196967982670","10310","19104557","19262308","157751","2024-09"
"200130","콜마비앤에이치","416953893440","14320","29116892","29415558","298666","2024-09"
"024720","콜마홀딩스","237673074870","6930","34296259","34296259","0","2024-09"
"031820","콤텍시스템","68151975358","563","121051466","121051466","0","2024-09"
"294570","쿠콘","139301715780","13660","10197783","10254685","56902","2024-09"
"192400","쿠쿠홀딩스","769190028750","24750","31078385","35562185","4483800","2024-09"
"284740","쿠쿠홈시스","528047049000","23550","22422380","22437330","14950","2024-09"
"317690","퀀타매트릭스","119896229750","7250","16537411","16537411","0","2024-09"
"078940","퀀타피아","151577916950","2855","53092090","53094278","2188","2024-09"
"227100","퀀텀온","18283595924","1166","15680614","15680614","0","2024-09"
"432720","퀄리타스반도체","139212783360","10080","13810792","13810792","0","2024-09"
"365270","큐라클","77555481120","5590","13873968","13873968","0","2024-09"
"348080","큐라티스","33637303980","798","42152010","42152010","0","2024-09"
"060280","큐렉소","286397230300","6970","41089990","41089990","0","2024-09"
"372320","큐로셀","435384862500","30900","14090125","14090125","0","2024-09"
"051780","큐로홀딩스","18871240202","139","135764318","136422450","658132","2024-09"
"115180","큐리언트","175965686900","5450","32287282","32292671","5389","2024-09"
"445680","큐리옥스바이오시스템즈","382297527500","23750","16096738","16096738","0","2024-09"
"182360","큐브엔터","192361237300","13850","13888898","14571557","682659","2024-09"
"405100","큐알티","167442495000","14200","11791725","12289301","497576","2024-09"
"066310","큐에스아이","61596565550","6890","8939995","9271621","331626","2024-09"
"016600","큐캐피탈","49563686248","284","174520022","178247112","3727090","2024-09"
"355390","크라우드웍스","48589591610","11510","4221511","4224606","3095","2024-09"
"264900","크라운제과","100695496220","8380","12016169","12523850","507681","2024-09"
"005740","크라운해태홀딩스","84858136500","5900","14382735","14847347","464612","2024-09"
"259960","크래프톤","15136695153000","333000","45455541","47900115","2444574","2024-09"
"096240","크레버스","132439029900","15700","8435607","11138180","2702573","2024-09"
"040350","크레오에스지","106781053632","704","151677633","152074086","396453","2024-09"
"110790","크리스에프앤씨","135494690730","6690","20253317","23430960","3177643","2024-09"
"045520","크린앤사이언스","31686060000","5180","6117000","6500000","383000","2024-09"
"036170","클라우드에어","52376983252","869","60272708","61365626","1092918","2024-09"
"214150","클래시스","3687968601700","56300","65505659","65505659","0","2024-09"
"352770","클리노믹스","24106354272","627","38447136","38886113","438977","2024-09"
"237880","클리오","406571253600","23200","17524623","18071353","546730","2024-09"
"139670","키네마스터","40026826350","2835","14118810","14118810","0","2024-09"
"020120","키다리스튜디오","133242175240","3595","37063192","37063766","574","2024-09"
"413600","키움제6호스팩","9020900000","2630","3430000","3430000","0","2024-09"
"433530","키움제7호스팩","9092575000","2215","4105000","4105000","0","2024-09"
"446840","키움제8호스팩","13171200000","2240","5880000","5880000","0","2024-09"
"039490","키움증권","3277038823800","135800","24131361","25526706","1395345","2024-09"
"054780","키이스트","86265854975","4415","19539265","19547793","8528","2024-09"
"219130","타이거일렉","130705803000","20700","6314290","6314290","0","2024-09"
"360070","탑머티리얼","277433679600","34650","8006744","8076743","69999","2024-09"
"065130","탑엔지니어링","62991695760","4060","15515196","17189982","1674786","2024-09"
"134580","탑코미디어","48053787000","2220","21645850","22025767","379917","2024-09"
"014580","태경비케이","122468964000","4440","27583100","27583100","0","2024-09"
"015890","태경산업","149651200000","5120","29228750","29228750","0","2024-09"
"006890","태경케미컬","126259634860","11140","11333899","11600000","266101","2024-09"
"023160","태광","334463439060","12930","25867242","26500000","632758","2024-09"
"003240","태광산업","536118947000","637000","841631","1113400","271769","2024-09"
"011280","태림포장","145594740915","2115","68839121","70805940","1966819","2024-09"
"323280","태성","769457754000","29800","25820730","25820730","0","2024-09"
"053620","태양","50950598400","6400","7961031","8600000","638969","2024-09"
"004100","태양금속","110000057200","3020","36423860","36700000","276140","2024-09"
"009410","태영건설","1330097939940","4620","287899987","287905337","5350","2024-09"
"044490","태웅","285705400680","14280","20007381","20007381","0","2024-09"
"124560","태웅로직스","103069064400","2850","36164584","38416584","2252000","2024-09"
"001420","태원물산","27865806600","3800","7333107","7600000","266893","2024-09"
"191420","테고사이언스","128105056000","16000","8006566","8108834","102268","2024-09"
"073640","테라사이언스","59577565530","654","91097195","95587404","4490209","2024-09"
"066700","테라젠이텍스","113619095450","3550","32005379","32474435","469056","2024-09"
"095610","테스","288202343180","16430","17541226","19768226","2227000","2024-09"
"055490","테이팩스","81513318500","17090","4769650","4769650","0","2024-09"
"064520","테크엘","49160148400","2200","22345522","22351062","5540","2024-09"
"089030","테크윙","1463572410300","40950","35740474","37353645","1613171","2024-09"
"054450","텔레칩스","190715944320","12920","14761296","15144233","382937","2024-09"
"078000","텔코웨어","51175269730","9910","5164003","9240077","4076074","2024-09"
"200230","텔콘RF제약","66979380895","557","120250235","120250235","0","2024-09"
"214420","토니모리","188352889880","7880","23902651","24054799","152148","2024-09"
"393210","토마토시스템","98281107450","6390","15380455","15614544","234089","2024-09"
"215480","토박스코리아","23745250800","2650","8960472","9400000","439528","2024-09"
"051360","토비스","310046081800","20300","15273206","16167058","893852","2024-09"
"045340","토탈소프트","43646004000","5100","8558040","8558040","0","2024-09"
"108230","톱텍","196023463440","5380","36435588","38023245","1587657","2024-09"
"079970","투비소프트","8424605301","1007","8366043","9290500","924457","2024-09"
"199800","툴젠","448060099200","56400","7944328","7946828","2500","2024-09"
"417790","트루엔","94948306370","9070","10468391","10999650","531259","2024-09"
"290090","트윔","59022316230","8430","7001461","7432268","430807","2024-09"
"026150","특수건설","113524761570","6470","17546331","17546331","0","2024-09"
"464280","티디에스팜","82500600000","15600","5288500","5530000","241500","2024-09"
"322180","티라유텍","94821786500","5740","16519475","16519475","0","2024-09"
"117730","티로보틱스","132172614600","7410","17837060","17837060","0","2024-09"
"033830","티비씨","81017052050","857","94535650","100000000","5464350","2024-09"
"057680","티사이언티픽","63696159894","894","71248501","71248501","0","2024-09"
"204610","티쓰리","84692986035","1445","58611063","63851720","5240657","2024-09"
"064760","티씨케이","1053085000000","90200","11675000","11675000","0","2024-09"
"246710","티앤알바이오팹","153413415360","7120","21546828","21546828","0","2024-09"
"340570","티앤엘","587642400800","72800","8072011","8128000","55989","2024-09"
"043220","티에스넥스젠","82916688195","583","142224165","142224165","0","2024-09"
"277880","티에스아이","126610024960","6280","20160832","20160832","0","2024-09"
"131290","티에스이","589967944000","54700","10785520","11061429","275909","2024-09"
"019180","티에이치엔","57600000000","3200","18000000","18000000","0","2024-09"
"425420","티에프이","184934850000","16350","11311000","11381000","70000","2024-09"
"131100","티엔엔터테인먼트","43299184072","1544","28043513","28048252","4739","2024-09"
"356860","티엘비","117271560000","12000","9772630","9832630","60000","2024-09"
"062860","티엘아이","42843237000","5800","7386765","9872720","2485955","2024-09"
"363280","티와이홀딩스","120553122675","3405","35404735","50429268","15024533","2024-09"
"321550","티움바이오","164741370690","6330","26025493","26025493","0","2024-09"
"091810","티웨이항공","624003396500","2900","215173585","215378976","205391","2024-09"
"004870","티웨이홀딩스","64176430800","575","111611184","111611693","509","2024-09"
"425040","티이엠씨","196300703040","9280","21153093","21316062","162969","2024-09"
"241790","티이엠씨씨엔에스","58183487630","5990","9713437","10002634","289197","2024-09"
"104480","티케이케미칼","132980019942","1463","90895434","90895434","0","2024-09"
"081150","티플랙스","76566808310","3155","24268402","24268402","0","2024-09"
"130740","티피씨글로벌","21346753347","1893","11276679","11276679","0","2024-09"
"084730","팅크웨어","108984158400","10400","10479246","11109424","630178","2024-09"
"440110","파두","987551441800","20050","49254436","49334436","80000","2024-09"
"034230","파라다이스","898147380000","10400","86360325","91771623","5411298","2024-09"
"033540","파라텍","50819063778","1358","37421991","37751063","329072","2024-09"
"388870","파로스아이바이오","129826858480","10040","12930962","12930962","0","2024-09"
"043200","파루","22609868012","541","41792732","41804315","11583","2024-09"
"214450","파마리서치","2350681779000","226500","10378286","10498238","119952","2024-09"
"208340","파멥신","233760977175","2915","80192445","80201108","8663","2024-09"
"005690","파미셀","306020471400","5100","60004014","60016964","12950","2024-09"
"177830","파버나인","37243485010","3130","11898877","14288753","2389876","2024-09"
"037070","파세코","119233944450","5970","19972185","20000000","27815","2024-09"
"150900","파수","55390388900","4900","11304161","11685422","381261","2024-09"
"037030","파워넷","54027152270","2470","21873341","21878974","5633","2024-09"
"047310","파워로직스","184884312750","5050","36610755","36610755","0","2024-09"
"368770","파이버프로","152518559625","4665","32694225","32854225","160000","2024-09"
"170790","파이오링크","53908479630","8070","6680109","6856330","176221","2024-09"
"049120","파인디앤씨","55144474824","1182","46653532","46653532","0","2024-09"
"038950","파인디지털","31573669050","3850","8200953","10210765","2009812","2024-09"
"441270","파인엠텍","235146709080","6360","36972753","36987901","15148","2024-09"
"106240","파인테크닉스","16506736480","1040","15871862","15923057","51195","2024-09"
"131760","파인텍","35657329643","821","43431583","43431583","0","2024-09"
"065690","파커스","14023893244","1052","13330697","14049331","718634","2024-09"
"140860","파크시스템스","1436170554000","207000","6938022","6983609","45587","2024-09"
"091700","파트론","359769244200","7080","50814865","58918214","8103349","2024-09"
"032800","판타지오","37249153971","163","228522417","229785294","1262877","2024-09"
"318010","팜스빌","44436678500","5750","7728118","7929338","201220","2024-09"
"036580","팜스코","75640685760","2160","35018836","36727943","1709107","2024-09"
"027710","팜스토리","144004143822","1302","110602261","111416600","814339","2024-09"
"004720","팜젠사이언스","85332773575","4705","18136615","18178525","41910","2024-09"
"225590","패션플랫폼","22713304334","887","25606882","26636713","1029831","2024-09"
"054300","팬스타엔터프라이즈","33013142554","493","66963778","66985895","22117","2024-09"
"068050","팬엔터테인먼트","58545992785","2165","27042029","27694076","652047","2024-09"
"028670","팬오션","1881684682240","3520","534569512","534569512","0","2024-09"
"222110","팬젠","54333891080","4760","11414683","11414683","0","2024-09"
"271830","팸텍","62129223665","2165","28697101","29490202","793101","2024-09"
"010820","퍼스텍","169353006945","3485","48594837","48771938","177101","2024-09"
"016800","퍼시스","414336477600","46300","8948952","11500000","2551048","2024-09"
"263750","펄어비스","2272518170000","37000","61419410","64247855","2828445","2024-09"
"251970","펌텍코리아","442622380200","35700","12398386","12400000","1614","2024-09"
"001020","페이퍼코리아","143760557456","808","177921482","177983313","61831","2024-09"
"168360","펨트론","169241857800","7950","21288284","21288284","0","2024-09"
"087010","펩트론","1971888666200","95800","20583389","20657350","73961","2024-09"
"090080","평화산업","54463040928","992","54902259","54902259","0","2024-09"
"010770","평화홀딩스","39569642750","2750","14388961","14625466","236505","2024-09"
"064800","포니링크","186930904280","1483","126049160","127807298","1758138","2024-09"
"119500","포메탈","34416208960","2905","11847232","11847232","0","2024-09"
"389140","포바이포","61800468800","5600","11035798","11112735","76937","2024-09"
"105760","포스뱅크","63098099950","6670","9459985","9459985","0","2024-09"
"022100","포스코DX","4091616887050","26950","151822519","152034729","212210","2024-09"
"058430","포스코스틸리온","226444302000","37800","5990590","6000000","9410","2024-09"
"009520","포스코엠텍","670396899900","16100","41639559","41642703","3144","2024-09"
"047050","포스코인터내셔널","8692668837000","51000","170444487","175922788","5478301","2024-09"
"003670","포스코퓨처엠","18236004672000","235500","77435264","77463220","27956","2024-09"
"189690","포시에스","62139888360","2280","27254337","27321969","67632","2024-09"
"318020","포인트모바일","54527252500","4375","12463372","12662272","198900","2024-09"
"256630","포인트엔지니어링","73764525312","1296","56917072","57997072","1080000","2024-09"
"331380","포커스에이치엔에스","76869560400","3450","22281032","22725452","444420","2024-09"
"472850","폰드그룹","203716655100","6300","32335977","32343933","7956","2024-09"
"039980","폴라리스AI","164747968770","2310","71319467","72152777","833310","2024-09"
"041910","폴라리스AI파마","83616040200","6700","12480006","12698263","218257","2024-09"
"234100","폴라리스세원","69975391918","1286","54413213","54413213","0","2024-09"
"041020","폴라리스오피스","240221139155","4835","49683793","49725498","41705","2024-09"
"114630","폴라리스우노","40048200857","527","75992791","77757548","1764757","2024-09"
"290720","푸드나무","39342243150","3150","12489601","13403058","913457","2024-09"
"005670","푸드웰","48366958410","5130","9428257","10000000","571743","2024-09"
"094940","푸른기술","49484442380","6260","7904863","8361386","456523","2024-09"
"057880","푸른소나무","215672327790","8790","24536101","24580368","44267","2024-09"
"007330","푸른저축은행","102767912400","8770","11718120","15082800","3364680","2024-09"
"017810","풀무원","392594730750","10650","36863355","38120542","1257187","2024-09"
"093380","풍강","27374373810","2855","9588222","9879313","291091","2024-08"
"023900","풍국주정","127638000000","10130","12600000","12600000","0","2024-09"
"103140","풍산","1901073748800","69600","27314278","28024278","710000","2024-09"
"005810","풍산홀딩스","386505321600","27600","14003816","14417292","413476","2024-09"
"371950","풍원정밀","225554031360","10720","21040488","21040488","0","2024-09"
"370090","퓨런티어","121909267000","14900","8181830","8181830","0","2024-09"
"445180","퓨릿","110508948920","6590","16769188","16769188","0","2024-09"
"151910","퓨처코어","121645902080","640","190071722","190071722","0","2024-09"
"220100","퓨쳐켐","602141288000","27250","22096928","22102155","5227","2024-09"
"035200","프럼파스트","23362042080","2760","8464508","9730590","1266082","2024-09"
"334970","프레스티지바이오로직스","452035797150","7350","61501469","61501469","0","2024-09"
"321260","프로이천","60894834480","2160","28192053","28192084","31","2024-09"
"053610","프로텍","292500000000","32500","9000000","11000000","2000000","2024-09"
"303360","프로티아","37021993125","2875","12877215","12877215","0","2024-09"
"377220","프롬바이오","60583400000","2140","28310000","28310000","0","2024-09"
"335810","프리시젼바이오","39489388400","3400","11614526","11614526","0","2024-09"
"053160","프리엠스","68228777320","12730","5359684","6000000","640316","2024-09"
"405000","플라즈맵","50224001544","1926","26076844","26076844","0","2024-09"
"041590","플래스크","103917099150","789","131707350","131707350","0","2024-09"
"367000","플래티어","39015940185","4815","8102999","8388207","285208","2024-09"
"075130","플랜티넷","31762273680","2040","15569742","16622320","1052578","2024-09"
"009810","플레이그램","53764771290","354","151877885","151887500","9615","2024-09"
"237820","플레이디","77091111400","6010","12827140","12827140","0","2024-09"
"023770","플레이위드","36776809900","4195","8766820","8766820","0","2024-09"
"019570","플루토스","19989080418","381","52464778","52470042","5264","2024-09"
"300080","플리토","86905435650","15810","5496865","5501817","4952","2024-09"
"033790","피노","202508976000","8920","22702800","22822800","120000","2024-09"
"032580","피델릭스","49605366706","1498","33114397","33132064","17667","2024-09"
"051380","피씨디렉트","42280503980","2860","14783393","15340072","556679","2024-09"
"241820","피씨엘","62071393383","1049","59171967","59171967","0","2024-09"
"237750","피앤씨테크","30079258000","4630","6496600","6496600","0","2024-09"
"460940","피앤에스미캐닉스","82708837200","12780","6471740","6471740","0","2024-09"
"319660","피에스케이","611197665400","21100","28966714","28966714","0","2024-09"
"031980","피에스케이홀딩스","1082432229000","50200","21562395","21562395","0","2024-09"
"002230","피에스텍","59915649375","3625","16528455","19370673","2842218","2024-09"
"043370","피에이치에이","197871447690","10130","19533213","21000000","1466787","2024-09"
"239890","피엔에이치테크","69550285000","7000","9935755","9935755","0","2024-09"
"347740","피엔케이피부임상연구센타","69893934220","2420","28881791","30010576","1128785","2024-09"
"137400","피엔티","1211186205600","52100","23247336","23743086","495750","2024-09"
"257370","피엔티엠에스","63882774800","5200","12285149","12504861","219712","2024-09"
"147760","피엠티","37869531000","3500","10819866","10819866","0","2024-09"
"128660","피제이메탈","81851117700","3300","24803369","24803369","0","2024-09"
"006140","피제이전자","77149350000","5190","14865000","15000000","135000","2024-09"
"376180","피코그램","61903811970","3365","18396378","18491378","95000","2024-09"
"304840","피플바이오","77816986600","3700","21031618","21089464","57846","2024-09"
"087600","픽셀플러스","45360567000","7000","6480081","8166558","1686477","2024-09"
"291810","핀텔","22829001120","2010","11357712","11357712","0","2024-09"
"378340","필에너지","334188347400","15700","21285882","21285882","0","2024-09"
"161580","필옵틱스","510545073000","22350","22843180","22843180","0","2024-09"
"347770","핌스","52799767020","2310","22857042","22857042","0","2024-09"
"163730","핑거","96460024500","10500","9186669","9360608","173939","2024-09"
"417180","핑거스토리","45110190125","2695","16738475","16739405","930","2024-09"
"446750","하나26호스팩","12843900000","2130","6030000","6030000","0","2024-09"
"448370","하나27호스팩","11998700000","2135","5620000","5620000","0","2024-09"
"454750","하나28호스팩","14980160000","2080","7202000","7202000","0","2024-09"
"454640","하나29호스팩","11558140000","2140","5401000","5401000","0","2024-09"
"469880","하나30호스팩","15011775000","2055","7305000","7305000","0","2024-09"
"469900","하나31호스팩","11658400000","2080","5605000","5605000","0","2024-09"
"475240","하나32호스팩","6944000000","2170","3200000","3200000","0","2024-09"
"475250","하나33호스팩","7881000000","2130","3700000","3700000","0","2024-09"
"406760","하나금융21호스팩","15375750000","2075","7410000","7410000","0","2024-09"
"418170","하나금융22호스팩","13492450000","2245","6010000","6010000","0","2024-09"
"435620","하나금융25호스팩","44568720000","10360","4302000","4302000","0","2024-09"
"086790","하나금융지주","17889364432800","64400","277785162","287240880","9455718","2024-09"
"299030","하나기술","225456462000","28200","7994910","7994910","0","2024-09"
"067310","하나마이크론","713332121600","10850","65744896","65744896","0","2024-09"
"166090","하나머티리얼즈","581715426900","29850","19487954","19777674","289720","2024-09"
"293480","하나제약","192024294600","11100","17299486","17772946","473460","2024-09"
"039130","하나투어","753585191800","48650","15489932","16039185","549253","2024-09"
"136480","하림","299447853240","2820","106187182","106209702","22520","2024-09"
"003380","하림지주","512566423870","5270","97261181","112005621","14744440","2024-09"
"450330","하스","65744115510","8390","7836009","7836009","0","2024-09"
"101670","하이드로리튬","85598532550","1735","49336330","51086330","1750000","2024-09"
"365590","하이딥","126832079949","879","144291331","144447309","155978","2024-09"
"149980","하이로닉","113124838250","6770","16709725","18594363","1884638","2024-09"
"013030","하이록코리아","280180167250","23150","12102815","12856050","753235","2024-09"
"352820","하이브","8043106398600","193800","41502097","41652097","150000","2024-09"
"126700","하이비젼시스템","209901721190","16490","12729031","14942112","2213081","2024-09"
"106080","하이소닉","91888656560","5840","15734359","15735465","1106","2024-09"
"071090","하이스틸","65697458505","3255","20183551","20191471","7920","2024-09"
"450050","하이제8호스팩","10529400000","2100","5014000","5014000","0","2024-09"
"160190","하이젠알앤엠","216132000000","7750","27888000","30888000","3000000","2024-09"
"221840","하이즈항공","34577337289","1849","18700561","18700561","0","2024-09"
"106190","하이텍팜","161828141560","15220","10632598","10633173","575","2024-09"
"019490","하이트론","100900682400","3360","30029965","30044269","14304","2024-09"
"000080","하이트진로","1372988540000","20000","68649427","70133611","1484184","2024-09"
"000140","하이트진로홀딩스","197639412750","9250","21366423","23206765","1840342","2024-09"
"065650","하이퍼코퍼레이션","136867341750","1285","106511550","106681728","170178","2024-09"
"066130","하츠","62064872870","5170","12004811","12800000","795189","2024-09"
"004590","한국가구","55200000000","3680","15000000","15000000","0","2024-09"
"036460","한국가스공사","3582656565700","41050","87275434","92313000","5037566","2024-09"
"039340","한국경제TV","112493743820","5290","21265358","23000000","1734642","2024-09"
"005430","한국공항","178905343500","58500","3058211","3166355","108144","2024-09"
"071050","한국금융지주","4081960906200","77400","52738513","55725992","2987479","2024-09"
"034950","한국기업평가","380066209200","85200","4460871","4540514","79643","2024-09"
"010040","한국내화","78315995420","2210","35437102","41067062","5629960","2024-09"
"025540","한국단자","789097500000","76500","10315000","10415000","100000","2024-09"
"222980","한국맥널티","41165524640","3790","10861616","11031483","169867","2024-09"
"010100","한국무브넥스","110687276700","3635","30450420","30450420","0","2024-09"
"256840","한국비엔씨","340858499760","5130","66444152","67912443","1468291","2024-09"
"219750","한국비티비","63245329550","967","65403650","65426885","23235","2024-09"
"004090","한국석유","220291193080","17480","12602471","12694120","91649","2024-09"
"025550","한국선재","62828933760","2840","22122864","23300000","1177136","2024-09"
"002200","한국수출포장","97751095710","2630","37167717","40000000","2832283","2024-09"
"002960","한국쉘석유","416650000000","320500","1300000","1300000","0","2024-09"
"017890","한국알콜","186871784440","9080","20580593","21605760","1025167","2024-09"
"000240","한국앤컴퍼니","1557166287360","16440","94718144","94935240","217096","2024-09"
"080720","한국유니온제약","15410411825","2725","5655197","7912828","2257631","2024-09"
"123890","한국자산신탁","357923635875","2925","122367055","123977752","1610697","2024-09"
"015760","한국전력","14091111490150","21950","641964077","641964077","0","2024-09"
"063570","한국전자금융","155291484160","5120","30330368","34147728","3817360","2024-09"
"041460","한국전자인증","65110170000","3440","18927375","19000000","72625","2024-09"
"006200","한국전자홀딩스","32365644606","738","43855887","46803136","2947249","2024-09"
"101680","한국정밀기계","19998590220","2380","8402769","8404000","1231","2024-09"
"039740","한국정보공학","21369028005","2665","8018397","8018397","0","2024-09"
"053300","한국정보인증","158538857980","3860","41072243","42441361","1369118","2024-09"
"025770","한국정보통신","293163427110","8210","35708091","37444271","1736180","2024-09"
"458610","한국제12호스팩","9221400000","2180","4230000","4230000","0","2024-09"
"464440","한국제13호스팩","9331200000","2160","4320000","4320000","0","2024-09"
"477530","한국제14호스팩","10942750000","2275","4810000","4810000","0","2024-09"
"479880","한국제15호스팩","13946100000","2030","6870000","6870000","0","2024-09"
"027970","한국제지","189390117120","996","190150720","190178237","27517","2024-09"
"023350","한국종합기술","45621167275","4385","10403915","10950000","546085","2024-09"
"025890","한국주강","21954893520","1970","11144616","11309259","164643","2024-09"
"000970","한국주철관","137885317700","6410","21510970","22800500","1289530","2024-09"
"104700","한국철강","269870114910","7870","34290993","42450000","8159007","2024-09"
"062970","한국첨단소재","19835502090","2010","9868409","9868409","0","2024-09"
"017960","한국카본","536473431400","10900","49217746","51908452","2690706","2024-09"
"023760","한국캐피탈","178262127750","570","312740575","315609576","2869001","2024-09"
"054040","한국컴퓨터","66284436400","4900","13527436","16071290","2543854","2024-09"
"161890","한국콜마","1628750313000","69000","23605077","23605077","0","2024-09"
"021650","한국큐빅","40137719830","2470","16250089","16350563","100474","2024-09"
"161390","한국타이어앤테크놀로지","4446490046850","36450","121988753","123875069","1886316","2024-09"
"034830","한국토지신탁","223849664697","1039","215447223","252489230","37042007","2024-09"
"007280","한국특강","94625511916","1556","60813311","60813311","0","2024-09"
"032300","한국파마","242128762200","22200","10906701","10906701","0","2024-09"
"037230","한국팩키지","59183449422","1986","29800327","29800327","0","2024-09"
"047810","한국항공우주","5575576120400","57200","97475107","97475107","0","2024-09"
"123690","한국화장품","107006692860","6660","16067071","16068000","929","2024-09"
"003350","한국화장품제조","280575541800","77400","3625007","4532000","906993","2024-09"
"030520","한글과컴퓨터","426025813500","17700","24069255","24179744","110489","2024-09"
"052600","한네트","45907889000","3970","11563700","11563700","0","2024-09"
"011500","한농화성","291962841800","19090","15294020","15637042","343022","2024-09"
"002390","한독","210444419570","15290","13763533","13763533","0","2024-09"
"256150","한독크린텍","54494293000","7000","7784899","8395000","610101","2024-09"
"092460","한라IMS","105416736000","6450","16343680","17109680","766000","2024-09"
"053690","한미글로벌","145148018500","14270","10171550","10957550","786000","2024-09"
"042700","한미반도체","9711154803000","101500","95676402","96993634","1317232","2024-09"
"008930","한미사이언스","2217623871500","32750","67713706","68391550","677844","2024-09"
"128940","한미약품","4038648159000","318500","12680214","12810991","130777","2024-09"
"452190","한빛레이저","106540089400","4600","23160889","23162757","1868","2024-09"
"047080","한빛소프트","33932168854","1367","24822362","24822362","0","2024-09"
"009240","한샘","856576615200","51600","16600322","23533928","6933606","2024-09"
"452280","한선엔지니어링","156252975000","9190","17002500","17002500","0","2024-09"
"020000","한섬","341484204600","15900","21476994","23398500","1921506","2024-09"
"003680","한성기업","28805080500","5100","5648055","6209515","561460","2024-09"
"066980","한성크린텍","115808917500","2230","51932250","51935125","2875","2024-09"
"105630","한세실업","608858690940","15460","39382839","40000000","617161","2024-09"
"069640","한세엠케이","41759212930","1522","27437065","30106502","2669437","2024-09"
"016450","한세예스24홀딩스","191490619125","4875","39280127","40000000","719873","2024-09"
"010420","한솔PNS","21497169588","1049","20493012","20493012","0","2024-09"
"009180","한솔로지스틱스","63393754840","2260","28050334","28057025","6691","2024-09"
"114810","한솔아이원스","198962805600","7200","27633723","29113174","1479451","2024-09"
"070590","한솔인티큐브","15465922832","1132","13662476","13879521","217045","2024-09"
"213500","한솔제지","223502559200","9400","23776868","23800576","23708","2024-09"
"014680","한솔케미칼","1452038479500","128100","11335195","11335195","0","2024-09"
"004710","한솔테크닉스","136194936195","4335","31417517","32109878","692361","2024-09"
"004150","한솔홀딩스","94566356795","2305","41026619","42008577","981958","2024-09"
"025750","한솔홈데코","56878995194","706","80565149","80565149","0","2024-09"
"226440","한송네오텍","100580954580","1530","65739186","65739186","0","2024-09"
"042520","한스바이오메드","115584113100","8900","12986979","13526367","539388","2024-09"
"004960","한신공영","78565066580","6790","11570702","11570702","0","2024-09"
"011700","한신기계","113858451520","3520","32346151","32446151","100000","2024-09"
"430690","한싹","52842224400","4850","10895304","10895327","23","2024-09"
"078350","한양디지텍","174045130110","11730","14837607","15244382","406775","2024-09"
"045100","한양이엔지","282709616880","16840","16787982","18000000","1212018","2024-09"
"001750","한양증권","158852104320","12480","12728534","12728534","0","2024-09"
"018880","한온시스템","2025271691850","3795","533668430","533800000","131570","2024-09"
"009420","한올바이오파마","2421415870000","47750","50710280","52240638","1530358","2024-09"
"320000","한울반도체","79841853665","2855","27965623","27965627","4","2024-09"
"091440","한울소재과학","71946188800","5120","14051990","14606671","554681","2024-09"
"014130","한익스프레스","40592000000","3440","11800000","12000000","200000","2024-09"
"024740","한일단조","107128339360","3430","31232752","31532546","299794","2024-09"
"005860","한일사료","162540200625","4125","39403685","39403685","0","2024-09"
"300720","한일시멘트","976587714000","14100","69261540","69261540","0","2024-09"
"002220","한일철강","48658772520","1998","24353740","26697460","2343720","2024-09"
"006390","한일현대시멘트","267688257200","13850","19327672","19327672","0","2024-09"
"003300","한일홀딩스","410983148520","13330","30831444","30832884","1440","2024-09"
"007770","한일화학","42541200000","12120","3510000","3510000","0","2024-09"
"051600","한전KPS","2004750000000","44550","45000000","45000000","0","2024-09"
"052690","한전기술","2685871453000","70600","38043505","38220000","176495","2024-09"
"130660","한전산업","436514000000","13390","32600000","32600000","0","2024-09"
"198940","한주라이트메탈","39191380636","1007","38918948","38922978","4030","2024-09"
"058450","한주에이알티","35448073970","2455","14439134","14452469","13335","2024-09"
"107640","한중엔시에스","355720603500","39750","8948946","8948946","0","2024-09"
"002320","한진","280992388340","19420","14469227","14947628","478401","2024-09"
"003480","한진중공업홀딩스","89226103680","3420","26089504","29529812","3440308","2024-09"
"180640","한진칼","5955737062200","89800","66322239","66762279","440040","2024-09"
"005110","한창","22551214950","1254","17983425","18606407","622982","2024-09"
"079170","한창산업","40376505070","7810","5169847","5200000","30153","2024-09"
"009460","한창제지","43974937182","737","59667486","59667486","0","2024-09"
"372910","한컴라이프케어","113465064600","4100","27674406","27674406","0","2024-09"
"054920","한컴위드","62942890890","2530","24878613","28217081","3338468","2024-09"
"457370","한켐","163352075150","20350","8027129","8027134","5","2024-09"
"002680","한탑","21370574511","689","31016799","32316799","1300000","2024-09"
"000880","한화","1911309681600","27550","69376032","74958735","5582703","2024-09"
"452260","한화갤러리아","254041947219","1311","193777229","193859610","82381","2024-09"
"088350","한화생명","2186545627500","2910","751390250","868530000","117139750","2024-09"
"000370","한화손해보험","566540087400","4900","115620426","116738915","1118489","2024-09"
"009830","한화솔루션","3480107133450","20550","169348279","171892536","2544257","2024-09"
"272210","한화시스템","3507993576360","18760","186993261","188919389","1926128","2024-09"
"012450","한화에어로스페이스","16959022404000","373000","45466548","45581161","114613","2024-09"
"082740","한화엔진","1276410685500","15300","83425535","83447142","21607","2024-09"
"042660","한화오션","9360434062850","30550","306397187","306413394","16207","2024-09"
"489790","한화인더스트리얼솔루션즈","2130970026600","42300","50377542","50488390","110848","2024-09"
"003530","한화투자증권","746407654120","3490","213870388","214547775","677387","2024-09"
"430460","한화플러스제3호스팩","12668800000","2140","5920000","5920000","0","2024-09"
"455310","한화플러스제4호스팩","10676600000","2110","5060000","5060000","0","2024-09"
"195870","해성디에스","483650000000","28450","17000000","17000000","0","2024-09"
"034810","해성산업","203290063200","6860","29634120","32556857","2922737","2024-09"
"059270","해성에어로보틱스","70187033700","6300","11140799","11140799","0","2024-09"
"076610","해성옵틱스","28624200262","1126","25421137","25453198","32061","2024-09"
"101530","해태제과식품","153272086360","5780","26517662","29116822","2599160","2024-09"
"220180","핸디소프트","61038160000","3145","19408000","19408000","0","2024-09"
"143210","핸즈코퍼레이션","41934218455","1951","21493705","21875747","382042","2024-09"
"214180","헥토이노베이션","154337922860","12470","12376738","13257185","880447","2024-09"
"234340","헥토파이낸셜","136532544220","16430","8309954","9453000","1143046","2024-09"
"084990","헬릭스미스","166919969000","3625","46046888","46092797","45909","2024-09"
"187660","현대ADM","82707952390","3910","21152929","21836250","683321","2024-09"
"000720","현대건설","3173639302500","28500","111355765","111355765","0","2024-09"
"170030","현대공업","80537235510","5370","14997623","15340000","342377","2024-09"
"453340","현대그린푸드","393005291850","11610","33850585","33880914","30329","2024-09"
"086280","현대글로비스","9172500000000","122300","75000000","75000000","0","2024-09"
"064350","현대로템","6963278293400","63800","109142293","109142293","0","2024-09"
"079430","현대리바트","161315900040","8020","20114202","20535282","421080","2024-09"
"012330","현대모비스","22187130499500","246500","90008643","92995094","2986451","2024-09"
"319400","현대무벡스","372528680220","3195","116597396","117741058","1143662","2024-09"
"048410","현대바이오","687282015520","17260","39819352","39821608","2256","2024-09"
"052260","현대바이오랜드","164100000000","5470","30000000","30000000","0","2024-09"
"069960","현대백화점","1006431315300","46050","21855186","23402441","1547255","2024-09"
"004560","현대비앤지스틸","191500899700","12700","15078811","15078811","0","2024-09"
"016790","현대사료","187340898626","994","188471729","188471729","0","2024-09"
"004310","현대약품","105849576900","4050","26135698","32000000","5864302","2024-08"
"041440","현대에버다임","141663193280","7940","17841712","17915944","74232","2024-09"
"039010","현대에이치티","45526340000","5860","7769000","8625000","856000","2024-09"
"017800","현대엘리베이","1606675259000","44500","36105062","39092385","2987323","2024-09"
"307950","현대오토에버","3855690109600","140600","27423116","27423982","866","2024-09"
"011210","현대위아","1276332047700","47900","26645763","27195083","549320","2024-09"
"090850","현대이지웰","119206732220","5020","23746361","23746361","0","2024-09"
"004020","현대제철","3505693944350","26650","131545739","133445785","1900046","2024-09"
"005440","현대지에프홀딩스","689097010420","4420","155904301","155904301","0","2024-09"
"005380","현대차","49124447321000","241000","203835881","209416191","5580310","2024-09"
"001500","현대차증권","283510304280","8940","31712562","31712562","0","2024-09"
"011760","현대코퍼레이션","219320239160","18260","12010966","13228966","1218000","2024-09"
"227840","현대코퍼레이션홀딩스","92627860500","10500","8821701","9100836","279135","2024-09"
"126560","현대퓨처넷","427395017400","3880","110153355","110202945","49590","2024-09"
"001450","현대해상","2399483700000","30600","78414500","89400000","10985500","2024-09"
"057050","현대홈쇼핑","539189025000","47100","11447750","12000000","552250","2024-09"
"460930","현대힘스","358638790650","10150","35333871","35333871","0","2024-09"
"092300","현우산업","52697056320","2880","18297589","18672816","375227","2024-09"
"138360","협진","40054748234","829","48316946","48348248","31302","2024-09"
"011080","형지I&C","15195733412","596","25496197","25503364","7167","2024-09"
"093240","형지엘리트","45541582985","1345","33859913","34164255","304342","2024-09"
"003010","혜인","52881749160","4920","10748323","12712747","1964424","2024-09"
"111110","호전실업","75041222800","8150","9207512","9749984","542472","2024-09"
"008770","호텔신라","1640399948200","44200","37113121","39248121","2135000","2024-09"
"060560","홈센타홀딩스","99520966272","784","126940008","127669525","729517","2024-09"
"064240","홈캐스트","93117618950","2710","34360745","35038012","677267","2024-09"
"039610","화성밸브","104208104000","10010","10410400","10410400","0","2024-09"
"378850","화승알앤에이","73114526100","3850","18990786","18993623","2837","2024-09"
"241590","화승엔터프라이즈","525309022920","8670","60589276","60589276","0","2024-09"
"006060","화승인더","200593725365","4055","49468243","55320000","5851757","2024-09"
"013520","화승코퍼레이션","83215423508","1874","44405242","50051252","5646010","2024-09"
"010690","화신","338449815340","9740","34748441","34920410","171969","2024-09"
"126640","화신정공","47325478500","1350","35055910","36373887","1317977","2024-09"
"133820","화인베스틸","26479635362","859","30826118","30826118","0","2024-09"
"127980","화인써키트","79680736820","6730","11839634","11840684","1050","2024-09"
"061250","화일약품","104650863408","1404","74537652","76877652","2340000","2024-09"
"010660","화천기계","61050000000","2775","22000000","22000000","0","2024-09"
"000850","화천기공","60170000000","27350","2200000","2200000","0","2024-09"
"016580","환인제약","204578738000","13400","15267070","18600070","3333000","2024-09"
"032560","황금에스티","89021217680","5240","16988782","17000000","11218","2024-09"
"004800","효성","837588032400","50100","16718324","16740407","22083","2024-09"
"094280","효성ITX","136765342350","12390","11038365","11558200","519835","2024-09"
"097870","효성오앤비","49470300000","6270","7890000","8490000","600000","2024-09"
"298040","효성중공업","3654858342500","392500","9311741","9324548","12807","2024-09"
"298020","효성티앤씨","1299022690000","301000","4315690","4327682","11992","2024-09"
"298000","효성화학","151368174000","40050","3779480","3791811","12331","2024-09"
"093370","후성","649966730160","6060","107255236","107255330","94","2024-09"
"081660","휠라홀딩스","2380876080000","40000","59521902","60095839","573937","2024-09"
"290270","휴네시온","33571586780","3620","9273919","9607672","333753","2024-09"
"005870","휴니드","110483735600","8440","13090490","14116015","1025525","2024-09"
"353190","휴럼","30950722074","786","39377509","39378420","911","2024-09"
"192410","휴림네트웍스","36191376100","2545","14220580","14235530","14950","2024-09"
"090710","휴림로봇","124150070264","1133","109576408","109623165","46757","2024-09"
"078590","휴림에이텍","30447300114","567","53698942","54210339","511397","2024-09"
"205470","휴마시스","175501605840","1551","113153840","129375009","16221169","2024-09"
"115160","휴맥스","73220176254","1698","43121423","43970124","848701","2024-09"
"028080","휴맥스홀딩스","32754174000","3000","10918058","12577506","1659448","2024-09"
"175140","휴먼테크놀로지","105102201420","4885","21515292","21515292","0","2024-09"
"200670","휴메딕스","318023981150","30850","10308719","11229930","921211","2024-09"
"079980","휴비스","87870554400","2670","32910320","34500000","1589680","2024-09"
"065510","휴비츠","98553728700","9060","10877895","12159371","1281476","2024-09"
"215090","휴센텍","149904424845","1505","99604269","99649272","45003","2024-09"
"005010","휴스틸","228404524875","4065","56188075","56188075","0","2024-09"
"263920","휴엠앤씨","49633675608","1012","49045134","49045134","0","2024-09"
"243070","휴온스","333061796400","28200","11810702","11979665","168963","2024-09"
"084110","휴온스글로벌","447660702400","36800","12164693","12621492","456799","2024-09"
"145020","휴젤","2969789940000","270000","10999222","12604033","1604811","2024-09"
"024060","흥구석유","255482154690","17570","14540817","15000000","459183","2024-09"
"010240","흥국","54799945200","4950","11070696","12322696","1252000","2024-09"
"189980","흥국에프엔비","70924721751","1833","38693247","40137827","1444580","2024-09"
"000540","흥국화재","216818926875","3375","64242645","64242645","0","2024-09"
"003280","흥아해운","475484122318","1979","240264842","240424899","160057","2024-09"
"037440","희림","58767140600","4655","12624520","13922475","1297955","2024-09"
"238490","힘스","48728736600","4390","11099940","11312236","212296","2024-09"