종목코드,종목명,자기주식 제외 시가총액(A*B),종가,자기주식 제외 발행주식수(B=C-D),총발행주식수(C),자기주식수(D),자기주식수 반영시점
"060310","3S","108299441040","2120","51084642","51084642","0","2024-09"
"095570","AJ네트웍스","219727655500","4910","44751050","45252759","501709","2024-09"
"006840","AK홀딩스","161503228100","12380","13045495","13247561","202066","2024-09"
"054620","APS","115375969400","6350","18169444","19894221","1724777","2024-09"
"265520","AP시스템","266457177160","17740","15020134","15281421","261287","2024-09"
"211270","AP위성","151583164650","10650","14233161","15082304","849143","2024-09"
"109960","AP헬스케어","62764855450","550","114117919","114153169","35250","2024-09"
"139050","BF랩스","24234697905","2805","8639821","8644551","4730","2024-09"
"027410","BGF","344073013770","3595","95708766","95716791","8025","2024-09"
"282330","BGF리테일","1971079211500","114100","17275015","17283906","8891","2024-09"
"126600","BGF에코머티리얼즈","208374933000","3365","61924200","62766899","842699","2024-09"
"138930","BNK금융지주","3008724254550","9450","318383519","320436727","2053208","2024-09"
"001460","BYC","200714700500","32150","6243070","6246150","3080","2024-09"
"013720","CBI","48449355288","1087","44571624","44628136","56512","2024-09"
"083790","CG인바이츠","195695693190","2545","76894182","76894182","0","2024-09"
"001040","CJ","2776197483000","102600","27058455","29176998","2118543","2024-09"
"079160","CJ CGV","923936416740","5580","165580003","165580003","0","2024-09"
"035760","CJ ENM","1285236378000","62000","20729619","21929154","1199535","2024-09"
"311690","CJ 바이오사이언스","99599646860","10930","9112502","9112502","0","2024-09"
"000120","CJ대한통운","1741209761700","87300","19945129","22812344","2867215","2024-09"
"011150","CJ씨푸드","114439512005","3185","35930773","35930773","0","2024-09"
"097950","CJ제일제당","3997551088000","272000","14696879","15054186","357307","2024-09"
"051500","CJ프레시웨이","211314230800","17800","11871586","11871586","0","2024-09"
"058820","CMG제약","290284789960","2090","138892244","138892244","0","2024-09"
"023460","CNH","5273350240","160","32958439","37200000","4241561","2024-09"
"056730","CNT85","54378451138","781","69626698","74111186","4484488","2024-09"
"000480","CR홀딩스","235162346400","5700","41256552","46890490","5633938","2024-09"
"065770","CS","20071108420","1034","19411130","19411130","0","2024-09"
"083660","CSA 코스믹","48578845080","820","59242494","61247181","2004687","2024-09"
"000590","CS홀딩스","72156130200","69300","1041214","1154482","113268","2024-09"
"012030","DB","312525951988","1636","191030533","201173933","10143400","2024-09"
"456440","DB금융스팩11호","12091625000","2275","5315000","5315000","0","2024-09"
"477760","DB금융스팩12호","12351600000","2115","5840000","5840000","0","2024-09"
"016610","DB금융투자","218314885040","5360","40730389","42446389","1716000","2024-09"
"005830","DB손해보험","6664825059000","111000","60043469","70800000","10756531","2024-09"
"000990","DB하이텍","1549298982750","37250","41591919","44398588","2806669","2024-09"
"139130","DGB금융지주","1354437652480","8140","166392832","169145833","2753001","2024-09"
"099520","DGI","58000622016","1284","45171824","45281824","110000","2024-09"
"060900","DGP","29874994604","1183","25253588","25258229","4641","2024-09"
"290120","DH오토리드","40029056040","2580","15515138","15515138","0","2024-09"
"025440","DH오토웨어","36167937025","235","153906115","153906120","5","2024-09"
"001530","DI동일","744807990550","38450","19370819","25215672","5844853","2024-09"
"000210","DL","828856789200","39600","20930727","20955884","25157","2024-09"
"375500","DL이앤씨","1178828669200","30650","38460968","38693623","232655","2024-09"
"068790","DMS","129411128000","5500","23529296","24573061","1043765","2024-09"
"007340","DN오토모티브","908256837150","18070","50263245","59065865","8802620","2024-09"
"004840","DRB동일","88652874400","4600","19272364","19930000","657636","2024-09"
"241520","DSC인베스트먼트","74654824000","2855","26148800","27496125","1347325","2024-09"
"155660","DSR","60480000000","3780","16000000","16000000","0","2024-09"
"069730","DSR제강","50544000000","3510","14400000","14400000","0","2024-09"
"017860","DS단석","458947933200","78300","5861404","5861404","0","2024-09"
"180400","DXVX","126738142200","2575","49218696","49219432","736","2024-09"
"017940","E1","430740449500","74500","5781751","6860000","1078249","2024-09"
"245620","EDGC","57441040175","415","138412145","138493951","81806","2024-09"
"037370","EG","60374804000","7000","8624972","8624972","0","2024-09"
"050120","ES큐브","23747751711","1773","13394107","13564086","169979","2024-09"
"383220","F&F","2223839108400","58800","37820393","38307075","486682","2024-09"
"007700","F&F홀딩스","521973770480","13360","39069893","39114367","44474","2024-09"
"214270","FSN","77300470050","2325","33247514","33250463","2949","2024-09"
"130500","GH신소재","44362350650","3050","14545033","14545052","19","2024-09"
"114090","GKL","692164947300","11190","61855670","61855670","0","2024-09"
"078930","GS","3864452592000","41600","92895495","92915378","19883","2024-09"
"083450","GST","283851717800","15260","18601030","18618260","17230","2024-09"
"006360","GS건설","1516964553650","17870","84888895","85581490","692595","2024-09"
"001250","GS글로벌","266459502460","3230","82495202","82533764","38562","2024-09"
"007070","GS리테일","2151515724800","20800","103438256","104717922","1279666","2024-09"
"297890","HB솔루션","273547018360","3740","73140914","73140914","0","2024-09"
"440290","HB인베스트먼트","50825643750","1875","27107010","27107010","0","2024-09"
"078150","HB테크놀러지","203921348310","2295","88854618","92715916","3861298","2024-09"
"012630","HDC","553843015020","11070","50030986","59741721","9710735","2024-09"
"039570","HDC랩스","184254311060","8020","22974353","25957601","2983248","2024-09"
"089470","HDC현대EP","101087465700","3900","25919863","31900000","5980137","2024-09"
"294870","HDC현대산업개발","1312262798500","20450","64169330","65907330","1738000","2024-09"
"009540","HD한국조선해양","13209492884000","186800","70714630","70773116","58486","2024-09"
"267250","HD현대","5604006499000","79300","70668430","78993085","8324655","2024-09"
"267270","HD현대건설기계","911348312400","51600","17661789","18305586","643797","2024-09"
"443060","HD현대마린솔루션","6427470000000","144600","44450000","44450000","0","2024-09"
"071970","HD현대마린엔진","651292281600","19200","33921473","33921495","22","2024-09"
"010620","HD현대미포","4311492613800","108100","39884298","39942149","57851","2024-09"
"322000","HD현대에너지솔루션","252560000000","22550","11200000","11200000","0","2024-09"
"042670","HD현대인프라코어","1284582183440","6670","192591032","192655867","64835","2024-09"
"267260","HD현대일렉트릭","12345497472000","343000","35992704","36047135","54431","2024-09"
"329180","HD현대중공업","16636081938400","187400","88773116","88773116","0","2024-09"
"097230","HJ중공업","184855714800","2220","83268340","83274281","5941","2024-09"
"195940","HK이노엔","1340003844300","47300","28329891","28329891","0","2024-09"
"014790","HL D&I","90103470380","2380","37858601","37858601","0","2024-09"
"028300","HLB","8615333834100","65700","131131413","131387433","256020","2024-09"
"003580","HLB글로벌","189697505345","3995","47483731","47489591","5860","2024-09"
"278650","HLB바이오스텝","178073529030","2115","84195522","86730589","2535067","2024-09"
"067630","HLB생명과학","1039017914760","8760","118609351","118679271","69920","2024-09"
"024850","HLB이노베이션","325652701080","3570","91219244","91226268","7024","2024-09"
"047920","HLB제약","613410676770","19290","31799413","31799994","581","2024-09"
"115450","HLB테라퓨틱스","717429302630","8990","79803037","80139933","336896","2024-09"
"046210","HLB파나진","123093794495","2905","42373079","42373079","0","2024-09"
"204320","HL만도","1702195600000","36250","46957120","46957120","0","2024-09"
"060980","HL홀딩스","331016486850","34850","9498321","10169410","671089","2024-09"
"011200","HMM","12935912095920","17270","749039496","749039496","0","2024-09"
"403870","HPSP","2350412481950","29350","80082197","82934144","2851947","2024-09"
"036640","HRS","80867730900","5060","15981765","16354800","373035","2024-09"
"035000","HS애드","103566845160","6390","16207644","16567409","359765","2024-09"
"002460","HS화성","83952146230","8870","9464729","10150000","685271","2024-09"
"487570","HS효성","148063768650","39950","3706227","3725927","19700","2024-09"
"298050","HS효성첨단소재","1184025830000","265000","4468022","4479948","11926","2024-09"
"439730","IBKS제20호스팩","9482000000","2200","4310000","4310000","0","2024-09"
"442770","IBKS제21호스팩","9240950000","2195","4210000","4210000","0","2024-09"
"448760","IBKS제22호스팩","9746000000","2200","4430000","4430000","0","2024-09"
"467930","IBKS제23호스팩","9242550000","2185","4230000","4230000","0","2024-09"
"469480","IBKS제24호스팩","9390600000","2220","4230000","4230000","0","2024-09"
"003560","IHQ","63786625000","10760","5928125","6010174","82049","2024-09"
"095340","ISC","1313801126400","64200","20464192","21197058","732866","2024-09"
"175330","JB금융지주","3447962712840","17980","191766558","195083198","3316640","2024-09"
"234080","JW생명과학","168781638600","10900","15484554","15834554","350000","2024-09"
"067290","JW신약","70006332833","1381","50692493","50841502","149009","2024-09"
"001060","JW중외제약","605710585650","26350","22987119","23285930","298811","2024-09"
"096760","JW홀딩스","212609166800","2950","72070904","73924942","1854038","2024-09"
"035900","JYP Ent.","1638429767550","49450","33133059","35532492","2399433","2024-09"
"318000","KBG","49586357700","5700","8699361","8740223","40862","2024-09"
"024840","KBI메탈","93540247485","2685","34838081","34909199","71118","2024-09"
"105560","KB금융","35420553291000","93900","377215690","393528423","16312733","2024-09"
"024120","KB오토시스","42147500000","3665","11500000","11500000","0","2024-09"
"455250","KB제25호스팩","11365200000","2640","4305000","4305000","0","2024-09"
"458320","KB제26호스팩","12578925000","2285","5505000","5505000","0","2024-09"
"464680","KB제27호스팩","25680950000","1990","12905000","12905000","0","2024-09"
"476470","KB제28호스팩","11532975000","2095","5505000","5505000","0","2024-09"
"478390","KB제29호스팩","12719900000","2045","6220000","6220000","0","2024-09"
"486630","KB제30호스팩","10752750000","2025","5310000","5310000","0","2024-09"
"002380","KCC","1923115716500","261500","7354171","8886471","1532300","2024-09"
"021320","KCC건설","85067284540","4265","19945436","21400000","1454564","2024-09"
"344820","KCC글라스","614615487150","38550","15943333","15970512","27179","2024-09"
"036670","KCI","81777520000","7600","10760200","11270000","509800","2024-09"
"009070","KCTC","132033886250","4415","29905750","30000000","94250","2024-09"
"009440","KC그린홀딩스","18761983040","848","22124980","22434980","310000","2024-09"
"119650","KC코트렐","27804804457","433","64214329","64214329","0","2024-09"
"044180","KD","12554259770","470","26711191","26717799","6608","2024-09"
"092220","KEC","178679195490","890","200763141","200763141","0","2024-09"
"046440","KG모빌리언스","162511236360","4380","37103022","38825568","1722546","2024-09"
"003620","KG모빌리티","867124781410","4415","196404254","196404254","0","2024-09"
"016380","KG스틸","669802573440","6720","99673002","100008897","335895","2024-09"
"151860","KG에코솔루션","216937015460","5170","41960738","49603002","7642264","2024-09"
"035600","KG이니시스","244091534960","9170","26618488","27904434","1285946","2024-09"
"001390","KG케미칼","268740982000","3925","68469040","68469040","0","2024-09"
"226360","KH 건설","60474013950","2555","23668890","23756732","87842","2024-09"
"111870","KH 미래물산","43747975260","8910","4909986","4930249","20263","2024-09"
"033180","KH 필룩스","125157155370","6630","18877399","18903579","26180","2024-09"
"060720","KH바텍","200540722200","9100","22037442","23677442","1640000","2024-09"
"015590","KIB플러그에너지","95503561023","403","236981541","236981544","3","2024-09"
"001940","KISCO홀딩스","259535361900","20550","12629458","16176380","3546922","2024-09"
"058400","KNN","108989659560","823","132429720","132429720","0","2024-09"
"025000","KPX케미칼","224684192250","47250","4755221","4840000","84779","2024-09"
"092230","KPX홀딩스","219754583100","55900","3931209","4224646","293437","2024-09"
"000040","KR모터스","31323176460","521","60121260","60132868","11608","2024-09"
"044450","KSS해운","210874083500","9340","22577525","23085880","508355","2024-09"
"101000","KS인더스트리","65990481600","2190","30132640","30149619","16979","2024-09"
"030200","KT","10902373121250","44350","245825775","252021685","6195910","2024-09"
"033780","KT&G","12068764730000","110000","109716043","130322497","20606454","2024-09"
"058850","KTcs","108884152230","2870","37938729","42685000","4746271","2024-09"
"058860","KTis","81295521210","2655","30619782","34802000","4182218","2024-09"
"122450","KX","146146337920","3520","41518846","45335964","3817118","2024-09"
"052900","KX하이텍","51301415680","944","54344720","55107517","762797","2024-09"
"376190","LB루셈","111930000000","4550","24600000","24600000","0","2024-09"
"061970","LB세미콘","192214358880","4390","43784592","43784592","0","2024-09"
"309960","LB인베스트먼트","90372090990","3930","22995443","23217239","221796","2024-09"
"093050","LF","416377827840","15040","27684696","29240000","1555304","2024-09"
"003550","LG","11792976312000","78000","151192004","157300993","6108989","2024-09"
"034220","LG디스플레이","5345000000000","10690","500000000","500000000","0","2024-09"
"051900","LG생활건강","4830399157500","329500","14659785","15618197","958412","2024-09"
"373220","LG에너지솔루션","96291000000000","411500","234000000","234000000","0","2024-09"
"032640","LG유플러스","4289686952960","9980","429828352","436611361","6783009","2024-09"
"011070","LG이노텍","4164953232000","176000","23664507","23667107","2600","2024-09"
"066570","LG전자","14903944377000","91500","162884638","163647814","763176","2024-09"
"037560","LG헬로비전","204072489275","2635","77446865","77446865","0","2024-09"
"051910","LG화학","22624845931500","320500","70592343","70592343","0","2024-09"
"079550","LIG넥스원","5470384360000","251000","21794360","22000000","205640","2024-09"
"225190","LK삼양","129408522000","2550","50748440","50748440","0","2024-09"
"006260","LS","2907043289400","106300","27347538","32200000","4852462","2024-09"
"010120","LS ELECTRIC","4442325890800","149800","29655046","30000000","344954","2024-09"
"000680","LS네트웍스","252957674940","3210","78803014","78803016","2","2024-09"
"060370","LS마린솔루션","408498326580","14930","27360906","28706781","1345875","2024-09"
"417200","LS머트리얼즈","1027643890210","15190","67652659","67652659","0","2024-09"
"229640","LS에코에너지","835524718800","27550","30327576","30624879","297303","2024-09"
"078020","LS증권","222793158640","4420","50405692","55481190","5075498","2024-09"
"108320","LX세미콘","992122300000","61000","16264300","16264300","0","2024-09"
"001120","LX인터내셔널","1066448294300","29650","35967902","38760000","2792098","2024-09"
"108670","LX하우시스","355754351250","39750","8949795","8967670","17875","2024-09"
"383800","LX홀딩스","543555043770","7130","76234929","76280690","45761","2024-09"
"476080","M83","100192950000","12870","7785000","7785000","0","2024-09"
"086960","MDS테크","97741342764","1053","92821788","92821788","0","2024-09"
"023150","MH에탄올","36757428570","5730","6414909","7378526","963617","2024-09"
"038340","MIT","39924432729","1233","32379913","32424892","44979","2024-09"
"035420","NAVER","26377118233600","174400","151244944","160784508","9539564","2024-09"
"160550","NEW","66137471220","2370","27906106","27906106","0","2024-09"
"053290","NE능률","58916284455","3565","16526307","16526307","0","2024-09"
"181710","NHN","547101813600","16620","32918280","33766123","847843","2024-09"
"060250","NHN KCP","279170808740","7220","38666317","40160611","1494294","2024-09"
"104200","NHN벅스","46983994650","3475","13520574","14827550","1306976","2024-09"
"005940","NH투자증권","4532835670360","13870","326808628","327492299","683671","2024-09"
"034310","NICE","395052985030","11290","34991407","37503477","2512070","2024-09"
"030190","NICE평가정보","647433798700","11050","58591294","60107670","1516376","2024-09"
"008260","NI스틸","105963433485","3705","28600117","28600117","0","2024-09"
"004250","NPC","168180530400","4960","33907365","36720000","2812635","2024-09"
"222160","NPX","79551289560","8040","9894439","9894439","0","2024-09"
"456040","OCI","646370139000","72200","8952495","8952495","0","2024-09"
"010060","OCI홀딩스","1288835077500","67500","19093853","19563983","470130","2024-09"
"178920","PI첨단소재","582040502040","19820","29366322","29366322","0","2024-09"
"024940","PN풍년","63629063600","6770","9398680","10000000","601320","2024-09"
"005490","POSCO홀딩스","25711064860000","340000","75620779","82624377","7003598","2024-09"
"218410","RFHIC","310008458150","12050","25726843","26484442","757599","2024-09"
"327260","RF머트리얼즈","51754568750","6250","8280731","8433231","152500","2024-09"
"091340","S&K폴리텍","28004775045","2615","10709283","11703721","994438","2024-09"
"010950","S-Oil","6518543656800","57900","112582792","112582792","0","2024-09"
"419530","SAMG엔터","101846567000","12820","7944350","8590930","646580","2024-09"
"019550","SBI인베스트먼트","111349400473","691","161142403","162066575","924172","2024-09"
"034120","SBS","281008169100","15150","18548394","18551238","2844","2024-09"
"036120","SCI평가정보","76573712250","2250","34032761","35500000","1467239","2024-09"
"246960","SCL사이언스","60962066370","8370","7283401","7283401","0","2024-09"
"099220","SDN","66631327530","1230","54171811","56171811","2000000","2024-09"
"036540","SFA반도체","589454171405","3595","163964999","164460303","495304","2024-09"
"255220","SG","251261510850","3010","83475585","94073791","10598206","2024-09"
"040610","SG&G","55984756674","1659","33746086","34087196","341110","2024-09"
"049470","SGA","18072302235","309","58486415","58862249","375834","2024-09"
"184230","SGA솔루션즈","31430073528","504","62361257","62599161","237904","2024-09"
"016250","SGC E&C","48974599480","15140","3234782","3243585","8803","2024-09"
"005090","SGC에너지","400521327600","27800","14407242","14409333","2091","2024-09"
"001380","SG글로벌","132194580420","2940","44964143","44964143","0","2024-09"
"004060","SG세계물산","69969587072","352","198777236","202424960","3647724","2024-09"
"001770","SHD","21916399120","18040","1214878","1214878","0","2024-09"
"002360","SH에너지화학","54990639780","505","108892356","111133730","2241374","2024-09"
"009160","SIMPAC","211108417240","3890","54269516","65429516","11160000","2024-09"
"033530","SJG세종","120247469055","4445","27052299","27820961","768662","2024-09"
"123700","SJM","51184065440","3280","15604898","15604898","0","2024-09"
"025530","SJM홀딩스","47906288185","3535","13551991","14934008","1382017","2024-09"
"034730","SK","8145340140600","149400","54520349","72502703","17982354","2024-09"
"011790","SKC","4929532522000","144700","34067260","37868298","3801038","2024-09"
"018670","SK가스","1768981566600","197100","8975046","9230244","255198","2024-09"
"001740","SK네트웍스","1008428668000","5200","193928590","221277902","27349312","2024-09"
"006120","SK디스커버리","587962637600","33200","17709718","18785855","1076137","2024-09"
"210980","SK디앤디","148476606180","7980","18606091","18617382","11291","2024-09"
"302440","SK바이오사이언스","4136737070400","52800","78347293","78347293","0","2024-09"
"326030","SK바이오팜","9366264700000","119600","78313250","78313250","0","2024-09"
"402340","SK스퀘어","11946290406400","89600","133329134","134749960","1420826","2024-09"
"361610","SK아이이테크놀로지","2324182444000","32600","71293940","71297592","3652","2024-09"
"100090","SK오션플랜트","783157364640","13230","59195568","59195568","0","2024-09"
"096770","SK이노베이션","11312064007200","118800","95219394","95735590","516196","2024-09"
"475150","SK이터닉스","516146873760","15330","33669072","33691895","22823","2024-09"
"001510","SK증권","209850444921","507","413906203","472590171","58683968","2024-09"
"285130","SK케미칼","849090251800","49300","17222926","17253783","30857","2024-09"
"017670","SK텔레콤","12113232859800","56900","212886342","214790053","1903711","2024-09"
"000660","SK하이닉스","134362552545000","195000","689038731","728002365","38963634","2024-09"
"048550","SM C&C","162290895957","1691","95973327","96714620","741293","2024-09"
"063440","SM Life Design","62553620286","1359","46029154","46029154","0","2024-09"
"003570","SNT다이내믹스","588958281300","26300","22393851","33252697","10858846","2024-09"
"064960","SNT모티브","545313485800","45550","11971756","14623136","2651380","2024-09"
"100840","SNT에너지","259463348040","13130","19761108","20680783","919675","2024-09"
"036530","SNT홀딩스","328957310500","22750","14459662","16303886","1844224","2024-09"
"067160","SOOP","959072400000","90000","10656360","11494767","838407","2024-09"
"005610","SPC삼립","399182232750","49250","8105223","8629009","523786","2024-09"
"011810","STX","151802245000","4900","30980050","31017927","37877","2024-09"
"465770","STX그린로지스","71517345900","10010","7144590","7171032","26442","2024-09"
"077970","STX엔진","442282442610","19230","22999607","23008904","9297","2024-09"
"002820","SUN&L","38180040660","3165","12063204","12607989","544785","2024-09"
"289080","SV인베스트먼트","84748528000","1592","53234000","53234000","0","2024-09"
"084870","TBH글로벌","29011835229","1391","20856819","20856819","0","2024-09"
"002710","TCC스틸","1183548419550","45150","26213697","26213697","0","2024-09"
"089230","THE E&M","27977154239","1279","21874241","21882953","8712","2024-09"
"032540","TJ미디어","72722998980","5220","13931609","13931609","0","2024-09"
"022220","TKG애강","52882265159","1021","51794579","51794579","0","2024-09"
"069260","TKG휴켐스","758208529520","19760","38370877","40878588","2507711","2024-09"
"007980","TP","66121212726","1359","48654314","51175130","2520816","2024-09"
"048770","TPC","38146118130","2430","15697991","15697991","0","2024-09"
"246690","TS인베스트먼트","41122690560","1008","40796320","41477862","681542","2024-09"
"317240","TS트릴리온","29786621715","279","106762085","107240922","478837","2024-09"
"002900","TYM","132644204430","3090","42926927","45050956","2124029","2024-09"
"024070","WISCOM","32032255420","2090","15326438","15326438","0","2024-09"
"057030","YBM넷","55916918885","3455","16184347","16312697","128350","2024-09"
"037270","YG PLUS","342518814000","5400","63429410","63429410","0","2024-09"
"040300","YTN","131880000000","3140","42000000","42000000","0","2024-09"
"051390","YW","30399408180","3765","8074212","11355368","3281156","2024-09"
"052220","iMBC","58535000000","2545","23000000","23000000","0","2024-09"
"079940","가비아","175776300240","13560","12962854","13535684","572830","2024-09"
"078890","가온그룹","56559402240","3520","16068012","17410157","1342145","2024-09"
"000500","가온전선","271601488800","38100","7128648","7357946","229298","2024-09"
"399720","가온칩스","432535248000","37650","11488320","11488320","0","2024-09"
"036620","감성코퍼레이션","325320437820","3585","90744892","90744892","0","2024-09"
"000860","강남제비스코","162175000000","24950","6500000","6500000","0","2024-09"
"198440","강동씨앤엘","88002727104","1446","60859424","60931896","72472","2024-09"
"217730","강스템바이오텍","116872900665","2085","56054149","56054149","0","2024-09"
"035250","강원랜드","3588480264600","17700","202738998","213940500","11201502","2024-09"
"114190","강원에너지","324970592720","12440","26123038","26123038","0","2024-09"
"094480","갤럭시아머니트리","341691888980","8710","39229838","39229838","0","2024-09"
"011420","갤럭시아에스엠","60609216800","2200","27549644","27549644","0","2024-09"
"039240","경남스틸","78780443680","2920","26979604","26979604","0","2024-09"
"053950","경남제약","21818579495","613","35593115","35593402","287","2024-09"
"002100","경농","165783952000","9280","17864650","19522575","1657925","2024-09"
"009450","경동나비엔","1222718047200","84600","14452932","14568592","115660","2024-09"
"267290","경동도시가스","110268793440","18720","5890427","5895406","4979","2024-09"
"012320","경동인베스트","167669068800","76900","2180352","2365023","184671","2024-09"
"011040","경동제약","169194315600","6280","26941770","30768766","3826996","2024-09"
"000050","경방","155969590200","6260","24915270","27415270","2500000","2024-09"
"214390","경보제약","177867038400","7440","23906860","23906860","0","2024-09"
"012610","경인양행","124511184420","3010","41365842","41616365","250523","2024-09"
"009140","경인전자","26962515900","20700","1302537","1570797","268260","2024-09"
"024910","경창산업","79529971800","2235","35583880","35819005","235125","2024-09"
"013580","계룡건설","117542966190","13270","8857797","8930907","73110","2024-09"
"012200","계양전기","40167980958","1477","27195654","27222829","27175","2024-09"
"002140","고려산업","70930332500","2875","24671420","24939425","268005","2024-09"
"049720","고려신용정보","134382194400","9650","13925616","14300000","374384","2024-09"
"010130","고려아연","22218202699000","1081000","20553379","20703283","149904","2024-09"
"002240","고려제강","481018287750","19250","24987963","25000000","12037","2024-09"
"014570","고려제약","53138233325","4925","10789489","11000000","210511","2024-09"
"348150","고바이오랩","132710872500","6850","19373850","19373850","0","2024-09"
"098460","고영","711225227080","10810","65793268","68654755","2861487","2024-09"
"035290","골드앤에스","21359063040","448","47676480","47676480","0","2024-09"
"215000","골프존","389730990000","64900","6005100","6275415","270315","2024-09"
"121440","골프존뉴딘홀딩스","155817273150","3825","40736542","42836818","2100276","2024-09"
"366030","공구우먼","97524824250","4305","22653850","22653850","0","2024-09"
"009290","광동제약","221244978240","5520","40080612","52420851","12340239","2024-09"
"014200","광림","87868591200","30200","2909556","3023556","114000","2024-09"
"017040","광명전기","56122211425","1295","43337615","43337615","0","2024-09"
"029480","광무","204768099950","3725","54971302","55009083","37781","2024-09"
"017900","광전자","92467868868","1836","50363763","57943763","7580000","2024-09"
"037710","광주신세계","225001574000","29500","7627172","7957190","330018","2024-09"
"026910","광진실업","14155945050","2210","6405405","6405405","0","2024-09"
"421800","교보12호스팩","16205800000","2710","5980000","5980000","0","2024-06"
"440790","교보13호스팩","8889750000","2195","4050000","4050000","0","2024-09"
"456490","교보14호스팩","9009000000","2145","4200000","4200000","0","2024-09"
"465320","교보15호스팩","8286750000","2175","3810000","3810000","0","2024-09"
"482520","교보16호스팩","12535500000","2055","6100000","6100000","0","2024-09"
"030610","교보증권","603851092050","5350","112869363","113962961","1093598","2024-09"
"339770","교촌에프앤비","262816320800","10520","24982540","24982540","0","2024-09"
"053270","구영테크","57905627520","2220","26083616","27410405","1326789","2024-09"
"007690","국도화학","271067355000","32500","8340534","9010616","670082","2024-09"
"005320","국동","29134614960","440","66215034","67327897","1112863","2024-09"
"001140","국보","33448047050","2110","15852155","15856388","4233","2024-09"
"066620","국보디자인","106017406560","16040","6609564","7500000","890436","2024-09"
"043650","국순당","82952255820","5270","15740466","17858304","2117838","2024-09"
"006050","국영지앤엠","73213724880","2160","33895243","34895243","1000000","2024-09"
"060480","국일신동","21814030000","1967","11090000","11090000","0","2024-09"
"078130","국일제지","901924696800","800","1127405871","1127405871","0","2024-09"
"307750","국전약품","203882326560","4155","49069152","49069269","117","2024-09"
"002720","국제약품","111790135980","5490","20362502","21159832","797330","2024-09"
"035080","그래디언트","173885840460","12710","13681026","14527584","846558","2024-09"
"453450","그리드위즈","146464310000","18440","7942750","7942750","0","2024-09"
"204020","그리티","56661289310","2830","20021657","20147430","125773","2024-09"
"402490","그린리소스","136305416560","16490","8265944","8265944","0","2024-09"
"114450","그린생명과학","39606500250","2075","19087470","20000000","912530","2024-09"
"083420","그린케미칼","134126363000","5750","23326324","24000000","673676","2024-09"
"186230","그린플러스","97091299520","9040","10740188","10820188","80000","2024-09"
"014530","극동유화","124408506900","3695","33669420","34869420","1200000","2024-09"
"204620","글로벌텍스프리","244461212000","4000","61115303","61116035","732","2024-09"
"019660","글로본","17047465540","490","34790746","34790746","0","2024-09"
"014280","금강공업","110981843210","4130","26872117","29329357","2457240","2024-09"
"053260","금강철강","74714922400","4700","15896792","18720000","2823208","2024-09"
"008870","금비","45917850000","56100","818500","1000000","181500","2024-09"
"001570","금양","2215646970750","38250","57925411","58050037","124626","2024-09"
"282720","금양그린파워","124651077000","10330","12066900","12119500","52600","2024-09"
"002990","금호건설","103558125140","2885","35895364","36953595","1058231","2024-09"
"011780","금호석유","3269611227200","142400","22960753","27334587","4373834","2024-09"
"214330","금호에이치티","131009438669","643","203747183","213914131","10166948","2024-09"
"001210","금호전기","35629314730","835","42669838","43535722","865884","2024-09"
"073240","금호타이어","1269690468540","4420","287260287","287260287","0","2024-09"
"036190","금화피에스시","161818646000","27400","5905790","6000000","94210","2024-09"
"049080","기가레인","57293998650","675","84879998","84883347","3349","2024-09"
"420770","기가비스","469003046000","37000","12675758","12675758","0","2024-09"
"035460","기산텔레콤","26049706580","1787","14577340","14577340","0","2024-09"
"092440","기신정기","75920000000","2600","29200000","29200000","0","2024-09"
"000270","기아","36871696930900","94100","391835249","399858417","8023168","2024-09"
"024110","기업은행","11530778036820","14460","797425867","797425869","2","2024-09"
"013700","까뮤이앤씨","78213836470","1309","59750830","59750830","0","2024-09"
"308100","까스텔바작","19478586260","3020","6449863","6624733","174870","2024-09"
"004540","깨끗한나라","77830026230","2090","37239247","37240693","1446","2024-09"
"407400","꿈비","73362567500","6220","11794625","12259474","464849","2024-09"
"187790","나노","31435070025","1025","30668361","30840830","172469","2024-09"
"286750","나노브릭","48940539010","2365","20693674","20694559","885","2024-09"
"121600","나노신소재","997845304800","83400","11964572","12196078","231506","2024-09"
"247660","나노씨엠에스","33016391460","7730","4271202","4343920","72718","2024-09"
"039860","나노엔텍","125550420620","3910","32110082","32110082","0","2024-09"
"091970","나노캠텍","21611517278","598","36139661","37417493","1277832","2024-09"
"417010","나노팀","182055547440","9230","19724328","19724328","0","2024-09"
"405920","나라셀라","46745797680","3760","12432393","12878076","445683","2024-09"
"051490","나라엠앤디","62800973025","4755","13207355","14200000","992645","2024-09"
"137080","나래나노텍","35943121500","3250","11059422","11059422","0","2024-09"
"190510","나무가","193932601560","12270","15805428","16264384","458956","2024-09"
"242040","나무기술","54245445796","1637","33137108","34606264","1469156","2024-09"
"089600","나스미디어","173097447390","15310","11306169","11568163","261994","2024-09"
"293580","나우IB","92361701250","975","94729950","94929950","200000","2024-09"
"138610","나이벡","197634034620","18180","10870959","10870959","0","2024-09"
"130580","나이스디앤비","78540000000","5100","15400000","15400000","0","2024-09"
"036800","나이스정보통신","164104474500","18710","8770950","10000000","1229050","2024-09"
"267320","나인테크","91578779150","2110","43402265","43664104","261839","2024-09"
"001260","남광토건","62085872480","6320","9823714","9832572","8858","2024-09"
"008350","남선알미늄","175289404220","1358","129079090","129079090","0","2024-09"
"004270","남성","40562620665","1295","31322487","36212160","4889673","2024-09"
"003920","남양유업","443553975000","675000","657117","679731","22614","2024-09"
"025860","남해화학","312625491400","6520","47948695","49678843","1730148","2024-09"
"111710","남화산업","111998720000","5440","20588000","20588000","0","2024-09"
"091590","남화토건","46666500000","3975","11740000","11740000","0","2024-09"
"168330","내츄럴엔도텍","47959904979","1519","31573341","31754900","181559","2024-09"
"094860","네오리진","28355282124","1326","21384074","21399569","15495","2024-09"
"253590","네오셈","484914297420","11410","42499062","43869164","1370102","2024-09"
"212560","네오오토","67248716780","8540","7874557","7874963","406","2024-09"
"095660","네오위즈","416098162700","20900","19909003","22033719","2124716","2024-09"
"042420","네오위즈홀딩스","137191967900","21100","6501989","8856866","2354877","2024-09"
"311390","네오크레마","78410311200","7200","10890321","10979147","88826","2024-09"
"085910","네오티스","47355549960","3540","13377274","13934818","557544","2024-09"
"092730","네오팜","104796415200","13400","7820628","8207361","386733","2024-09"
"290660","네오펙트","39011929038","926","42129513","42129513","0","2024-09"
"306620","네온테크","106305076800","2600","40886568","42608149","1721581","2024-09"
"153460","네이블","40142646720","6270","6402336","6530014","127678","2024-09"
"007390","네이처셀","1287143120000","20000","64357156","64357156","0","2024-09"
"033640","네패스","170546145000","7500","22739486","23059202","319716","2024-09"
"330860","네패스아크","151691360250","12450","12184045","12184045","0","2024-09"
"005720","넥센","223820566200","4620","48446010","53543977","5097967","2024-09"
"002350","넥센타이어","666412542180","6930","96163426","97667877","1504451","2024-09"
"089140","넥스턴바이오","56380715000","5000","11276143","11282627","6484","2024-09"
"389650","넥스트바이오메디컬","259986954900","32150","8086686","8086686","0","2024-09"
"137940","넥스트아이","32079386658","419","76561782","78320992","1759210","2024-09"
"396270","넥스트칩","236784224600","13090","18088940","18088940","0","2024-09"
"348210","넥스틴","658443076200","63700","10336626","10437250","100624","2024-09"
"092790","넥스틸","236618200000","9100","26002000","26002000","0","2024-09"
"225570","넥슨게임즈","969774087720","15160","63969267","65860174","1890907","2024-09"
"217270","넵튠","232412360180","5180","44867251","46676150","1808899","2024-09"
"251270","넷마블","4694850918300","57300","81934571","85953502","4018931","2024-09"
"104620","노랑풍선","70814303220","4470","15842126","15842126","0","2024-09"
"090350","노루페인트","167800000000","8390","20000000","20000000","0","2024-09"
"000320","노루홀딩스","135180260670","13190","10248693","13291151","3042458","2024-09"
"194700","노바렉스","172596606000","9750","17702216","18754848","1052632","2024-09"
"285490","노바텍","117435380790","11830","9926913","10575831","648918","2024-09"
"145170","노브랜드","106475751360","12840","8292504","9079834","787330","2024-09"
"106520","노블엠앤비","15902299386","411","38691726","38695952","4226","2024-09"
"376930","노을","113058003600","3060","36947060","36947060","0","2024-09"
"006280","녹십자","1820401891000","159500","11413178","11686538","273360","2024-09"
"142280","녹십자엠에스","90843485310","4185","21706926","21741926","35000","2024-09"
"234690","녹십자웰빙","186856597980","10530","17745166","17752276","7110","2024-09"
"005250","녹십자홀딩스","707264150600","15740","44934190","47028210","2094020","2024-09"
"004370","농심","2093309526000","362000","5782623","6082642","300019","2024-09"
"072710","농심홀딩스","313978383000","67700","4637790","4637790","0","2024-09"
"054050","농우바이오","116061261640","7240","16030561","16030561","0","2024-09"
"069140","누리플랜","17769385701","1359","13075339","13102743","27404","2024-09"
"040160","누리플렉스","29035821450","2570","11297985","12055535","757550","2024-09"
"332290","누보","38005726605","1155","32905391","33384803","479412","2024-09"
"348340","뉴로메카","210983400000","20000","10549170","10549170","0","2024-09"
"060260","뉴보텍","14076185580","1055","13342356","13512009","169653","2024-09"
"123840","뉴온","58482294075","225","259921307","292370108","32448801","2024-09"
"012340","뉴인텍","27538843813","541","50903593","50907162","3569","2024-09"
"270870","뉴트리","78704902500","8750","8994846","9200224","205378","2024-09"
"144960","뉴파워프라즈마","195449731890","4830","40465783","43692624","3226841","2024-09"
"085670","뉴프렉스","133743053480","5470","24450284","24450761","477","2024-09"
"064260","다날","213737584000","3200","66792995","68949040","2156045","2024-09"
"340360","다보링크","122137816780","2815","43388212","43388212","0","2024-09"
"039560","다산네트웍스","138099266760","3570","38683268","39505981","822713","2024-09"
"154040","다산솔루에타","31933217226","1779","17950094","17950094","0","2024-09"
"058730","다스코","63270715200","3480","18181240","18796941","615701","2024-09"
"030210","다올투자증권","166760349465","2815","59239911","60911106","1671195","2024-09"
"023590","다우기술","787071485760","18240","43150849","44866617","1715768","2024-09"
"032190","다우데이타","422449000000","11030","38300000","38300000","0","2024-09"
"323350","다원넥스뷰","49269743600","6490","7591640","7596111","4471","2024-09"
"068240","다원시스","419034538260","10980","38163437","38163437","0","2024-09"
"145210","다이나믹디자인","97635356100","2825","34561188","34581687","20499","2024-09"
"019680","대교","154644164010","2295","67383078","84702850","17319772","2024-09"
"006370","대구백화점","59665950870","7170","8321611","10821611","2500000","2024-09"
"008060","대덕","210118930000","6200","33890150","33890150","0","2024-09"
"353200","대덕전자","810931739250","16410","49416925","49416925","0","2024-09"
"000490","대동","192320485920","8160","23568687","25640788","2072101","2024-09"
"020400","대동금속","20091745800","6300","3189166","3189166","0","2024-09"
"008830","대동기어","68484902400","7620","8987520","8987520","0","2024-09"
"048470","대동스틸","34327253550","3650","9404727","10000000","595273","2024-09"
"008110","대동전자","105136322880","15040","6990447","10490447","3500000","2024-09"
"004780","대륙제관","64646503935","4065","15903199","15903199","0","2024-09"
"005750","대림B&Co","58186117600","3490","16672240","16672240","0","2024-09"
"017650","대림제지","58345000000","7000","8335000","9000000","665000","2024-09"
"006570","대림통상","39242949560","2605","15064472","15225000","160528","2024-09"
"007720","대명소노시즌","131846988600","1308","100800450","100800450","0","2024-09"
"389260","대명에너지","202554000000","11880","17050000","17050000","0","2024-09"
"317850","대모","85741526000","10300","8324420","8324420","0","2024-09"
"290670","대보마그네틱","121784993600","16300","7471472","7857660","386188","2024-09"
"078140","대봉엘에스","189622287080","17320","10948169","11086579","138410","2024-09"
"065150","대산F&B","18113400725","145","124920005","125282405","362400","2024-09"
"001680","대상","703354907500","20300","34648025","34648025","0","2024-09"
"084690","대상홀딩스","311427826800","8600","36212538","36212538","0","2024-09"
"036480","대성미생물","39292000000","10340","3800000","3800000","0","2024-09"
"128820","대성산업","128302602950","3425","37460614","45235478","7774864","2024-09"
"117580","대성에너지","250461768660","9210","27194546","27500000","305454","2024-09"
"027830","대성창투","80514000000","1491","54000000","54000000","0","2024-09"
"104040","대성파인텍","45007330074","966","46591439","47224987","633548","2024-09"
"129920","대성하이텍","55888840975","4075","13715053","13715053","0","2024-09"
"016710","대성홀딩스","125488849200","7800","16088314","16089459","1145","2024-09"
"438220","대신밸런스제13호스팩","14692200000","2605","5640000","5640000","0","2024-09"
"442310","대신밸런스제14호스팩","15030400000","2240","6710000","6710000","0","2024-09"
"457390","대신밸런스제15호스팩","16778475000","2385","7035000","7035000","0","2024-09"
"457630","대신밸런스제16호스팩","15899250000","2175","7310000","7310000","0","2024-09"
"471050","대신밸런스제17호스팩","12847200000","2120","6060000","6060000","0","2024-09"
"478780","대신밸런스제18호스팩","16294600000","2060","7910000","7910000","0","2024-09"
"020180","대신정보통신","33241011475","865","38428915","38428915","0","2024-09"
"003540","대신증권","641460623030","17090","37534267","50773400","13239133","2024-09"
"045390","대아티아이","189221017245","2685","70473377","70473377","0","2024-09"
"009190","대양금속","72173470392","1704","42355323","42359986","4663","2024-09"
"108380","대양전기공업","105840502400","11450","9243712","9567333","323621","2024-09"
"014160","대영포장","98974197627","1039","95259093","108394549","13135456","2024-09"
"047040","대우건설","1497678449400","3645","410885720","415622638","4736918","2024-09"
"003090","대웅","1014089608000","24800","40890710","58141980","17251270","2024-09"
"069620","대웅제약","1719036738000","149400","11506270","11586575","80305","2024-09"
"007680","대원","58828323750","4375","13446474","13446474","0","2024-09"
"000430","대원강업","243970000000","3935","62000000","62000000","0","2024-09"
"048910","대원미디어","97400376840","8060","12084414","12578946","494532","2024-09"
"005710","대원산업","118622592000","5920","20037600","20037600","0","2024-09"
"006340","대원전선","206942523000","2760","74979175","74979175","0","2024-09"
"003220","대원제약","309284524770","14430","21433439","22427583","994144","2024-09"
"024890","대원화성","42756812008","1049","40759592","41249152","489560","2024-09"
"290380","대유","56838037000","2300","24712190","24713612","1422","2024-09"
"002880","대유에이텍","50096866944","1072","46732152","46744020","11868","2024-09"
"000300","대유플러스","156936737152","1984","79101178","79101178","0","2024-09"
"120240","대정화금","99922550630","13930","7173191","7190391","17200","2024-09"
"003310","대주산업","50646452850","1431","35392350","35392350","0","2024-09"
"078600","대주전자재료","1594797030000","106500","14974620","15480593","505973","2024-09"
"012800","대창","95476477626","1251","76320126","91140499","14820373","2024-09"
"015230","대창단조","130356069800","5170","25213940","28572230","3358290","2024-09"
"096350","대창솔루션","53476173744","336","159155279","163761009","4605730","2024-09"
"140520","대창스틸","46859395920","2220","21107836","21109243","1407","2024-09"
"131220","대한과학","35436147735","4755","7452397","7454490","2093","2024-09"
"010170","대한광통신","74809210664","1004","74511166","74511166","0","2024-09"
"054670","대한뉴팜","108352431080","7720","14035289","14354920","319631","2024-09"
"001070","대한방직","21059796450","5830","3612315","5300000","1687685","2024-09"
"023910","대한약품","148470000000","25250","5880000","6000000","120000","2024-09"
"006650","대한유화","639843960000","103600","6176100","6500000","323900","2024-09"
"001440","대한전선","2223512415180","11970","185757094","186447300","690206","2024-09"
"084010","대한제강","232387073640","13320","17446477","23414397","5967920","2024-09"
"001790","대한제당","254791238400","2880","88469180","89696580","1227400","2024-09"
"001130","대한제분","217824082800","132400","1645197","1690000","44803","2024-09"
"003490","대한항공","8855705742650","24050","368220613","368220661","48","2024-09"
"005880","대한해운","566539991500","1775","319177460","319177460","0","2024-09"
"003830","대한화섬","131678725000","117500","1120670","1328000","207330","2024-09"
"016090","대현","90335912400","2040","44282310","44282310","0","2024-09"
"069460","대호에이엘","75975115960","1126","67473460","67544896","71436","2024-09"
"021040","대호특수강","28189441314","1539","18316726","21704774","3388048","2024-09"
"067080","대화제약","298308549500","17030","17516650","18616650","1100000","2024-09"
"298540","더네이쳐홀딩스","143551294210","9830","14603387","14765856","162469","2024-09"
"032860","더라미","66477287250","1650","40289265","40395863","106598","2024-09"
"192080","더블유게임즈","1032911519700","52100","19825557","21495906","1670349","2024-09"
"393890","더블유씨피","568460258660","16870","33696518","33696518","0","2024-09"
"299170","더블유에스아이","44381307144","1478","30027948","30027963","15","2024-09"
"012510","더존비즈온","1650899441700","58900","28028853","30382784","2353931","2024-09"
"224060","더코디","21740762205","4605","4721121","4748398","27277","2024-09"
"043090","더테크놀로지","27607130621","371","74412751","74412751","0","2024-09"
"213420","덕산네오룩스","669339433750","27250","24562915","24831179","268264","2024-09"
"317330","덕산테코피아","734085536400","35850","20476584","20476584","0","2024-09"
"077360","덕산하이메탈","207419914130","4565","45437002","45437002","0","2024-09"
"004830","덕성","91621958500","6620","13840175","15680000","1839825","2024-09"
"090410","덕신이피씨","67328775135","1461","46084035","46084095","60","2024-09"
"024900","덕양산업","108145979300","3335","32427580","32564980","137400","2024-09"
"263600","덕우전자","93510919700","5870","15930310","15930310","0","2024-09"
"194480","데브시스터즈","391934875200","36300","10797104","12035480","1238376","2024-09"
"263800","데이타솔루션","71365272000","4400","16219380","16219380","0","2024-09"
"206560","덱스터","189921254150","7550","25155133","25411736","256603","2024-09"
"261200","덴티스","108472557500","7100","15277825","15809700","531875","2024-09"
"145720","덴티움","676975443500","78500","8623891","11068830","2444939","2024-09"
"067990","도이치모터스","137117247960","4620","29679058","30181550","502492","2024-09"
"002150","도화엔지니어링","224413860500","6740","33295825","33720000","424175","2024-09"
"006620","동구바이오제약","147786549100","5450","27116798","28464992","1348194","2024-09"
"100130","동국S&C","138776970270","2490","55733723","57143000","1409277","2024-09"
"005160","동국산업","351396483020","6820","51524411","54244482","2720071","2024-09"
"460850","동국씨엠","191029862400","6400","29848416","29898656","50240","2024-09"
"075970","동국알앤에스","48208000000","2620","18400000","18400000","0","2024-09"
"460860","동국제강","427616862460","8630","49550042","49608017","57975","2024-09"
"086450","동국제약","764169401600","17380","43968320","44460000","491680","2024-09"
"001230","동국홀딩스","246013205130","7910","31101543","31800483","698940","2024-09"
"023450","동남합성","113854815000","32850","3465900","3500000","34100","2024-09"
"004140","동방","110406001860","2310","47794806","47971766","176960","2024-09"
"099410","동방선기","41001401700","2940","13946055","14000000","53945","2024-09"
"007590","동방아그로","77783682570","6270","12405691","13617577","1211886","2024-09"
"005960","동부건설","92112346810","4015","22942054","22946345","4291","2024-09"
"026960","동서","2723361634800","27600","98672523","99700000","1027477","2024-09"
"002210","동성제약","101753646600","4450","22865988","26100970","3234982","2024-09"
"102260","동성케미컬","209680785090","4305","48706338","49689728","983390","2024-09"
"033500","동성화인텍","311525474170","10730","29033129","29989494","956365","2024-09"
"025950","동신건설","176400000000","21000","8400000","8400000","0","2024-09"
"000640","동아쏘시오홀딩스","753837193800","120600","6250723","6348913","98190","2024-09"
"170900","동아에스티","666155579600","74200","8977838","9167274","189436","2024-09"
"088130","동아엘텍","82530682080","9440","8742657","8742657","0","2024-09"
"028100","동아지질","174225402000","13150","13249080","14052646","803566","2024-09"
"041930","동아화성","100961381600","6800","14847262","15800000","952738","2024-09"
"001520","동양","144061283817","759","189804063","238684063","48880000","2024-09"
"084670","동양고속","21785150000","8350","2609000","2895569","286569","2024-09"
"082640","동양생명","926314862220","5940","155945263","161358585","5413322","2024-09"
"060380","동양에스텍","27907800000","1446","19300000","19700000","400000","2024-09"
"079960","동양이엔피","144067123740","18660","7720639","7860000","139361","2024-09"
"008970","동양철관","116364846039","741","157037579","157052160","14581","2024-09"
"228340","동양파일","39900000000","1995","20000000","20000000","0","2024-09"
"092780","동양피스톤","68910288720","5460","12620932","13168460","547528","2024-09"
"088910","동우팜투테이블","51289197416","1994","25721764","25831764","110000","2024-09"
"094170","동운아나텍","421230807600","22350","18847016","19067208","220192","2024-09"
"049770","동원F&B","592375534000","30700","19295620","19295620","0","2024-09"
"013120","동원개발","231106614500","2545","90808100","90808100","0","2024-09"
"018500","동원금속","60067074425","1285","46744805","46754933","10128","2024-09"
"006040","동원산업","1213937861500","33700","36021895","36021895","0","2024-09"
"030720","동원수산","26247460200","5640","4653805","4653805","0","2024-09"
"014820","동원시스템즈","1442316279500","49750","28991282","28991282","0","2024-09"
"111380","동인기연","109989428970","18530","5935749","6128000","192251","2024-09"
"163560","동일고무벨트","108559000000","7810","13900000","13900000","0","2024-09"
"109860","동일금속","73510665250","8690","8459225","9100000","640775","2024-09"
"032960","동일기연","41798084720","11060","3779212","3986323","207111","2024-09"
"004890","동일산업","84801679650","39150","2166071","2425215","259144","2024-09"
"002690","동일제강","28137492880","1483","18973360","20300360","1327000","2024-09"
"023790","동일철강","25925941005","1245","20824049","20841335","17286","2024-09"
"005290","동진쎄미켐","1367625540400","26600","51414494","51414494","0","2024-09"
"025900","동화기업","504524090340","11030","45741078","50557285","4816207","2024-09"
"000020","동화약품","208161654300","7510","27717930","27931470","213540","2024-09"
"000150","두산","2738401222500","202500","13522969","16523835","3000866","2024-09"
"454910","두산로보틱스","4517952606000","69700","64819980","64819980","0","2024-09"
"241560","두산밥캣","3848545436050","38450","100092209","100249166","156957","2024-09"
"034020","두산에너빌리티","13705954595200","21400","640465168","640561146","95978","2024-09"
"131970","두산테스나","475391894100","28100","16917861","17006566","88705","2024-09"
"336260","두산퓨얼셀","1134814827070","17330","65482679","65493726","11047","2024-09"
"016740","두올","107160258720","3440","31151238","32066680","915442","2024-09"
"073190","듀오백","27879863760","2520","11063438","11968040","904602","2024-09"
"030350","드래곤플라이","17139076331","247","69388973","69388973","0","2024-09"
"203650","드림시큐리티","166722260580","3420","48749199","50605754","1856555","2024-09"
"223250","드림씨아이에스","95911275720","4030","23799324","23799324","0","2024-09"
"060570","드림어스컴퍼니","156536656110","2070","75621573","75621573","0","2024-09"
"362990","드림인사이트","34105943040","2080","16397088","16800574","403486","2024-09"
"192650","드림텍","564445438920","8360","67517397","68883113","1365716","2024-09"
"217620","디딤이앤에프","21715711458","381","56996618","57747210","750592","2024-09"
"016670","디모아","19642740760","3980","4935362","4941846","6484","2024-09"
"187870","디바이스이엔지","89937496680","13380","6721786","7036609","314823","2024-09"
"024090","디씨엠","102677822520","11830","8679444","11400000","2720556","2024-09"
"003160","디아이","494058443310","18990","26016769","28300000","2283231","2024-09"
"092200","디아이씨","140647526250","3630","38745875","38888569","142694","2024-09"
"110990","디아이티","255894580920","13880","18436209","18900000","463791","2024-09"
"263690","디알젬","73983051000","6750","10960452","11325610","365158","2024-09"
"214680","디알텍","230028190080","3120","73726984","73727108","124","2024-09"
"347850","디앤디파마텍","460190120850","43650","10542729","10542729","0","2024-09"
"263720","디앤씨미디어","222185378900","17900","12412591","12524473","111882","2024-09"
"376300","디어유","748946709300","31550","23738406","23738406","0","2024-09"
"109740","디에스케이","126016150000","5000","25203230","25710390","507160","2024-09"
"196490","디에이테크놀로지","36209568780","203","178372260","178549360","177100","2024-09"
"066900","디에이피","42945202920","2440","17600493","22744503","5144010","2024-09"
"127120","디엔에이링크","79930061865","3555","22483843","22483843","0","2024-09"
"092070","디엔에프","116760047220","10090","11571858","11571858","0","2024-09"
"039840","디오","239469441160","16570","14451988","14981755","529767","2024-09"
"013570","디와이","113848316465","4615","24669191","26319633","1650442","2024-09"
"219550","디와이디","54558049745","695","78500791","78500791","0","2024-09"
"310870","디와이씨","27057663396","1308","20686287","20687271","984","2024-09"
"210540","디와이파워","135520250280","12280","11035851","11041708","5857","2024-09"
"104460","디와이피엔에프","96176918900","9950","9666022","10713625","1047603","2024-09"
"079810","디이엔티","162146729780","7420","21852659","22028094","175435","2024-09"
"113810","디젠스","28777940982","882","32628051","32628051","0","2024-09"
"043360","디지아이","19842481025","2225","8917969","9000000","82031","2024-09"
"197140","디지캡","33371212620","2630","12688674","13013154","324480","2024-09"
"068930","디지털대성","193120532000","7370","26203600","27675342","1471742","2024-09"
"033130","디지틀조선","70519007300","1900","37115267","37115267","0","2024-09"
"105740","디케이락","73314978730","7210","10168513","10168513","0","2024-09"
"263020","디케이앤디","58775332450","3950","14879831","15069831","190000","2024-09"
"290550","디케이티","164410110600","8220","20001230","20001230","0","2024-09"
"066670","디티씨","50781845990","3235","15697634","18691918","2994284","2024-09"
"187220","디티앤씨","42584627435","3695","11524933","11698021","173088","2024-09"
"383930","디티앤씨알오","95268019520","7460","12770512","12770512","0","2024-09"
"131180","딜리","29315138355","1055","27786861","29350000","1563139","2024-09"
"315640","딥노이드","145514029320","6490","22421268","22421268","0","2024-09"
"223310","딥마인드","49435843820","2165","22834108","22839375","5267","2024-09"
"317120","라닉스","33960872250","3525","9634290","9660000","25710","2024-09"
"462510","라메디텍","90227166050","10430","8650735","8650735","0","2024-09"
"042510","라온시큐어","104441099280","1932","54058540","56025871","1967331","2024-09"
"232680","라온테크","89892685960","7370","12197108","12534234","337126","2024-09"
"418420","라온텍","93849387500","3125","30031804","30108433","76629","2024-09"
"300120","라온피플","100440957780","4815","20860012","20860012","0","2024-09"
"171120","라이온켐텍","95298390000","2700","35295700","35901760","606060","2024-09"
"388790","라이콤","88550618310","2970","29815023","29913930","98907","2024-09"
"347700","라이프시맨틱스","68381653615","3355","20382013","20382013","0","2024-09"
"214260","라파스","150164017800","17880","8398435","8912435","514000","2024-09"
"115390","락앤락","374233582080","8640","43314072","43326411","12339","2024-09"
"200350","래몽래인","145442163750","14550","9996025","9996025","0","2024-09"
"171010","램테크놀러지","52547913600","3675","14298752","14298752","0","2024-09"
"084650","랩지노믹스","265036764300","3570","74239990","74239990","0","2024-09"
"217500","러셀","49226362178","1697","29007874","31812000","2804126","2024-09"
"038390","레드캡투어","132010889690","15790","8360411","8589480","229069","2024-09"
"294140","레몬","101402386890","4830","20994283","21000000","5717","2024-09"
"443250","레뷰코퍼레이션","97520628000","9050","10775760","11279386","503626","2024-09"
"228670","레이","128300703120","8280","15495254","15495254","0","2024-09"
"228850","레이언스","109525622400","6960","15736440","16591014","854574","2024-09"
"412350","레이저쎌","42762162800","4900","8726972","8726972","0","2024-09"
"199550","레이저옵텍","71809632450","6150","11676363","11677947","1584","2024-09"
"281740","레이크머티리얼즈","941260903200","14320","65730510","65730548","38","2024-09"
"277810","레인보우로보틱스","2392002491400","123300","19399858","19399858","0","2024-09"
"215100","로보로보","68539429225","3385","20247985","20348454","100469","2024-09"
"090360","로보스타","207187500000","21250","9750000","9750000","0","2024-09"
"108490","로보티즈","231126156800","17920","12897665","13053665","156000","2024-09"
"067730","로지시스","25297306030","2615","9673922","9673922","0","2024-09"
"071280","로체시스템즈","284449435830","19070","14916069","15296603","380534","2024-09"
"032350","롯데관광개발","731483356800","9600","76196183","76196183","0","2024-09"
"089860","롯데렌탈","1038868201800","28600","36324063","36634063","310000","2024-09"
"000400","롯데손해보험","703225318250","2275","309110030","310336320","1226290","2024-09"
"023530","롯데쇼핑","1840418664000","65100","28270640","28288755","18115","2024-09"
"020150","롯데에너지머티리얼즈","1719934145500","37300","46110835","46110835","0","2024-09"
"280360","롯데웰푸드","1136102809500","128500","8841267","9434574","593307","2024-09"
"286940","롯데이노베이트","347975441000","23000","15129367","15129367","0","2024-09"
"004000","롯데정밀화학","1138509000000","44700","25470000","25800000","330000","2024-09"
"004990","롯데지주","1688706405000","23850","70805300","104909237","34103937","2024-09"
"005300","롯데칠성","1087485204800","117200","9278884","9278884","0","2024-09"
"011170","롯데케미칼","3917327956300","92900","42167147","42775419","608272","2024-09"
"071840","롯데하이마트","183234839040","7920","23135712","23607712","472000","2024-09"
"328130","루닛","1126052928000","39000","28873152","28873152","0","2024-09"
"038060","루멘스","59599702491","1239","48103069","48103069","0","2024-09"
"474170","루미르","137752208880","8030","17154696","17154696",,"자료 없음"
"141080","리가켐바이오","4697379534400","128800","36470338","36610338","140000","2024-09"
"058470","리노공업","2712508744000","178700","15179120","15242370","63250","2024-09"
"016100","리더스코스메틱","48314904145","2635","18335827","19100894","765067","2024-09"
"012700","리드코프","110825709160","4330","25594852","26446135","851283","2024-09"
"302550","리메드","109684326400","3580","30638080","30638080","0","2024-09"
"073570","리튬포어스","57461981676","1588","36185127","36189497","4370","2024-09"
"377450","리파인","205269390000","13500","15205140","17330000","2124860","2024-09"
"277070","린드먼아시아","49030771500","3870","12669450","13692000","1022550","2024-09"
"042500","링네트","73504790040","4565","16101816","19070134","2968318","2024-09"
"193250","링크드","26152554701","413","63323377","63323377","0","2024-09"
"219420","링크제니시스","49464657015","4395","11254757","11469507","214750","2024-09"
"439090","마녀공장","302015114400","18440","16378260","16378260","0","2024-09"
"027740","마니커","58675125432","924","63501218","63511228","10010","2024-09"
"195500","마니커에프앤지","47055210000","2945","15978000","15978000","0","2024-09"
"377480","마음AI","69068453220","11070","6239246","6239246","0","2024-09"
"305090","마이크로디지탈","205222804900","12410","16536890","16536890","0","2024-09"
"098120","마이크로컨텍솔","44473298100","5350","8312766","8312766","0","2024-09"
"424980","마이크로투나노","48712464700","8230","5918890","5918890","0","2024-09"
"038290","마크로젠","178126167450","17850","9979057","10841400","862343","2024-09"
"001080","만호제강","88537351400","29950","2956172","4150000","1193828","2024-09"
"267980","매일유업","275316799800","38150","7216692","7843638","626946","2024-09"
"005990","매일홀딩스","104955690000","8400","12494725","13718304","1223579","2024-09"
"093520","매커스","85973986320","8760","9814382","16163092","6348710","2024-09"
"377030","맥스트","47557243260","2430","19570882","19570882","0","2024-09"
"100590","머큐리","53268027395","3365","15830023","15830023","0","2024-09"
"067280","멀티캠퍼스","174543641550","29450","5926779","5926779","0","2024-09"
"072870","메가스터디","128100632460","11230","11407002","11920959","513957","2024-09"
"215200","메가스터디교육","453488773050","42150","10758927","11461955","703028","2024-09"
"133750","메가엠디","45253719250","2050","22074985","23407077","1332092","2024-09"
"446540","메가터치","84122550000","4050","20771000","20771000","0","2024-09"
"235980","메드팩토","178985104350","5330","33580695","33580695","0","2024-09"
"041920","메디아나","86767298750","4675","18559850","18598223","38373","2024-09"
"014100","메디앙스","24692057905","2185","11300713","11800000","499287","2024-09"
"054180","메디콕스","19368634012","329","58871228","58878283","7055","2024-09"
"086900","메디톡스","1144320320000","170000","6731296","7298497","567201","2024-09"
"078160","메디포스트","225392968850","6610","34098785","34217785","119000","2024-09"
"138040","메리츠금융지주","18963629652500","102500","185011021","190720114","5709093","2024-09"
"408920","메쎄이상","95760257550","2225","43038318","43232455","194137","2024-09"
"021880","메이슨캐피탈","46264060032","304","152184408","152184408","0","2024-09"
"140410","메지온","1024594995600","34200","29958918","29958918","0","2024-09"
"241770","메카로","74641397000","7580","9847150","10192640","345490","2024-09"
"090370","메타랩스","39120459159","1571","24901629","24904689","3060","2024-09"
"059210","메타바이오메드","94228964960","4120","22871108","23862351","991243","2024-09"
"118000","메타케어","56353121820","342","164775210","164777364","2154","2024-09"
"058110","멕아이씨에스","39596189150","2555","15497530","16050530","553000","2024-09"
"017180","명문제약","77052302955","2305","33428331","33953454","525123","2024-09"
"009900","명신산업","682111729000","13000","52470133","52470133","0","2024-09"
"012690","모나리자","134360848125","3675","36560775","36571255","10480","2024-09"
"005360","모나미","43841752240","2320","18897307","18897307","0","2024-09"
"070960","모나용평","183541394040","3880","47304483","48133333","828850","2024-09"
"434480","모니터랩","45998413000","3910","11764300","12253300","489000","2024-09"
"080420","모다이노칩","150913030446","1893","79721622","79721622","0","2024-09"
"417970","모델솔루션","60001046000","9380","6396700","6396700","0","2024-09"
"080160","모두투어","170526046650","9850","17312289","18900000","1587711","2024-09"
"087260","모바일어플라이언스","68198243795","2095","32552861","32552861","0","2024-09"
"101330","모베이스","73028876495","3155","23147029","23147029","0","2024-09"
"012860","모베이스전자","129007255600","1775","72680144","73233457","553313","2024-09"
"363260","모비데이즈","72971042000","2300","31726540","32163769","437229","2024-09"
"348030","모비릭스","52244672000","5440","9603800","9603800","0","2024-09"
"250060","모비스","102051817595","3185","32041387","32171314","129927","2024-09"
"288980","모아데이타","57847684788","1674","34556562","34556562","0","2024-09"
"142760","모아라이프플러스","51394812582","1362","37734811","37734811","0","2024-09"
"033200","모아텍","29040288995","3155","9204529","14331185","5126656","2024-09"
"333050","모코엠시스","28915160192","1258","22985024","24444326","1459302","2024-09"
"009680","모토닉","187295223840","8660","21627624","33000000","11372376","2024-09"
"118990","모트렉스","252909224400","10200","24795022","24861990","66968","2024-09"
"006920","모헨즈","27900600000","2555","10920000","10920000","0","2024-09"
"009580","무림P&P","171500389500","2750","62363778","62368324","4546","2024-09"
"001810","무림SP","38895587500","1757","22137500","22137500","0","2024-09"
"009200","무림페이퍼","86547364800","2080","41609310","41609310","0","2024-09"
"033920","무학","153358965720","5790","26486868","28500000","2013132","2024-09"
"008420","문배철강","43851450450","2290","19149105","20503505","1354400","2024-09"
"279600","미디어젠","52938025300","11300","4684781","4684781","0","2024-09"
"095500","미래나노텍","289965754260","10220","28372383","31009999","2637616","2024-09"
"254490","미래반도체","223067100000","15450","14438000","14438000","0","2024-09"
"025560","미래산업","31270247660","1004","31145665","31166865","21200","2024-09"
"218150","미래생명자원","86267892825","4425","19495569","20415802","920233","2024-09"
"007120","미래아이앤지","32159305178","1177","27323114","28878608","1555494","2024-09"
"442900","미래에셋드림스팩1호","76876800000","10010","7680000","7680000","0","2024-09"
"100790","미래에셋벤처투자","248604305040","4680","53120578","53124634","4056","2024-09"
"412930","미래에셋비전스팩1호","17848640000","2890","6176000","6176000","0","2024-09"
"446190","미래에셋비전스팩2호","11187000000","2260","4950000","4950000","0","2024-09"
"448830","미래에셋비전스팩3호","10528800000","2140","4920000","4920000","0","2024-09"
"477380","미래에셋비전스팩4호","16362000000","2020","8100000","8100000","0","2024-09"
"477470","미래에셋비전스팩5호","11316200000","2065","5480000","5480000","0","2024-09"
"478440","미래에셋비전스팩6호","14033250000","2025","6930000","6930000","0","2024-09"
"482680","미래에셋비전스팩7호","16306775000","1985","8215000","8215000","0","2024-09"
"085620","미래에셋생명","690239200000","5290","130480000","177016189","46536189","2024-09"
"006800","미래에셋증권","4145675922830","9230","449152321","595316408","146164087","2024-09"
"049950","미래컴퍼니","143868316350","18150","7926629","8817884","891255","2024-09"
"207760","미스터블루","114513363850","1390","82383715","83079783","696068","2024-09"
"002840","미원상사","918621771000","197800","4644195","4750000","105805","2024-09"
"268280","미원에스씨","693401478000","142000","4883109","5000000","116891","2024-09"
"107590","미원홀딩스","185236000000","80000","2315450","2320000","4550","2024-09"
"134380","미원화학","159202089000","79500","2002542","2199268","196726","2024-09"
"003650","미창석유","146607665100","96900","1512979","1739672","226693","2024-09"
"059090","미코","298897960530","9490","31496097","33416778","1920681","2024-09"
"214610","미코바이오메드","69477534885","1595","43559583","43568945","9362","2024-09"
"201490","미투온","66101836320","2160","30602702","31257770","655068","2024-09"
"452200","민테크","138474843000","6310","21945300","21945300","0","2024-09"
"418470","밀리의서재","120434925130","14170","8499289","8499289","0","2024-09"
"206640","바디텍메드","340634138000","15500","21976396","23486560","1510164","2024-09"
"018700","바른손","38765441568","1126","34427568","35119757","692189","2024-09"
"035620","바른손이앤에이","35648270880","480","74267231","74439675","172444","2024-09"
"053030","바이넥스","628991601000","19750","31847676","32684188","836512","2024-09"
"301300","바이브컴퍼니","51840041750","4190","12372325","12394861","22536","2024-09"
"377740","바이오노트","473462191300","4655","101710460","102056048","345588","2024-09"
"064550","바이오니아","598798751200","23200","25810291","25810291","0","2024-09"
"314930","바이오다인","596904390000","20250","29476760","29764103","287343","2024-09"
"208710","바이오로그디바이스","29193994152","443","65900664","65900664","0","2024-09"
"086820","바이오솔루션","136561978360","17020","8023618","8143426","119808","2024-09"
"038460","바이오스마트","90861978490","3595","25274542","26164438","889896","2024-09"
"251120","바이오에프디엔씨","142262869320","16680","8528949","8695700","166751","2024-09"
"199730","바이오인프라","38769004990","7970","4864367","4864367","0","2024-09"
"086040","바이오톡스텍","67363580865","4285","15720789","15958247","237458","2024-09"
"099430","바이오플러스","301778596720","5360","56301977","57930864","1628887","2024-09"
"032980","바이온","27710779190","619","44767010","44777990","10980","2024-09"
"308080","바이젠셀","57983857400","3010","19263740","19263740","0","2024-09"
"043150","바텍","340162462400","22900","14854256","14854256","0","2024-09"
"323990","박셀바이오","293257239650","12770","22964545","22993200","28655","2024-09"
"003610","방림","113261468800","3200","35394209","42314090","6919881","2024-09"
"267790","배럴","35301037500","4475","7888500","7888500","0","2024-09"
"001340","백광산업","448554927120","10160","44149107","44918407","769300","2024-09"
"046310","백금T&A","38275262340","2380","16082043","16418641","336598","2024-09"
"035150","백산","286810000000","13340","21500000","21500000","0","2024-09"
"331520","밸로프","33506930912","683","49058464","50864390","1805926","2024-09"
"199480","뱅크웨어글로벌","73842973780","7310","10101638","10101638","0","2024-09"
"438700","버넥트","39062839450","3505","11144890","11144890","0","2024-09"
"066410","버킷스튜디오","97025536877","1153","84150509","84151767","1258","2024-09"
"002410","범양건영","25127911424","1012","24829952","24831982","2030","2024-09"
"382900","범한퓨얼셀","118095200000","13760","8582500","8761000","178500","2024-09"
"206400","베노티앤알","126435777000","3900","32419430","32420452","1022","2024-09"
"019010","베뉴지","87837000000","2185","40200000","48200000","8000000","2024-09"
"177350","베셀","26047323012","292","89203161","89372043","168882","2024-09"
"424760","벨로크","20169339840","1040","19393596","19665002","271406","2024-09"
"007210","벽산","111795824345","1997","55981885","67560000","11578115","2024-09"
"225530","보광산업","140266806860","3860","36338551","36338727","176","2024-09"
"250000","보라티알","64378694980","9830","6549206","6750733","201527","2024-09"
"002760","보락","75893300000","1267","59900000","59900000","0","2024-09"
"003850","보령","727157438400","11040","65865710","68690000","2824290","2024-09"
"310210","보로노이","1843792715700","102700","17953191","18356592","403401","2024-09"
"006910","보성파워텍","155596840320","3180","48929824","49129824","200000","2024-09"
"000890","보해양조","58828975416","423","139075592","139120129","44537","2024-09"
"226340","본느","68214569880","1626","41952380","41952420","40","2024-09"
"003000","부광약품","334401067835","4885","68454671","68454671","0","2024-09"
"001270","부국증권","164810635500","27750","5939122","10369886","4430764","2024-09"
"026940","부국철강","49900000000","2495","20000000","20000000","0","2024-09"
"014470","부방","93701675826","1746","53666481","60052260","6385779","2024-09"
"011390","부산산업","62515200000","59200","1056000","1056000","0","2024-09"
"005030","부산주공","38288532168","486","78782988","78782988","0","2024-09"
"008470","부스타","32044380615","3965","8081811","8404800","322989","2024-09"
"338220","뷰노","405535936400","29200","13888217","13888217","0","2024-09"
"100120","뷰웍스","221284055100","24100","9181911","10001865","819954","2024-09"
"406820","뷰티스킨","49158496400","13910","3534040","3534040","0","2024-09"
"337930","브랜드엑스코퍼레이션","239475338990","8170","29311547","29311547","0","2024-09"
"099390","브레인즈컴퍼니","53901876820","6820","7903501","8208283","304782","2024-09"
"064480","브리지텍","60502169880","5220","11590454","11952500","362046","2024-09"
"288330","브릿지바이오테라퓨틱스","220925438905","4645","47561989","47561989","0","2024-09"
"365900","브이씨","24123990000","3300","7310300","7310300","0","2024-09"
"089970","브이엠","180647508800","8200","22030184","24075595","2045411","2024-09"
"251630","브이원텍","60974266775","3995","15262645","15942886","680241","2024-09"
"018290","브이티","1130436984950","31850","35492527","35798007","305480","2024-09"
"439580","블루엠텍","229548041550","20550","11170221","11170221","0","2024-09"
"033560","블루콤","56485967570","3310","17065247","17100000","34753","2024-09"
"369370","블리츠웨이스튜디오","78225443206","1642","47640343","49871911","2231568","2024-09"
"126340","비나텍","210751641550","35650","5911687","6085118","173431","2024-09"
"121800","비덴트","256296018720","3320","77197596","77201611","4015","2024-09"
"082800","비보존 제약","248517801120","5230","47517744","48242965","725221","2024-09"
"318410","비비씨","45386335310","8170","5555243","5555243","0","2024-09"
"002070","비비안","24788599680","832","29793990","29793990","0","2024-09"
"100220","비상교육","64933029500","5300","12251515","12996741","745226","2024-09"
"419540","비스토스","42026551740","1828","22990455","22992511","2056","2024-09"
"146320","비씨엔씨","159836395360","12590","12695504","12792923","97419","2024-09"
"200780","비씨월드제약","40969233075","4855","8438565","8892384","453819","2024-09"
"413640","비아이매트릭스","54484466400","7560","7206940","7206940","0","2024-09"
"141000","비아트론","76009232910","6890","11031819","12114710","1082891","2024-09"
"090460","비에이치","517806481500","16500","31382211","34464379","3082168","2024-09"
"083650","비에이치아이","370686765320","11980","30942134","30944375","2241","2024-09"
"445360","비엔케이제1호스팩","9094100000","2110","4310000","4310000","0","2024-09"
"473370","비엔케이제2호스팩","8546300000","2030","4210000","4210000","0","2024-09"
"065170","비엘팜텍","20818687968","234","88968752","88970559","1807","2024-09"
"086670","비엠티","79571517280","8720","9125174","9125174","0","2024-09"
"335890","비올","491392419400","8510","57742940","58419125","676185","2024-09"
"230980","비유테크놀러지","21370405721","229","93320549","93320557","8","2024-09"
"138580","비즈니스온","358288805600","15950","22463248","22556163","92915","2024-09"
"082920","비츠로셀","420488618280","18770","22402164","22872213","470049","2024-09"
"054220","비츠로시스","21728984758","442","49160599","49160599","0","2024-09"
"042370","비츠로테크","181042172750","6910","26200025","26200025","0","2024-09"
"050090","비케이홀딩스","15662895225","795","19701755","19784735","82980","2024-09"
"148780","비큐AI","32672108275","1039","31445725","31445725","0","2024-09"
"307870","비투엔","34199898645","755","45297879","45297879","0","2024-09"
"357880","비트나인","23081142760","2210","10443956","10443956","0","2024-09"
"032850","비트컴퓨터","79715654920","4945","16120456","16623293","502837","2024-09"
"238200","비피도","31084000000","3800","8180000","8180000","0","2024-09"
"093190","빅솔론","67500321915","4485","15050239","19238905","4188666","2024-09"
"065450","빅텍","148134976000","5170","28652800","28652800","0","2024-09"
"210120","빅텐츠","77514636500","24650","3144610","3144610","0","2024-09"
"044480","빌리언스","24072926976","592","40663728","40663728","0","2024-09"
"005180","빙그레","557917643100","63100","8841801","9851241","1009440","2024-09"
"069540","빛과전자","56797190160","1338","42449320","42449320","0","2024-09"
"072950","빛샘전자","31561858560","3940","8010624","8052610","41986","2024-09"
"451250","삐아","96460035750","9750","9893337","10089877","196540","2024-09"
"143240","사람인","173591629380","15990","10856262","11709263","853001","2024-09"
"003960","사조대림","368672853150","44150","8350461","9164467","814006","2024-09"
"008040","사조동아원","147429718924","1046","140946194","141144600","198406","2024-09"
"007160","사조산업","354503000000","71000","4993000","5000000","7000","2024-09"
"014710","사조씨푸드","119841059280","6960","17218543","17218543","0","2024-09"
"006090","사조오양","81223984320","8620","9422736","9422739","3","2024-09"
"452430","사피엔반도체","95606248840","11810","8095364","8096454","1090","2024-09"
"419120","산돌","45215234580","6180","7316381","7774326","457945","2024-09"
"062040","산일전기","1335396445650","43950","30384447","30445200","60753","2024-09"
"122350","삼기","53943388128","1421","37961568","38339428","377860","2024-09"
"419050","삼기이브이","119540141600","2090","57196240","57196240","0","2024-09"
"014970","삼륭물산","58431161000","3925","14886920","15125000","238080","2024-09"
"018310","삼목에스폼","307270843200","21600","14225502","14700000","474498","2024-09"
"053700","삼보모터스","95362221240","4290","22228956","22877190","648234","2024-09"
"009620","삼보산업","19700471379","267","73784537","73785902","1365","2024-09"
"023600","삼보판지","142646158200","9100","15675402","16170000","494598","2024-09"
"001470","삼부토건","117396207600","525","223611824","223611824","0","2024-09"
"028050","삼성E&A","3573080000000","18230","196000000","196000000","0","2024-09"
"006400","삼성SDI","22181834121000","339000","65433139","68764530","3331391","2024-09"
"006660","삼성공조","81673358740","10390","7860766","8126314","265548","2024-09"
"028260","삼성물산","21065568771900","129900","162167581","177784107","15616526","2024-09"
"207940","삼성바이오로직스","73380394000000","1031000","71174000","71174000","0","2024-09"
"032830","삼성생명","18280712502200","101800","179574779","200000000","20425221","2024-09"
"425290","삼성스팩6호","11702400000","2120","5520000","5520000","0","2024-09"
"439250","삼성스팩7호","36385780000","10390","3502000","3502000","0","2024-09"
"448740","삼성스팩8호","46919840000","10060","4664000","4664000","0","2024-09"
"468510","삼성스팩9호","22321000000","2020","11050000","11050000","0","2024-09"
"018260","삼성에스디에스","11757228272000","152000","77350186","77377800","27614","2024-09"
"009150","삼성전기","8556048019200","117700","72693696","74693696","2000000","2024-09"
"005930","삼성전자","352814148705000","59100","5969782550","5969782550","0","2024-09"
"001360","삼성제약","148710067680","1580","94120296","94162079","41783","2024-09"
"010140","삼성중공업","8190201125890","9590","854035571","880000000","25964429","2024-09"
"016360","삼성증권","4121195000000","46150","89300000","89300000","0","2024-09"
"068290","삼성출판사","143000000000","14300","10000000","10000000","0","2024-09"
"029780","삼성카드","4284434404250","40150","106710695","115858891","9148196","2024-09"
"000810","삼성화재","13800504564000","346500","39828296","47374837","7546541","2024-09"
"006110","삼아알미늄","742951758000","50500","14711916","14711916","0","2024-09"
"009300","삼아제약","131221853000","21500","6103342","6370000","266658","2024-09"
"145990","삼양사","479450960000","49600","9666350","10313449","647099","2024-09"
"003230","삼양식품","3818561536000","512000","7458128","7533015","74887","2024-09"
"002170","삼양통상","131841500000","48650","2710000","3000000","290000","2024-09"
"272550","삼양패키징","251708976330","16230","15508871","15788671","279800","2024-09"
"000070","삼양홀딩스","528667249500","71100","7435545","8564271","1128726","2024-09"
"003720","삼영","142439143775","4295","33163945","34000000","836055","2024-09"
"002810","삼영무역","224405763920","12730","17628104","18466948","838844","2024-09"
"361670","삼영에스앤씨","36481153320","6540","5578158","5667658","89500","2024-09"
"054540","삼영엠텍","48701950000","4015","12130000","13000000","870000","2024-09"
"065570","삼영이엔씨","31180427498","1958","15924631","15924631","0","2024-09"
"005680","삼영전자","195176618720","9770","19977136","20000000","22864","2024-09"
"023000","삼원강재","102926486040","2590","39739956","40000000","260044","2024-09"
"004380","삼익THK","181539000000","8770","20700000","21000000","300000","2024-09"
"002450","삼익악기","83405913755","1097","76030915","90530915","14500000","2024-09"
"032280","삼일","23219547840","1497","15510720","16213590","702870","2024-09"
"002290","삼일기업공사","35526000000","2865","12400000","12400000","0","2024-09"
"004440","삼일씨엔에스","54938351305","4315","12731947","12731947","0","2024-09"
"000520","삼일제약","328598369260","15530","21158942","21621100","462158","2024-09"
"009770","삼정펄프","67124221350","26850","2499971","2499971","0","2024-09"
"037460","삼지전자","133868672640","8720","15351912","16318522","966610","2024-09"
"032750","삼진","38175995340","4230","9025058","9031122","6064","2024-09"
"054090","삼진엘앤디","21465518618","866","24786973","24959232","172259","2024-09"
"005500","삼진제약","228749958800","18260","12527380","13900000","1372620","2024-09"
"000250","삼천당제약","2963001932800","127400","23257472","23457472","200000","2024-09"
"004690","삼천리","308504652500","90100","3424025","4055025","631000","2024-09"
"024950","삼천리자전거","48350158660","3995","12102668","13273577","1170909","2024-09"
"038500","삼표시멘트","330112172400","3075","107353552","107916306","562754","2024-09"
"437730","삼현","80325836400","7600","10569189","10569189","0","2024-09"
"017480","삼현철강","71500580700","4630","15442890","15702890","260000","2024-09"
"010960","삼호개발","69875000000","3125","22360000","25000000","2640000","2024-09"
"046390","삼화네트웍스","59304900228","1498","39589386","43172933","3583547","2024-09"
"004450","삼화왕관","55753457100","30900","1804319","2154379","350060","2024-09"
"009470","삼화전기","254301379000","38450","6613820","6613820","0","2024-09"
"011230","삼화전자","49435155900","2925","16900908","16902700","1792","2024-09"
"001820","삼화콘덴서","342717400000","33400","10261000","10395000","134000","2024-09"
"000390","삼화페인트","174099144600","7380","23590670","27203469","3612799","2024-09"
"027580","상보","67148033656","1192","56332243","59181279","2849036","2024-09"
"038540","상상인","91991507956","1681","54724276","55328313","604037","2024-09"
"415580","상상인제3호스팩","11151000000","2100","5310000","5310000","0","2024-09"
"452670","상상인제4호스팩","10518300000","2015","5220000","5220000","0","2024-09"
"001290","상상인증권","47393673086","446","106263841","108337120","2073279","2024-09"
"041650","상신브레이크","66018657100","3410","19360310","21471450","2111140","2024-09"
"091580","상신이디피","133415472190","10010","13328219","13428219","100000","2024-09"
"263810","상신전자","46639559925","3275","14241087","14244718","3631","2024-09"
"089980","상아프론테크","318826604350","20450","15590543","15989037","398494","2024-09"
"042940","상지건설","23914066460","6010","3979046","3981814","2768","2024-09"
"042600","새로닉스","165493128570","13530","12231569","12423574","192005","2024-09"
"075180","새론오토모티브","75936000000","3955","19200000","19200000","0","2024-09"
"107600","새빗켐","114575535000","23000","4981545","4981545","0","2024-09"
"411080","샌즈랩","105768598260","7270","14548638","15248638","700000","2024-09"
"252990","샘씨엔에스","326689498020","5730","57013874","58388063","1374189","2024-09"
"007540","샘표","88982912200","44150","2015468","2875800","860332","2024-09"
"248170","샘표식품","132887943600","29100","4566596","4568286","1690","2024-09"
"378800","샤페론","126902160510","4210","30143031","30143031","0","2024-09"
"294630","서남","84767387565","3535","23979459","23979459","0","2024-09"
"038070","서린바이오","59784893520","7080","8444194","8900676","456482","2024-09"
"006730","서부T&D","392128092160","6080","64494752","66426923","1932171","2024-09"
"079650","서산","24260000000","1213","20000000","20000000","0","2024-09"
"100660","서암기계공업","48762000000","3870","12600000","12600000","0","2024-09"
"007860","서연","153253439160","7060","21707286","23479844","1772558","2024-09"
"200880","서연이화","372103281270","13770","27022751","27028437","5686","2024-09"
"019770","서연탑메탈","44153500000","3790","11650000","11650000","0","2024-09"
"017390","서울가스","203846580000","52500","3882792","5000000","1117208","2024-09"
"043710","서울리거","32428129578","646","50198343","50198880","537","2024-09"
"092190","서울바이오시스","185434607300","4100","45227953","45868383","640430","2024-09"
"046890","서울반도체","524910275400","9310","56381340","58305400","1924060","2024-09"
"004410","서울식품","58461843804","156","374755409","374755559","150","2024-09"
"063170","서울옥션","133180812380","7910","16837018","17774267","937249","2024-09"
"027040","서울전자통신","18580040856","267","69588168","69588847","679","2024-09"
"018680","서울제약","46170903240","3960","11659319","11659319","0","2024-09"
"021050","서원","59153339140","1246","47474590","47474590","0","2024-09"
"093920","서원인텍","108624000000","5840","18600000","18600000","0","2024-09"
"189860","서전기전","50433656000","5200","9698780","9698780","0","2024-09"
"178320","서진시스템","1569317916600","27900","56247954","56247954","0","2024-09"
"122690","서진오토모티브","49739862560","2290","21720464","21844410","123946","2024-09"
"140070","서플러스글로벌","111104391150","3225","34450974","36988000","2537026","2024-09"
"011370","서한","77279358755","787","98194865","100894865","2700000","2024-09"
"065710","서호전기","106747100300","21650","4930582","5150000","219418","2024-09"
"008490","서흥","176793896700","15900","11119113","11569113","450000","2024-09"
"035890","서희건설","273531555800","1415","193308520","229808457","36499937","2024-09"
"357550","석경에이티","247746450000","45550","5439000","5455000","16000","2024-09"
"003100","선광","99004600000","15740","6290000","6600000","310000","2024-09"
"007610","선도전기","50907057000","3000","16969019","18000000","1030981","2024-09"
"067370","선바이오","79615504510","6470","12305333","12313555","8222","2024-09"
"171090","선익시스템","385675414050","44050","8755401","9494405","739004","2024-09"
"136490","선진","158131733200","6650","23779208","23779604","396","2024-09"
"086710","선진뷰티사이언스","128990192400","10740","12010260","12203280","193020","2024-09"
"014620","성광벤드","338946293940","12660","26773009","28600000","1826991","2024-09"
"037350","성도이엔지","65404815000","4605","14203000","15470000","1267000","2024-09"
"014910","성문전자","25946571250","1250","20757257","22460985","1703728","2024-09"
"003080","성보화학","51026794705","2605","19588021","20020000","431979","2024-09"
"004980","성신양회","194126530850","8050","24115097","24516073","400976","2024-09"
"011300","성안머티리얼스","35621229540","435","81887884","81887884","0","2024-09"
"081580","성우전자","67508863560","4440","15204699","15508143","303444","2024-09"
"045300","성우테크론","26626460800","2720","9789140","10151583","362443","2024-09"
"015750","성우하이텍","495147960670","6190","79991593","80000000","8407","2024-09"
"365340","성일하이텍","656630472700","54100","12137347","12137347","0","2024-09"
"000180","성창기업지주","95559692000","1370","69751600","69751600","0","2024-09"
"080470","성창오토텍","31207500000","4275","7300000","7300000","0","2024-09"
"043260","성호전자","92113305390","1510","61002189","61002189","0","2024-09"
"148150","세경하이테크","252043934480","7120","35399429","35860429","461000","2024-09"
"002420","세기상사","33019557120","5940","5558848","5558848","0","2024-09"
"188260","세니젠","20017208820","2820","7098301","7228470","130169","2024-09"
"053060","세동","20852777642","1181","17656882","17657419","537","2024-09"
"340440","세림B&G","39531054087","1393","28378359","28378364","5","2024-09"
"017510","세명전기","78059520000","5120","15246000","15246000","0","2024-09"
"004360","세방","213812902080","11920","17937324","19308690","1371366","2024-09"
"004490","세방전지","890558160600","67700","13154478","14000000","845522","2024-09"
"011560","세보엠이씨","101457273060","10230","9917622","10530000","612378","2024-09"
"396300","세아메카닉스","77128077500","2945","26189500","26489500","300000","2024-09"
"001430","세아베스틸지주","705049259540","19660","35862119","35862119","0","2024-09"
"306200","세아제강","319211400000","114000","2800100","2836300","36200","2024-09"
"003030","세아제강지주","658191096900","162900","4040461","4141657","101196","2024-09"
"019440","세아특수강","115075743510","13790","8344869","8570000","225131","2024-09"
"058650","세아홀딩스","388392217300","99700","3895609","4000000","104391","2024-09"
"013000","세우글로벌","35907429231","1251","28702981","28705031","2050","2024-09"
"100700","세운메디칼","119050525000","2750","43291100","43800000","508900","2024-09"
"024830","세원물산","51102000000","6120","8350000","8350000","0","2024-09"
"091090","세원이앤씨","54828158060","1270","43171778","43180255","8477","2024-09"
"021820","세원정공","69100000000","6910","10000000","10000000","0","2024-09"
"067830","세이브존I&C","81277447715","2155","37715753","41040895","3325142","2024-09"
"258830","세종메디칼","22974088612","412","55762351","55786351","24000","2024-09"
"036630","세종텔레콤","94403044708","497","189945764","200000000","10054236","2024-09"
"039310","세중","31386727244","1732","18121667","18121667","0","2024-09"
"075580","세진중공업","398514686560","7010","56849456","56849456","0","2024-09"
"067770","세진티에스","20241481160","2440","8295689","8396593","100904","2024-09"
"053450","세코닉스","79285369740","5420","14628297","14792803","164506","2024-09"
"222810","세토피아","81189010800","1080","75175010","75659350","484340","2024-09"
"252500","세화피앤씨","37669642120","908","41486390","41486390","0","2024-09"
"321370","센서뷰","55848739400","2120","26343745","26343745","0","2024-09"
"347000","센코","80250739665","2465","32556081","33004976","448895","2024-09"
"331920","셀레믹스","31023762400","3800","8164148","8164148","0","2024-09"
"049180","셀루메드","136493279700","2650","51506898","51515906","9008","2024-09"
"299660","셀리드","98761932360","4680","21102977","21102977","0","2024-09"
"268600","셀리버리","248384003120","6680","37183234","37183234","0","2024-09"
"108860","셀바스AI","291481609080","10830","26914276","26914790","514","2024-09"
"208370","셀바스헬스케어","107885243905","4195","25717579","25740564","22985","2024-09"
"318160","셀바이오휴먼텍","34359273225","3915","8776315","9260901","484586","2024-09"
"308430","셀비온","201913292650","15850","12739009","12739009","0","2024-09"
"068270","셀트리온","38684013293100","187700","206094903","217021190","10926287","2024-09"
"068760","셀트리온제약","2566218502000","62000","41390621","41600387","209766","2024-09"
"068940","셀피글로벌","29334496224","778","37705008","38260597","555589","2024-09"
"060230","소니드","43751058936","956","45764706","46066730","302024","2024-09"
"290690","소룩스","389079052320","8540","45559608","45564340","4732","2024-09"
"032680","소프트센","41398924976","397","104279408","105590764","1311356","2024-09"
"258790","소프트캠프","21844551972","911","23978652","24991284","1012632","2024-09"
"066910","손오공","52143232932","1548","33684259","33784259","100000","2024-09"
"336370","솔루스첨단소재","835526346200","11900","70212298","70217344","5046","2024-09"
"248070","솔루엠","911121419520","18720","48671016","50005551","1334535","2024-09"
"035610","솔본","100742759125","3925","25666945","27345997","1679052","2024-09"
"357780","솔브레인","1509912690000","195000","7743142","7778566","35424","2024-09"
"036830","솔브레인홀딩스","1016550375600","49200","20661593","20964056","302463","2024-09"
"304100","솔트룩스","202823096960","16720","12130568","12130568","0","2024-09"
"328380","솔트웨어","34669287268","1012","34258189","34262778","4589","2024-09"
"004430","송원산업","324960000000","13540","24000000","24000000","0","2024-09"
"086980","쇼박스","272541870000","4365","62438000","62638000","200000","2024-09"
"050960","수산아이앤티","66969920000","9920","6751000","6751000","0","2024-09"
"126720","수산인더스트리","326520860000","23200","14074175","14286000","211825","2024-09"
"017550","수산중공업","110134464450","1765","62399130","62399130","0","2024-09"
"084180","수성웹툰","72596752314","618","117470473","117470473","0","2024-09"
"253840","수젠텍","96936495120","6340","15289668","16743200","1453532","2024-09"
"298830","슈어소프트테크","251311201740","4815","52193396","52619061","425665","2024-09"
"236200","슈프리마","177315762200","25700","6899446","7193273","293827","2024-09"
"094840","슈프리마에이치큐","52633303500","5750","9153618","10471840","1318222","2024-09"
"192440","슈피겐코리아","123008572800","20400","6029832","6216363","186531","2024-09"
"424960","스마트레이더시스템","173352474000","11100","15617340","15617340","0","2024-09"
"099440","스맥","112415758380","3015","37285492","40243394","2957902","2024-09"
"053210","스카이라이프","237414534640","5020","47293732","47522955","229223","2024-09"
"276040","스코넥","38793324660","3090","12554474","12554474","0","2024-09"
"159910","스킨앤스킨","26735179890","739","36177510","36410098","232588","2024-09"
"060240","스타코링크","16413314320","520","31564066","32314179","750113","2024-09"
"115570","스타플렉스","23788404270","3015","7890018","7984508","94490","2024-09"
"330730","스톤브릿지벤처스","68432751800","3925","17435096","18150830","715734","2024-09"
"352090","스톰테크","89218353360","3320","26872998","26872998","0","2024-09"
"253450","스튜디오드래곤","1206848694700","40150","30058498","30058498","0","2024-09"
"408900","스튜디오미르","157152575055","4805","32706051","32706134","83","2024-09"
"204630","스튜디오산타클로스","23613109200","4650","5078088","5089941","11853","2024-09"
"415380","스튜디오삼익","33329058600","8220","4054630","4225498","170868","2024-09"
"026890","스틱인베스트먼트","295312607200","8080","36548590","41678175","5129585","2024-09"
"013810","스페코","72984240600","4980","14655470","14655470","0","2024-09"
"203690","스피어파워","65192692950","4950","13170241","13337850","167609","2024-09"
"049830","승일","43243090320","7320","5907526","6132112","224586","2024-09"
"020710","시공테크","65927111175","3495","18863265","20047970","1184705","2024-09"
"033170","시그네틱스","84528122534","986","85728319","85728319","0","2024-09"
"048870","시너지이노베이션","229929196320","2780","82708344","82708344","0","2024-09"
"025320","시노펙스","601003166400","7200","83472662","83817936","345274","2024-09"
"134790","시디즈","49613208900","29550","1678958","2000000","321042","2024-09"
"269620","시스웍","131663951937","889","148103433","148582691","479258","2024-09"
"429270","시지트로닉스","29380750000","6520","4506250","4506250","0","2024-09"
"418250","시큐레터","52279100100","6550","7981542","7981542","0","2024-09"
"131090","시큐브","34133741130","879","38832470","44000000","5167530","2024-09"
"232830","시큐센","24117392320","2060","11707472","11707472","0","2024-09"
"462870","시프트업","3791756800000","65000","58334720","58334720","0","2024-09"
"016590","신대양제지","180046007710","5870","30672233","40297820","9625587","2024-09"
"290520","신도기연","33518029320","2130","15736164","15929362","193198","2024-09"
"029530","신도리코","354396216900","41100","8622779","10080029","1457250","2024-09"
"004970","신라교역","148379000000","9400","15785000","16000000","215000","2024-09"
"001000","신라섬유","24593148020","1013","24277540","24277540","0","2024-09"
"025870","신라에스지","24920000000","6230","4000000","4000000","0","2024-09"
"215600","신라젠","341170930625","2485","137292125","137367125","75000","2024-09"
"065350","신성델타테크","1181142540600","43450","27183948","27483948","300000","2024-09"
"416180","신성에스티","229195212800","25600","8952938","9039778","86840","2024-09"
"011930","신성이엔지","293135038560","1440","203565999","205848151","2282152","2024-09"
"005390","신성통상","322625335550","2245","143708390","143708390","0","2024-09"
"004170","신세계","1396876808600","151400","9226399","9845181","618782","2024-09"
"035510","신세계 I&C","131195183800","9980","13145810","17200000","4054190","2024-09"
"034300","신세계건설","137438999420","18110","7589122","7760554","171432","2024-09"
"031430","신세계인터내셔날","443597490000","12810","34629000","35700000","1071000","2024-09"
"031440","신세계푸드","133400424950","34450","3872291","3872480","189","2024-09"
"006880","신송홀딩스","71427820620","6620","10789701","11828858","1039157","2024-09"
"162300","신스틸","105625346400","2575","41019552","41471382","451830","2024-09"
"290560","신시웨이","24105199480","6220","3875434","3877972","2538","2024-09"
"002800","신신제약","85713325000","5650","15170500","15170500","0","2024-09"
"472220","신영스팩10호","10083500000","2150","4690000","4690000","0","2024-09"
"430220","신영스팩8호","14601600000","2160","6760000","6760000","0","2024-09"
"445970","신영스팩9호","11738400000","2190","5360000","5360000","0","2024-09"
"005800","신영와코루","81810000000","9090","9000000","9000000","0","2024-09"
"001720","신영증권","617761993600","80200","7702768","16440000","8737232","2024-09"
"009270","신원","94565968560","1260","75052356","102586356","27534000","2024-09"
"017000","신원종합개발","34874026110","3115","11195514","11668027","472513","2024-09"
"002700","신일전자","100868773180","1435","70291828","71047521","755693","2024-09"
"012790","신일제약","83691221640","7240","11559561","11986415","426854","2024-09"
"138070","신진에스엠","41647646700","2475","16827332","17503204","675872","2024-09"
"226330","신테카바이오","67060997625","4395","15258475","15258475","0","2024-09"
"002870","신풍","25517575980","921","27706380","34958700","7252320","2024-09"
"019170","신풍제약","593715899450","12050","49271029","52984990","3713961","2024-09"
"418210","신한제10호스팩","8216700000","2245","3660000","3660000","0","2024-09"
"452980","신한제11호스팩","36902560000","1952","18905000","18905000","0","2024-09"
"474660","신한제12호스팩","11619600000","2105","5520000","5520000","0","2024-09"
"474930","신한제13호스팩","7891600000","2180","3620000","3620000","0","2024-09"
"055550","신한지주","27437770158000","54500","503445324","509393214","5947890","2024-09"
"056700","신화인터텍","48506544152","1672","29011091","29135091","124000","2024-09"
"187270","신화콘텍","30355356900","3300","9198593","10143845","945252","2024-09"
"004080","신흥","135034971500","14300","9443005","9500000","56995","2024-09"
"243840","신흥에스이씨","290097047200","7520","38576735","38919035","342300","2024-09"
"257720","실리콘투","2355794155800","38700","60873234","60873234","0","2024-09"
"222800","심텍","514629372320","16160","31845877","31854143","8266","2024-09"
"036710","심텍홀딩스","68300281060","1474","46336690","48350145","2013455","2024-09"
"160980","싸이맥스","111300460920","10890","10220428","10924243","703815","2024-09"
"356890","싸이버원","34434118800","2890","11914920","11916325","1405","2024-09"
"217330","싸이토젠","191246544630","8290","23069547","23129547","60000","2024-09"
"102280","쌍방울","70634046631","269","262580099","262592129","12030","2024-09"
"010280","쌍용정보통신","39074264400","600","65123774","65123786","12","2024-09"
"004770","써니전자","58029484723","1597","36336559","36702884","366325","2024-09"
"208640","썸에이지","34531582992","248","139240254","139240254","0","2024-09"
"222420","쎄노텍","38095671064","838","45460228","45460231","3","2024-09"
"037760","쎄니트","47702183049","1569","30402921","33832921","3430000","2024-09"
"099320","쎄트렉아이","424909586400","38800","10951278","10951278","0","2024-09"
"049960","쎌바이오텍","93008601000","13590","6843900","9400000","2556100","2024-09"
"088280","쏘닉스","45429536250","2625","17306490","17306490","0","2024-09"
"403550","쏘카","603794196800","18400","32814902","32814902","0","2024-09"
"050890","쏠리드","264824351060","4370","60600538","61095231","494693","2024-09"
"475400","씨메스","195241709700","17070","11437710","11437710",,"자료 없음"
"109670","씨싸이트","55201928540","9460","5835299","5836602","1303","2024-09"
"066790","씨씨에스","92784236974","1534","60485161","65152039","4666878","2024-09"
"222080","씨아이에스","614003039120","8560","71729327","71729327","0","2024-09"
"004920","씨아이테크","69891847028","1396","50065793","50065793","0","2024-09"
"352480","씨앤씨인터내셔널","680802782400","68100","9997104","10013941","16837","2024-09"
"264660","씨앤지하이테크","116875053540","12530","9327618","9627896","300278","2024-09"
"352700","씨앤투스","73053471630","2855","25587906","27276899","1688993","2024-09"
"458870","씨어스테크놀로지","149113958400","11880","12551680","12551680","0","2024-09"
"297090","씨에스베어링","148621500000","5450","27270000","27270000","0","2024-09"
"112610","씨에스윈드","2407052846100","58100","41429481","42171403","741922","2024-09"
"359090","씨엔알리서치","68022756100","1205","56450420","56450891","471","2024-09"
"115530","씨엔플러스","29495942000","434","67963000","67963000","0","2024-09"
"115480","씨유메디칼","35949044826","747","48124558","48224558","100000","2024-09"
"340810","씨유박스","33648215025","3175","10597863","10597863","0","2024-09"
"376290","씨유테크","55709412500","3155","17657500","17657500","0","2024-09"
"189330","씨이랩","41122917000","6750","6092284","6092284","0","2024-09"
"096530","씨젠","1085397038000","23500","46187108","52225994","6038886","2024-09"
"101240","씨큐브","50193203880","4855","10338456","10340947","2491","2024-09"
"060590","씨티씨바이오","187683883750","7850","23908775","24181020","272245","2024-09"
"308170","씨티알모빌리티","46407900000","5390","8610000","8610000","0","2024-09"
"260930","씨티케이","109670851980","5820","18843789","19341591","497802","2024-09"
"052300","씨티프라퍼티","62902495827","373","168639399","168651433","12034","2024-09"
"413630","씨피시스템","94949448885","2565","37017329","38703425","1686096","2024-09"
"013990","아가방컴퍼니","135249466500","4500","30055437","32887536","2832099","2024-09"
"123860","아나패스","220646153000","18200","12123415","12123415","0","2024-09"
"025980","아난티","452896632580","5110","88629478","88629478","0","2024-09"
"008700","아남전자","97327118460","1262","77121330","77124820","3490","2024-09"
"125210","아모그린텍","111848236200","6780","16496790","16496790","0","2024-09"
"002790","아모레G","1758071328750","23050","76272075","82458180","6186105","2024-09"
"090430","아모레퍼시픽","7022323198000","120200","58421990","58492759","70769","2024-09"
"357580","아모센스","80561495520","7180","11220264","11220264","0","2024-09"
"052710","아모텍","58450184000","4000","14612546","14615109","2563","2024-09"
"074430","아미노로직스","104074810140","1185","87826844","87826844","0","2024-09"
"092040","아미코젠","257636224600","4700","54816218","55018347","202129","2024-09"
"083930","아바코","227626418880","15680","14516991","14912798","395807","2024-09"
"149950","아바텍","156324369500","11300","13834015","15607500","1773485","2024-09"
"036010","아비코전자","69389115480","5220","13292934","13292934","0","2024-09"
"002030","아세아","426021453000","253500","1680558","2115648","435090","2024-09"
"183190","아세아시멘트","404884241300","10780","37558835","38501886","943051","2024-09"
"002310","아세아제지","327252334500","8190","39957550","42782510","2824960","2024-09"
"050860","아세아텍","43554557200","2200","19797526","22500000","2702474","2024-09"
"012170","아센디오","44741974752","432","103569386","103569488","102","2024-09"
"136410","아셈스","85561687050","8050","10628781","11019106","390325","2024-09"
"246720","아스타","58135880500","4285","13567300","13567300","0","2024-09"
"067390","아스트","186001202880","540","344446672","344580069","133397","2024-09"
"159010","아스플로","77160996300","5970","12924790","13334739","409949","2024-09"
"127710","아시아경제","45619635174","1307","34904082","34904082","0","2024-09"
"267850","아시아나IDT","201243000000","18130","11100000","11100000","0","2024-09"
"020560","아시아나항공","741141169440","9960","74411764","74411764","0","2024-09"
"154030","아시아종묘","27007850160","2330","11591352","11591352","0","2024-09"
"227610","아우딘퓨쳐스","48032564385","1355","35448387","35583547","135160","2024-09"
"143160","아이디스","148184158500","14700","10080555","10716390","635835","2024-09"
"054800","아이디스홀딩스","80279325810","9090","8831609","10347756","1516147","2024-09"
"332370","아이디피","46858981610","3715","12613454","13273726","660272","2024-09"
"122900","아이마켓코리아","265559029600","8440","31464340","33428840","1964500","2024-09"
"339950","아이비김영","77317601910","1783","43363770","44946655","1582885","2024-09"
"469750","아이비젼웍스","46268083788","1366","33871218","33936481","65263","2024-09"
"460470","아이빔테크놀로지","74215100400","4920","15084370","15084370","0","2024-09"
"099190","아이센스","532230570360","19260","27633986","27637273","3287","2024-09"
"461300","아이스크림미디어","198072993240","15480","12795413","13063433","268020","2024-09"
"289010","아이스크림에듀","28942440450","2310","12529195","12864037","334842","2024-09"
"214430","아이쓰리시스템","249900552000","36000","6941682","7106760","165078","2024-09"
"040910","아이씨디","75521555130","4630","16311351","18574275","2262924","2024-09"
"368600","아이씨에이치","64193680305","3735","17187063","17538346","351283","2024-09"
"456010","아이씨티케이","106568481760","8060","13221896","13221896","0","2024-09"
"052860","아이앤씨","25966734400","1600","16229209","17862854","1633645","2024-09"
"464500","아이언디바이스","57821568805","4235","13653263","13653263","0","2024-09"
"010780","아이에스동서","605248868800","20050","30186976","30186976","0","2024-09"
"038880","아이에이","62152804644","204","304670611","315334702","10664091","2024-09"
"307180","아이엘사이언스","82750022460","3060","27042491","27042828","337","2024-09"
"101390","아이엠","36009179325","3425","10513629","10548085","34456","2024-09"
"461030","아이엠비디엑스","210686782500","15030","14017750","14017750","0","2024-09"
"451220","아이엠티","74100089510","9410","7874611","7874611","0","2024-09"
"090150","아이윈","34751356500","875","39715836","41875293","2159457","2024-09"
"123010","아이윈플러스","21463368634","662","32422007","32658542","236535","2024-09"
"031310","아이즈비전","43876238692","1796","24429977","25334636","904659","2024-09"
"185490","아이진","79467564960","2940","27029784","27029784","0","2024-09"
"059100","아이컴포넌트","30255873880","4580","6606086","7070860","464774","2024-09"
"262840","아이퀘스트","40743455420","2165","18819148","19290000","470852","2024-09"
"175250","아이큐어","88192456600","2360","37369685","37558368","188683","2024-09"
"052460","아이크래프트","28160939280","2355","11957936","14607936","2650000","2024-09"
"119830","아이텍","116037595900","5450","21291302","21434297","142995","2024-09"
"052770","아이톡시","69796423050","1425","48979946","48979946","0","2024-09"
"124500","아이티센","155006240360","6680","23204527","23204527","0","2024-09"
"372800","아이티아이즈","33379233300","5670","5886990","6026990","140000","2024-09"
"084850","아이티엠반도체","381913789660","18460","20688721","22682934","1994213","2024-09"
"114840","아이패밀리에스씨","318975964000","18500","17241944","17241944","0","2024-09"
"027360","아주IB투자","238596770620","2015","118410308","120945406","2535098","2024-09"
"139990","아주스틸","133118321880","5020","26517594","26517744","150","2024-09"
"032080","아즈텍WB","23970613118","1142","20990029","21491029","501000","2024-09"
"013310","아진산업","104382603980","2690","38803942","38806582","2640","2024-09"
"059120","아진엑스텍","70768405090","7730","9155033","9748596","593563","2024-09"
"009320","아진전자부품","54426946080","1104","49299770","49299770","0","2024-09"
"158430","아톤","90830677000","4250","21371924","22602474","1230550","2024-09"
"321820","아티스트유나이티드","217076994400","16240","13366810","13366810","0","2024-09"
"001540","안국약품","81262359750","7150","11365365","13042420","1677055","2024-09"
"053800","안랩","576147919200","58800","9798434","11126506","1328072","2024-09"
"065660","안트로젠","146846418570","15090","9731373","9731373","0","2024-09"
"297570","알로이스","38014097364","1098","34621218","34621218","0","2024-09"
"001780","알루코","223677604920","2310","96830132","96830132","0","2024-09"
"260660","알리코제약","56450350160","3760","15013391","15327021","313630","2024-09"
"354320","알멕","195256689550","30550","6391381","6391381","0","2024-09"
"361570","알비더블유","62854463745","2195","28635291","28635291","0","2024-09"
"131370","알서포트","153919383990","2955","52087778","53267083","1179305","2024-09"
"140670","알에스오토메이션","95618309400","10350","9238484","9303140","64656","2024-09"
"096610","알에프세미","51550708615","2965","17386411","17386411","0","2024-09"
"061040","알에프텍","93976257480","3010","31221348","32089259","867911","2024-09"
"148250","알엔투테크놀로지","29056016250","4050","7174325","7391186","216861","2024-09"
"347860","알체라","50975531420","2315","22019668","22019668","0","2024-09"
"196170","알테오젠","20198850480000","379000","53295120","53318828","23708","2024-09"
"123750","알톤","20357343903","1599","12731297","12746297","15000","2024-09"
"085810","알티캐스트","40029226015","1321","30302215","31081959","779744","2024-09"
"043100","알파녹스","22470030720","2820","7968096","7975920","7824","2024-09"
"117670","알파홀딩스","37743429465","945","39940137","39940137","0","2024-09"
"314140","알피바이오","52418042520","6060","8649842","8666361","16519","2024-09"
"291650","압타머사이언스","36422640540","2145","16980252","16980252","0","2024-09"
"293780","압타바이오","202787640000","8200","24730200","24730200","0","2024-09"
"018250","애경산업","403256032920","15690","25701468","26409935","708467","2024-09"
"161000","애경케미칼","499184448840","10340","48277026","48648709","371683","2024-09"
"196300","애니젠","75642676200","12600","6003387","6003387","0","2024-09"
"310200","애니플러스","119886552170","2695","44484806","45520979","1036173","2024-09"
"299910","애닉","32483121920","6880","4721384","4721384","0","2024-09"
"179530","애드바이오텍","28838100820","3155","9140444","9140444","0","2024-09"
"205500","액션스퀘어","59456054325","1145","51926685","51928120","1435","2024-09"
"052790","액토즈소프트","74396165070","6810","10924547","11330638","406091","2024-09"
"290740","액트로","52447677740","5620","9332327","10065011","732684","2024-09"
"238090","앤디포스","88766129400","3900","22760546","23541303","780757","2024-09"
"092600","앤씨앤","28824026154","1177","24489402","25083517","594115","2024-09"
"129890","앱코","58288857576","1217","47895528","50643410","2747882","2024-09"
"174900","앱클론","289605344820","16620","17425111","17425111","0","2024-09"
"255440","야스","122012221590","10110","12068469","13058000","989531","2024-09"
"030960","양지사","126234483300","9190","13736070","15980000","2243930","2024-09"
"102120","어보브반도체","160697863960","9740","16498754","17780753","1281999","2024-09"
"263540","어스앤에어로스페이스","1057417820","74","14289430","14294091","4661","2023-12"
"238120","얼라인드","42992899040","2990","14378896","14378896","0","2024-09"
"019990","에너토크","60478715440","6320","9569417","9756088","186671","2024-09"
"011090","에넥스","31015239403","523","59302561","59991641","689080","2024-09"
"270660","에브리봇","190686621780","15590","12231342","12231342","0","2024-09"
"038680","에스넷","66986891785","3685","18178261","19549677","1371416","2024-09"
"137310","에스디바이오센서","1103574143320","9020","122347466","124477353","2129887","2024-09"
"217480","에스디생명공학","54756837359","499","109733141","109733141","0","2024-09"
"121890","에스디시스템","18780813198","1413","13291446","13291446","0","2024-09"
"304360","에스바이오메딕스","330644157400","28150","11745796","11745796","0","2024-09"
"389500","에스비비테크","84124017540","14110","5962014","6174904","212890","2024-09"
"042110","에스씨디","70319515620","1455","48329564","48329564","0","2024-09"
"298060","에스씨엠생명과학","38875159000","1900","20460610","20467248","6638","2024-09"
"065420","에스아이리소스","18466281372","258","71574734","71577299","2565","2024-09"
"103230","에스앤더블류","24948000000","3465","7200000","7200000","0","2024-09"
"260970","에스앤디","93725229600","32400","2892754","2892754","0","2024-09"
"101490","에스앤에스텍","475569540000","22700","20950200","21451447","501247","2024-09"
"095910","에스에너지","27686678580","1485","18644228","19504503","860275","2024-09"
"275630","에스에스알","17639234080","3260","5410808","6017989","607181","2024-09"
"031330","에스에이엠티","303852883705","3115","97545067","99995067","2450000","2024-09"
"060540","에스에이티","37631424960","1440","26132934","26133306","372","2024-09"
"351320","에스에이티이엔지","33970188068","1543","22015676","22015886","210","2024-09"
"056190","에스에프에이","651857390500","20750","31414814","35908760","4493946","2024-09"
"080000","에스엔유","59193724980","1730","34216026","34322870","106844","2024-09"
"005850","에스엘","1478380330200","32100","46055462","46448520","393058","2024-09"
"214310","에스엘에너지","22487615640","6120","3674447","3679130","4683","2024-09"
"246250","에스엘에스바이오","45200466670","2945","15348206","15348206","0","2024-09"
"041510","에스엠","1602628300000","70000","22894690","23353627","458937","2024-09"
"010580","에스엠벡셀","135660753228","1221","111106268","111251760","145492","2024-09"
"007820","에스엠코어","91901741400","4700","19553562","20033946","480384","2024-09"
"464080","에스오에스랩","96189155200","5440","17681830","17681830","0","2024-09"
"109610","에스와이","199628481800","4180","47758010","48907400","1149390","2024-09"
"365330","에스와이스틸텍","174783100000","5710","30610000","30610000","0","2024-09"
"012750","에스원","2126664033100","62900","33810239","37999178","4188939","2024-09"
"031860","에스유홀딩스","17169645366","1143","15021562","15026356","4794","2024-09"
"306040","에스제이그룹","53477745280","5680","9415096","9865828","450732","2024-09"
"457940","에스케이증권제10호스팩","7033750000","2125","3310000","3310000","0","2024-09"
"472230","에스케이증권제11호스팩","8642400000","2080","4155000","4155000","0","2024-09"
"473000","에스케이증권제12호스팩","6934450000","2095","3310000","3310000","0","2024-09"
"473950","에스케이증권제13호스팩","9083100000","2055","4420000","4420000","0","2024-09"
"435870","에스케이증권제8호스팩","7849200000","2110","3720000","3720000","0","2024-09"
"455910","에스케이증권제9호스팩","10642400000","2120","5020000","5020000","0","2024-09"
"096630","에스코넥","53587514835","687","78002205","79052205","1050000","2024-09"
"069510","에스텍","91837200000","10920","8410000","10910000","2500000","2024-09"
"234300","에스트래픽","121639350300","4420","27520215","27809848","289633","2024-09"
"039440","에스티아이","301372611150","20450","14737047","15830000","1092953","2024-09"
"098660","에스티오","37807527520","3115","12137248","12500976","363728","2024-09"
"052020","에스티큐브","284063476410","6090","46644249","46694249","50000","2024-09"
"237690","에스티팜","1960323242800","97400","20126522","20126522","0","2024-09"
"050760","에스폴리텍","24384132251","1579","15442769","16334678","891909","2024-09"
"288620","에스퓨얼셀","70909850560","10160","6979316","6979316","0","2024-09"
"443670","에스피소프트","186578900580","7710","24199598","24201392","1794","2024-09"
"317830","에스피시스템스","53192855140","5230","10170718","10773818","603100","2024-09"
"058610","에스피지","461289088000","20800","22177360","22177360","0","2024-09"
"043340","에쎈테크","45790000000","482","95000000","95000000","0","2024-09"
"023960","에쓰씨엔지니어링","61586554980","1812","33988165","33988167","2","2024-09"
"298690","에어부산","278048031840","2385","116581984","116640000","58016","2024-09"
"054630","에이디칩스","12594094838","158","79709461","79709461","0","2024-09"
"200710","에이디테크놀로지","183437716560","14160","12954641","13440822","486181","2024-09"
"096690","에이루트","41739673784","1247","33472072","33477189","5117","2024-09"
"078520","에이블씨엔씨","186521512860","7170","26014158","26014161","3","2024-09"
"298380","에이비엘바이오","1799389698050","37450","48047789","48047789","0","2024-09"
"203400","에이비온","212897075680","8440","25224772","25224772","0","2024-09"
"195990","에이비프로바이오","152308029710","535","284687906","284689721","1815","2024-09"
"003800","에이스침대","288732445750","27350","10556945","11090000","533055","2024-09"
"088800","에이스테크","119646042416","944","126743689","127068928","325239","2024-09"
"241840","에이스토리","63937029650","6890","9279685","9539994","260309","2024-09"
"453860","에이에스텍","124538251500","22100","5635215","5657215","22000","2024-09"
"312610","에이에프더블류","33423865200","1650","20256888","20256888","0","2024-09"
"015260","에이엔피","30722046978","681","45113138","45116894","3756","2024-09"
"172670","에이엘티","76895469000","8680","8858925","8960259","101334","2024-09"
"445090","에이직랜드","416864248200","38700","10771686","10771686","0","2024-09"
"295310","에이치브이엠","174244269840","14640","11901931","11901931","0","2024-09"
"072990","에이치시티","72069900440","10180","7079558","7287341","207783","2024-09"
"044990","에이치엔에스하이텍","136773809280","17020","8036064","8036064",,"자료 없음"
"239610","에이치엘사이언스","78584233930","15430","5092951","5392115","299164","2024-09"
"462020","에이치엠씨제6호스팩","8842075000","2035","4345000","4345000","0","2024-09"
"477340","에이치엠씨제7호스팩","14967430000","1993","7510000","7510000","0","2024-09"
"148930","에이치와이티씨","42825674300","4405","9722060","10175213","453153","2024-09"
"044780","에이치케이","23608880538","1286","18358383","18505787","147404","2024-09"
"357230","에이치피오","121125134285","2935","41269211","42089487","820276","2024-09"
"355690","에이텀","33889224600","6270","5404980","5404980","0","2024-09"
"071670","에이테크솔루션","61800000000","6180","10000000","10000000","0","2024-09"
"045660","에이텍","115868989440","15360","7543554","8260000","716446","2024-09"
"224110","에이텍모빌리티","65007004250","13250","4906189","5340000","433811","2024-09"
"021080","에이티넘인베스트","117286166250","2550","45994575","48000000","2005425","2024-09"
"200470","에이팩트","119246296635","2815","42361029","42362093","1064","2024-09"
"262260","에이프로","103575192690","7190","14405451","14468152","62701","2024-09"
"007460","에이프로젠","294298957540","1106","266093090","286851768","20758678","2024-09"
"003060","에이프로젠바이오로직스","162997564950","825","197572806","198407845","835039","2024-09"
"397030","에이프릴바이오","465148058400","21150","21992816","21992816","0","2024-09"
"244920","에이플러스에셋","96760926040","4280","22607693","22607693","0","2024-09"
"278470","에이피알","1984308631500","266500","7445811","7622678","176867","2024-09"
"230240","에치에프알","127956796500","9750","13123774","13309000","185226","2024-09"
"230360","에코마케팅","330414304500","10500","31468029","31468029","0","2024-09"
"038870","에코바이오","54159328995","3865","14012763","14014949","2186","2024-09"
"097780","에코볼트","59331776088","876","67730338","67730338","0","2024-09"
"448280","에코아이","187663817000","19000","9877043","9877043","0","2024-09"
"101360","에코앤드림","676461753300","38550","17547646","17786114","238468","2024-09"
"128540","에코캡","32905130124","1266","25991414","26690460","699046","2024-09"
"086520","에코프로","10592225238000","80400","131744095","133138340","1394245","2024-09"
"450080","에코프로머티","7929304650400","114800","69070598","69070598","0","2024-09"
"247540","에코프로비엠","16621745786200","170200","97660081","97801344","141263","2024-09"
"383310","에코프로에이치엔","695983369400","45650","15246076","15304932","58856","2024-09"
"038110","에코플라스틱","112299572710","2795","40178738","41169370","990632","2024-09"
"073540","에프알텍","14569200000","1278","11400000","11400000","0","2024-09"
"064850","에프앤가이드","114103320000","10000","11410332","11410332","0","2024-09"
"036810","에프에스티","356414017120","17860","19955992","21756789","1800797","2024-09"
"173940","에프엔씨엔터","54934638880","3680","14927891","15392808","464917","2024-09"
"083500","에프엔에스테크","73859016000","9240","7993400","8575722","582322","2024-09"
"054940","엑사이엔씨","24349384232","734","33173548","33173548","0","2024-09"
"373110","엑셀세라퓨틱스","66493433580","6090","10918462","10918462","0","2024-09"
"205100","엑셈","124414372264","1729","71957416","71963431","6015","2024-09"
"356680","엑스게이트","151797592240","5320","28533382","28543492","10110","2024-09"
"070300","엑스큐어","35494376500","4250","8351618","8351618","0","2024-09"
"317770","엑스페릭스","84873952200","3700","22938906","22938906","0","2024-09"
"373200","엑스플러스","48526825516","641","75704876","75705657","781","2024-09"
"069920","엑시온그룹","44631140400","1275","35004816","35194116","189300","2024-09"
"092870","엑시콘","144152775770","11530","12502409","13050797","548388","2024-09"
"317870","엔바이오니아","156864470000","18440","8506750","8506750","0","2024-09"
"067570","엔브이에이치코리아","103232516270","2470","41794541","42170000","375459","2024-09"
"236810","엔비티","61446727500","3810","16127750","16975426","847676","2024-09"
"333620","엔시스","98259307590","9510","10332209","10556344","224135","2024-09"
"101400","엔시트론","26045562074","419","62161246","62162413","1167","2024-09"
"036570","엔씨소프트","4355799140000","218000","19980730","21954022","1973292","2024-09"
"078860","엔에스이엔엠","90914486400","8640","10522510","10531054","8544","2024-09"
"422040","엔에이치스팩23호","15036000000","2100","7160000","7160000","0","2024-09"
"437780","엔에이치스팩24호","10713900000","2130","5030000","5030000","0","2024-09"
"438580","엔에이치스팩25호","6628900000","2195","3020000","3020000","0","2024-09"
"439410","엔에이치스팩26호","18392000000","2090","8800000","8800000","0","2024-09"
"440820","엔에이치스팩27호","16341000000","2095","7800000","7800000","0","2024-09"
"451700","엔에이치스팩29호","28771750000","2005","14350000","14350000","0","2024-09"
"466910","엔에이치스팩30호","18181800000","1998","9100000","9100000","0","2024-09"
"481890","엔에이치스팩31호","12848625000","2025","6345000","6345000","0","2024-09"
"265740","엔에프씨","48321038000","5410","8931800","8931800","0","2024-09"
"354200","엔젠바이오","43550994280","3170","13738484","13738484","0","2024-09"
"455900","엔젤로보틱스","351963722550","23550","14945381","14945381","0","2024-09"
"419080","엔젯","94919479800","9400","10097817","10517817","420000","2024-09"
"208860","엔지스테크널러지","41831348265","2205","18971133","18971133","0","2024-09"
"183490","엔지켐생명과학","113368885060","1420","79837243","85065562","5228319","2024-09"
"085310","엔케이","60895608584","772","78880322","79983352","1103030","2024-09"
"182400","엔케이맥스","172744574320","2020","85517116","85518831","1715","2024-09"
"348370","엔켐","3614845909700","173900","20786923","20786923","0","2024-09"
"069410","엔텔스","35300653840","3560","9915914","10244824","328910","2024-09"
"227950","엔투텍","44641053430","431","103575530","103575530","0","2024-09"
"291230","엔피","95026369265","2155","44095763","44095775","12","2024-09"
"198080","엔피디","55453101375","2575","21535185","21535185","0","2024-09"
"048830","엔피케이","22079263857","1181","18695397","18723923","28526","2024-09"
"096870","엘디티","15560672000","2330","6678400","6678400","0","2024-09"
"290650","엘앤씨바이오","406286397810","17910","22684891","22684891","0","2024-09"
"066970","엘앤에프","3765176969400","112200","33557727","36296338","2738611","2024-09"
"156100","엘앤케이바이오","148129926190","7430","19936733","19936743","10","2024-09"
"073110","엘엠에스","37021619200","6400","5784628","8895755","3111127","2024-09"
"083310","엘오티베큠","154195581070","9530","16180019","17810033","1630014","2024-09"
"037950","엘컴텍","106098853599","1257","84406407","84447519","41112","2024-09"
"170920","엘티씨","101956054340","10990","9277166","9805620","528454","2024-09"
"058630","엠게임","117196216200","6300","18602574","19543877","941303","2024-09"
"058970","엠로","625876310400","52800","11853718","11853718","0","2024-09"
"019590","엠벤처투자","104963185182","921","113966542","113966542","0","2024-09"
"169330","엠브레인","38266158290","2155","17756918","18256918","500000","2024-09"
"097520","엠씨넥스","294760185240","17070","17267732","17977732","710000","2024-09"
"373170","엠아이큐브솔루션","37633337100","7470","5037930","5037930","0","2024-09"
"179290","엠아이텍","279963114700","8650","32365678","32365678","0","2024-09"
"009780","엠에스씨","93456000000","5310","17600000","17600000","0","2024-09"
"123040","엠에스오토텍","168594729405","3065","55006437","69172213","14165776","2024-09"
"323230","엠에프엠코리아","6967193212","161","43274492","43274492","0","2024-06"
"032790","엠젠솔루션","55766878096","1303","42798832","42798832","0","2024-09"
"033160","엠케이전자","163882107200","7840","20903330","22066331","1163001","2024-09"
"347890","엠투아이","90626854520","5540","16358638","16913204","554566","2024-09"
"033310","엠투엔","79362824280","2005","39582456","40342231","759775","2024-09"
"259630","엠플러스","113598470410","9410","12072101","12282402","210301","2024-09"
"105550","엣지파운드리","151487925750","2650","57165255","57165255","0","2024-09"
"060850","영림원소프트랩","55534730000","6830","8131000","8131000","0","2024-09"
"014440","영보화학","66105000000","3390","19500000","20000000","500000","2024-09"
"143540","영우디에스피","30842880800","706","43686800","44599895","913095","2024-09"
"111770","영원무역","1708581480150","39950","42767997","44311468","1543471","2024-09"
"009970","영원무역홀딩스","1009626126000","87000","11604898","13635592","2030694","2024-09"
"003520","영진약품","438941889600","2400","182892454","182892731","277","2024-09"
"000670","영풍","619248240000","360000","1720134","1842040","121906","2024-09"
"036560","영풍정밀","299250000000","19000","15750000","15750000","0","2024-09"
"006740","영풍제지","54635253165","1237","44167545","46482148","2314603","2024-09"
"012280","영화금속","39187236870","774","50629505","51664505","1035000","2024-09"
"265560","영화테크","89223203800","8410","10609180","10690180","81000","2024-09"
"012160","영흥","31903701804","468","68170303","101310372","33140069","2024-09"
"036000","예림당","62538062055","2715","23034277","23034277","0","2024-09"
"250930","예선테크","16666987170","510","32680367","33000440","320073","2024-09"
"053280","예스24","150163768520","6010","24985652","25000000","14348","2024-09"
"015360","예스코홀딩스","216190500000","50500","4281000","6000000","1719000","2024-09"
"122640","예스티","443440250000","22000","20156375","20930108","773733","2024-09"
"045060","오공","45658619930","2695","16941974","16941974","0","2024-09"
"080520","오디텍","35602238720","3440","10349488","11746609","1397121","2024-09"
"007310","오뚜기","1408404406500","409500","3439327","4007830","568503","2024-09"
"039830","오로라","56237058100","5690","9883490","10762890","879400","2024-09"
"322310","오로스테크놀로지","150230464020","16310","9210942","9366542","155600","2024-09"
"046120","오르비텍","63733278400","2350","27120544","27449486","328942","2024-09"
"014940","오리엔탈정공","150533790145","3305","45547289","45573661","26372","2024-09"
"002630","오리엔트바이오","53711361078","453","118568126","118583005","14879","2024-09"
"065500","오리엔트정공","38135317908","1202","31726554","31742912","16358","2024-09"
"271560","오리온","3846151072400","97300","39528788","39536132","7344","2024-09"
"001800","오리온홀딩스","1003412972040","16680","60156653","62645422","2488769","2024-09"
"010470","오리콤","85062707550","7330","11604735","11975050","370315","2024-09"
"417860","오브젠","43331404920","9780","4430614","4430614","0","2024-09"
"352910","오비고","82651225080","6540","12637802","12637802","0","2024-09"
"053980","오상자이엘","69640255620","3690","18872698","18982783","110085","2024-09"
"036220","오상헬스케어","175371581430","12790","13711617","14489416","777799","2024-09"
"052420","오성첨단소재","143086038753","1717","83334909","86315192","2980283","2024-09"
"039200","오스코텍","1086134598400","28400","38244176","38244176","0","2024-09"
"226400","오스테오닉","111880842350","5650","19801919","20661601","859682","2024-09"
"031510","오스템","35073662897","1339","26193923","28000000","1806077","2024-09"
"368970","오에스피","30047904400","3215","9346160","9346160","0","2024-09"
"138080","오이솔루션","104890909200","10290","10193480","10624095","430615","2024-09"
"080580","오킨스전자","100120208700","5820","17202785","17679298","476513","2024-09"
"067170","오텍","50217110615","3535","14205689","15391605","1185916","2024-09"
"353590","오토앤","60708312550","4715","12875570","12875570","0","2024-09"
"173130","오파스넷","114909570040","8810","13043084","13046473","3389","2024-09"
"440320","오픈놀","46769850000","4770","9805000","9805000","0","2024-09"
"049480","오픈베이스","68244394400","2275","29997536","31422383","1424847","2024-09"
"394280","오픈엣지테크놀로지","251503018770","11510","21850827","21850827","0","2024-09"
"309930","오하임앤컴퍼니","41378079405","2015","20535027","21290990","755963","2024-09"
"244460","올리패스","18965436720","4710","4026632","4029073","2441","2024-09"
"226950","올릭스","443022331100","25700","17238223","17238223","0","2024-09"
"057540","옴니시스템","44448726406","749","59344094","61449355","2105261","2024-09"
"131030","옵투스제약","97297055310","6370","15274263","16153162","878899","2024-09"
"082210","옵트론텍","58309534910","2090","27899299","28566538","667239","2024-09"
"109080","옵티시스","33865617840","7120","4756407","5636000","879593","2024-09"
"380540","옵티코어","31751603212","1106","28708502","29779596","1071094","2024-09"
"153710","옵티팜","74523386640","5080","14669958","14669958","0","2024-09"
"432430","와이랩","86147276800","5240","16440320","16440320","0","2024-09"
"338840","와이바이오로직스","160396943760","10860","14769516","14769516","0","2024-09"
"122990","와이솔","169626497290","6130","27671533","28186941","515408","2024-09"
"232140","와이씨","957878070360","11940","80224294","82045350","1821056","2024-09"
"112290","와이씨켐","160656560050","15890","10110545","10110545","0","2024-09"
"065530","와이어블","67500488949","1411","47838759","52860000","5021241","2024-09"
"067900","와이엔텍","118552766450","6550","18099659","18199659","100000","2024-09"
"007530","와이엠","50508494325","2655","19023915","19174452","150537","2024-09"
"155650","와이엠씨","73987870960","4090","18089944","19474358","1384414","2024-09"
"273640","와이엠텍","125424889150","11870","10566545","10966000","399455","2024-09"
"251370","와이엠티","135899485120","8330","16314464","16314464","0","2024-09"
"066430","와이오엠","21999558564","562","39145122","39153476","8354","2024-09"
"209640","와이제이링크","198675374810","13970","14221573","14221573",,"자료 없음"
"273060","와이즈버즈","47179702625","935","50459575","50459582","7","2024-09"
"019210","와이지-원","171226476900","5100","33573819","33573819","0","2024-09"
"122870","와이지엔터테인먼트","713127459100","38450","18546878","18691049","144171","2024-09"
"011690","와이투솔루션","96358687870","2635","36568762","36574394","5632","2024-09"
"332570","와이팜","105206084400","2550","41257288","42233850","976562","2024-09"
"079000","와토스코리아","39655715220","5580","7106759","7200000","93241","2024-09"
"403490","우듬지팜","85448383650","1890","45210785","45212464","1679","2024-09"
"316140","우리금융지주","11806347140400","15900","742537556","742591501","53945","2024-09"
"032820","우리기술","362195008800","2280","158857460","158859048","1588","2024-09"
"041190","우리기술투자","750677943840","9640","77871156","84000000","6128844","2024-09"
"115440","우리넷","82225338540","7860","10461239","10754239","293000","2024-09"
"046970","우리로","49648635608","1144","43399157","43824999","425842","2024-09"
"082850","우리바이오","171834855920","3640","47207378","48456578","1249200","2024-09"
"215360","우리산업","108855382960","11920","9132163","9132163","0","2024-09"
"072470","우리산업홀딩스","57595373450","3050","18883729","18887341","3612","2024-09"
"073560","우리손에프앤지","96724987271","1397","69237643","69237643","0","2024-09"
"037400","우리엔터프라이즈","32059605192","1322","24250836","26223346","1972510","2024-09"
"153490","우리이앤엘","43801500600","866","50579100","51480000","900900","2024-09"
"101170","우림피티에스","70181749620","5310","13216902","13500000","283098","2024-09"
"006980","우성","41145098680","16030","2566756","3090000","523244","2024-09"
"066590","우수AMS","123962788085","3205","38677937","39073104","395167","2024-09"
"017370","우신시스템","124853668060","8030","15548402","18314054","2765652","2024-09"
"103840","우양","60883112160","3720","16366428","16366428","0","2024-09"
"046940","우원개발","41661376750","2305","18074350","18074350","0","2024-09"
"215380","우정바이오","33170330960","2110","15720536","15879576","159040","2024-09"
"065680","우주일렉트로","117040137760","14560","8038471","9530000","1491529","2024-09"
"105840","우진","163892015120","8270","19817656","20323614","505958","2024-09"
"018620","우진비앤지","29493801591","1021","28887171","28889293","2122","2024-09"
"010400","우진아이엔에스","22006357935","3265","6740079","7622000","881921","2024-09"
"457550","우진엔텍","211850096150","22850","9271339","9271339","0","2024-09"
"049800","우진플라임","45500000000","2275","20000000","20000000","0","2024-09"
"016880","웅진","70021616846","901","77715446","79927080","2211634","2024-09"
"095720","웅진씽크빅","196857356483","1747","112683089","115505985","2822896","2024-09"
"396470","워트","146692000000","9100","16120000","16120000","0","2024-09"
"005820","원림","32230526100","15670","2056830","2297970","241140","2024-09"
"307280","원바이오젠","47107981984","1328","35472878","36959013","1486135","2024-09"
"032940","원익","67860565130","3730","18193181","18193230","49","2024-09"
"240810","원익IPS","1338031475000","27500","48655690","49083901","428211","2024-09"
"074600","원익QnC","616453600000","23450","26288000","26288000","0","2024-09"
"104830","원익머트리얼즈","274224000000","21750","12608000","12608000","0","2024-09"
"014190","원익큐브","57410805162","1622","35395071","35399906","4835","2024-09"
"217820","원익피앤이","126089580300","2850","44241958","47454559","3212601","2024-09"
"030530","원익홀딩스","169952186125","2225","76383005","77237981","854976","2024-09"
"012620","원일특강","31064000000","7060","4400000","4400000","0","2024-09"
"382840","원준","206574221600","13600","15189281","15271581","82300","2024-09"
"336570","원텍","521727063840","5840","89336826","89340619","3793","2024-09"
"376980","원티드랩","42150256080","4720","8930139","9754994","824855","2024-09"
"008370","원풍","54008849895","4945","10921911","12000000","1078089","2024-09"
"008290","원풍물산","21975468350","550","39955397","40693679","738282","2024-09"
"101160","월덱스","311232218050","18850","16510993","16510993","0","2024-09"
"336060","웨이버스","65972624000","1370","48155200","48155200","0","2024-09"
"095270","웨이브일렉트로","55510167300","4350","12760958","14971256","2210298","2024-09"
"289930","웨이비스","125815724430","10130","12420111","12420111",,"자료 없음"
"010600","웰바이오텍","49552926545","545","90922801","90923407","606","2024-09"
"065950","웰크론","62122067880","2280","27246521","28231302","984781","2024-09"
"076080","웰크론한텍","32425062189","1469","22072881","22594156","521275","2024-09"
"043590","웰킵스하이텍","19894277360","745","26703728","27136762","433034","2024-09"
"196700","웹스","19262317104","1341","14364144","14364144","0","2024-09"
"069080","웹젠","491506474200","16680","29466815","34950884","5484069","2024-09"
"053580","웹케시","91683915690","7170","12787157","13636248","849091","2024-09"
"071460","위니아","21802751835","613","35567295","35967295","400000","2024-09"
"377460","위니아에이드","26030247855","1691","15393405","15393405","0","2024-09"
"044340","위닉스","91685843200","5800","15807904","17873425","2065521","2024-09"
"330350","위더스제약","92529756800","7010","13199680","13202139","2459","2024-09"
"348350","위드텍","79654840000","8150","9773600","10183600","410000","2024-09"
"112040","위메이드","1310989719000","39000","33615121","33948483","333362","2024-09"
"101730","위메이드맥스","336738301800","10200","33013559","33295292","281733","2024-09"
"123420","위메이드플레이","81128119800","7800","10401041","11469842","1068801","2024-09"
"065370","위세아이텍","30280609840","4360","6945094","7383954","438860","2024-09"
"038620","위즈코프","38145428457","607","62842551","66546465","3703914","2024-09"
"299900","위지윅스튜디오","203148828916","1199","169431884","171048884","1617000","2024-09"
"036090","위지트","89402639730","758","117945435","118392284","446849","2024-09"
"136540","윈스","153913672800","12450","12362544","13644162","1281618","2024-09"
"097800","윈팩","155693956173","1337","116450229","116450229","0","2024-09"
"192390","윈하이텍","42225090215","3865","10924991","10924991","0","2024-09"
"008600","윌비스","28622734650","435","65799390","67236039","1436649","2024-09"
"335870","윙스풋","20301290574","1217","16681422","16681422","0","2024-09"
"033270","유나이티드제약","306729958650","20850","14711269","16333822","1622553","2024-09"
"014830","유니드","456094422300","68700","6638929","6767600","128671","2024-09"
"446070","유니드비티플러스","45860089275","4485","10225215","10611215","386000","2024-09"
"036200","유니셈","198852518280","6760","29416053","30664223","1248170","2024-09"
"018000","유니슨","117874094800","700","168391564","168391564","0","2024-09"
"000910","유니온","73686841680","4720","15611619","15611619","0","2024-09"
"047400","유니온머티리얼","100590000000","2395","42000000","42000000","0","2024-09"
"203450","유니온커뮤니티","32263264260","2620","12314223","14079007","1764784","2024-09"
"011330","유니켐","133963372473","1491","89848003","96997167","7149164","2024-09"
"077500","유니퀘스트","100116472770","4635","21600102","21794015","193913","2024-09"
"011320","유니크","78345418225","4055","19320695","19320695","0","2024-09"
"086390","유니테스트","200888231960","9880","20332817","21134126","801309","2024-09"
"241690","유니테크노","89195723370","3645","24470706","24470706","0","2024-09"
"142210","유니트론텍","94455495430","4990","18928957","19246092","317135","2024-09"
"088340","유라클","48366859560","11170","4330068","4330068","0","2024-09"
"048430","유라테크","75474953680","6590","11452952","11520000","67048","2024-09"
"206650","유바이오로직스","545822546580","14940","36534307","36534307","0","2024-09"
"089850","유비벨록스","98628185400","6780","14546930","14730199","183269","2024-09"
"084440","유비온","16874156800","856","19712800","19712800","0","2024-09"
"032620","유비케어","192060899970","3785","50742642","52197139","1454497","2024-09"
"264450","유비쿼스","136155113410","13690","9945589","10245706","300117","2024-09"
"078070","유비쿼스홀딩스","161000911500","9750","16512914","18150700","1637786","2024-09"
"002920","유성기업","51423237500","2005","25647500","25947500","300000","2024-09"
"024800","유성티엔에스","65962882800","1975","33398928","37051812","3652884","2024-09"
"000700","유수홀딩스","125189460760","5110","24498916","26041812","1542896","2024-09"
"054930","유신","70050000000","23350","3000000","3000000","0","2024-09"
"069330","유아이디","17746972078","1258","14107291","14191091","83800","2024-09"
"049520","유아이엘","107352378720","5020","21384936","21784936","400000","2024-09"
"435380","유안타제10호스팩","12004350000","2095","5730000","5730000","0","2024-09"
"444920","유안타제11호스팩","10820600000","2065","5240000","5240000","0","2024-09"
"446150","유안타제12호스팩","9754650000","2045","4770000","4770000","0","2024-09"
"449020","유안타제13호스팩","19703250000","2025","9730000","9730000","0","2024-09"
"450940","유안타제14호스팩","9624800000","2120","4540000","4540000","0","2024-09"
"473050","유안타제15호스팩","14090100000","2010","7010000","7010000","0","2024-09"
"474490","유안타제16호스팩","11212850000","2035","5510000","5510000","0","2024-09"
"430700","유안타제9호스팩","11056400000","2110","5240000","5240000","0","2024-09"
"003470","유안타증권","552991895610","2870","192680103","199596576","6916473","2024-09"
"263770","유에스티","48788767425","2075","23512659","23700172","187513","2024-09"
"072130","유엔젤","57976337400","4850","11953884","13195454","1241570","2024-09"
"000220","유유제약","71365587930","4410","16182673","17032351","849678","2024-09"
"388720","유일로보틱스","376245306900","32850","11453434","11453434","0","2024-09"
"340930","유일에너테크","75882401250","2225","34104450","34204450","100000","2024-09"
"023410","유진기업","234745448225","3425","68538817","77310863","8772046","2024-09"
"056080","유진로봇","205941714480","5490","37512152","37512152","0","2024-09"
"468760","유진스팩10호","9073600000","2140","4240000","4240000","0","2024-09"
"442130","유진스팩9호","7733100000","2235","3460000","3460000","0","2024-09"
"084370","유진테크","795194042500","35750","22243190","22916042","672852","2024-09"
"240600","유진테크놀로지","43194658500","6300","6856295","6928151","71856","2024-09"
"001200","유진투자증권","362305427025","3945","91839145","96866418","5027273","2024-09"
"221800","유투바이오","33861588000","3000","11287196","11287196","0","2024-09"
"179900","유티아이","364687718650","23050","15821593","16286895","465302","2024-09"
"263050","유틸렉스","84812198400","2305","36794880","36798858","3978","2024-09"
"000100","유한양행","10478738770000","142000","73793935","80209064","6415129","2024-09"
"003460","유화증권","101349551075","2215","45756005","56702415","10946410","2024-09"
"191410","육일씨엔에쓰","18890373930","1686","11204255","11204255","0","2024-09"
"372170","윤성에프앤씨","440443449600","55200","7979048","7979048","0","2024-09"
"146060","율촌","30161507384","1256","24013939","24015595","1656","2024-09"
"008730","율촌화학","699360000000","28200","24800000","24800000","0","2024-09"
"072770","율호","131556231012","1873","70238244","70238244","0","2024-09"
"008250","이건산업","50866210900","4975","10224364","10952635","728271","2024-09"
"039020","이건홀딩스","71258837090","3290","21659221","22584709","925488","2024-09"
"025820","이구산업","147975491325","4425","33440789","33442000","1211","2024-09"
"067920","이글루","52772675760","5040","10470769","10996119","525350","2024-09"
"044960","이글벳","62970221610","5130","12274897","12641883","366986","2024-09"
"303530","이노뎁","52698363900","7410","7111790","7339299","227509","2024-09"
"296640","이노룰스","28561608800","5650","5055152","5178252","123100","2024-09"
"302430","이노메트리","89037376500","9060","9827525","9833208","5683","2024-09"
"214320","이노션","796000000000","19900","40000000","40000000","0","2024-09"
"462350","이노스페이스","183107303820","19530","9375694","9375694","0","2024-09"
"274400","이노시뮬레이션","39959310860","5110","7819826","7819826","0","2024-09"
"056090","이노시스","124568175900","1324","94084725","94084725","0","2024-09"
"073490","이노와이어리스","126984228200","16700","7603846","7603846","0","2024-09"
"215790","이노인스트루먼트","18529916880","460","40282428","40283149","721","2024-09"
"344860","이노진","22026636000","1842","11958000","12030000","72000","2024-09"
"088390","이녹스","98175823640","10460","9385834","9385844","10","2024-09"
"272290","이녹스첨단소재","466416062200","24200","19273391","20227658","954267","2024-09"
"053350","이니텍","67419938580","4020","16771129","19790916","3019787","2024-09"
"452400","이닉스","107677850360","11870","9071428","9071428","0","2024-09"
"264850","이랜시스","156017251800","5150","30294612","30294612","0","2024-09"
"054210","이랜텍","132398206920","5320","24886881","25291210","404329","2024-09"
"009730","이렘","70171785996","1524","46044479","46056774","12295","2024-09"
"065440","이루온","35768013534","1353","26436078","27275020","838942","2024-09"
"139480","이마트","1738564109700","64900","26788353","27875819","1087466","2024-09"
"115610","이미지스","62957185025","3995","15758995","15758995","0","2024-09"
"478110","이베스트스팩6호","10115300000","2015","5020000","5020000","0","2024-09"
"131400","이브이첨단소재","123938201920","2080","59585674","59589882","4208","2024-09"
"351330","이삭엔지니어링","67551438000","8150","8288520","8288520","0","2024-09"
"080010","이상네트웍스","50655950220","5340","9486133","9835071","348938","2024-09"
"457190","이수스페셜티케미컬","1216998602250","40650","29938465","30208280","269815","2024-09"
"086890","이수앱지스","225466054640","6280","35902238","35902238","0","2024-09"
"007660","이수페타시스","2551993006650","40350","63246419","63246419","0","2024-09"
"005950","이수화학","169565998080","7680","22078906","22722739","643833","2024-09"
"015020","이스타코","27729253767","713","38890959","42851600","3960641","2024-09"
"047560","이스트소프트","132990966460","12940","10277509","11603992","1326483","2024-09"
"239340","이스트에이드","44489297738","1649","26979562","26979634","72","2024-09"
"067010","이씨에스","34281040500","3010","11389050","12294000","904950","2024-09"
"093230","이아이디","354065768064","1392","254357592","254384360","26768","2024-09"
"418620","이에이트","124587658070","12910","9650477","9650477","0","2024-09"
"456070","이엔셀","204165367600","19120","10678105","10678105","0","2024-09"
"102710","이엔에프테크놀로지","231891578280","16230","14287836","14287836","0","2024-09"
"074610","이엔플러스","95900770803","1307","73374729","73374729","0","2024-09"
"041520","이엘씨","62935890980","5380","11698121","12188730","490609","2024-09"
"063760","이엘피","21013638800","2380","8829260","9325130","495870","2024-09"
"123570","이엠넷","57119620075","2675","21353129","22276078","922949","2024-09"
"083470","이엠앤아이","28700850090","1345","21338922","21340329","1407","2024-09"
"095190","이엠코리아","103329080160","2280","45319772","45319772","0","2024-09"
"091120","이엠텍","410106094100","24950","16437118","17132936","695818","2024-09"
"102460","이연제약","302442941590","16490","18340991","18586811","245820","2024-09"
"039030","이오테크닉스","2027110627500","167500","12102153","12319550","217397","2024-09"
"294090","이오플로우","158874139980","5220","30435659","30435659","0","2024-09"
"088290","이원컴포텍","35122323403","1121","31331243","31331669","426","2024-09"
"084680","이월드","248860716390","1755","141800978","141806193","5215","2024-09"
"353810","이지바이오","118068333600","3530","33447120","34191720","744600","2024-09"
"099750","이지케어텍","111768799820","16630","6720914","6834776","113862","2024-09"
"377330","이지트로닉스","45161075200","5710","7909120","8139954","230834","2024-09"
"035810","이지홀딩스","167094417210","2590","64515219","65145845","630626","2024-09"
"160600","이큐셀","106346383500","3100","34305285","34482552","177267","2024-09"
"092130","이크레더블","152953720000","12700","12043600","12043600","0","2024-09"
"096040","이트론","245561522409","271","906131079","906131295","216","2024-09"
"134060","이퓨쳐","16117203720","4190","3846588","4769250","922662","2024-09"
"001840","이화공영","49608433830","2505","19803766","19805760","1994","2024-09"
"000760","이화산업","31584000000","11280","2800000","2800000","0","2024-09"
"024810","이화전기","196810080587","899","218921113","218948640","27527","2024-09"
"014990","인디에프","56933372420","758","75109990","75112995","3005","2024-09"
"041830","인바디","316552382100","24300","13026847","13683782","656935","2024-09"
"352940","인바이오","24072021950","2215","10867730","10867730","0","2024-09"
"101140","인바이오젠","93257770480","9340","9984772","10044216","59444","2024-09"
"079950","인베니아","17432000000","800","21790000","23200000","1410000","2024-09"
"389470","인벤티지랩","171548465400","17100","10032074","10032074","0","2024-09"
"277410","인산가","50245011606","1333","37693182","38356789","663607","2024-09"
"060150","인선이엔티","249215829960","5560","44822991","46563612","1740621","2024-09"
"033230","인성정보","106978660635","2135","50107101","50515380","408279","2024-09"
"450520","인스웨이브시스템즈","49113290520","3340","14704578","14704578","0","2024-09"
"006490","인스코비","174143716110","1470","118465113","119368998","903885","2024-09"
"465480","인스피언","95396434520","9410","10137772","10137772",,"자료 없음"
"037330","인지디스플레","62910700320","1560","40327372","43885224","3557852","2024-09"
"100030","인지소프트","47525003000","17300","2747110","3283714","536604","2024-09"
"023800","인지컨트롤스","96472912920","6360","15168697","15809197","640500","2024-09"
"034590","인천도시가스","105317074450","25550","4121999","4374754","252755","2024-09"
"211050","인카금융서비스","261302404850","5350","48841571","51379800","2538229","2024-09"
"083640","인콘","25986466312","337","77111176","77720351","609175","2024-09"
"064090","인크레더블버즈","186527535000","3750","49740676","49742745","2069","2024-09"
"216050","인크로스","88353790800","7320","12070190","12843222","773032","2024-09"
"049070","인탑스","317815925940","19980","15906703","17200000","1293297","2024-09"
"119610","인터로조","312050211300","24900","12532137","13216478","684341","2024-09"
"017250","인터엠","20751603675","1025","20245467","21045467","800000","2024-09"
"129260","인터지스","61506807760","2180","28214132","29747874","1533742","2024-09"
"051370","인터플렉스","231641796960","9930","23327472","23327472","0","2024-09"
"064290","인텍플러스","155274566720","12530","12392224","12863962","471738","2024-09"
"189300","인텔리안테크","496380225600","47600","10428156","10733334","305178","2024-09"
"150840","인트로메딕","251537720850","5850","42997901","42997901","0","2024-09"
"048530","인트론바이오","192067427250","5870","32720175","34150762","1430587","2024-09"
"023810","인팩","69900000000","6990","10000000","10000000","0","2024-09"
"115310","인포바인","42229680210","19710","2142551","3192883","1050332","2024-09"
"039290","인포뱅크","49462195230","5930","8341011","8693978","352967","2024-09"
"071200","인피니트헬스케어","104574983370","4290","24376453","24396458","20005","2024-09"
"101930","인화정공","216212769500","22750","9503858","9615733","111875","2024-09"
"249420","일동제약","380718148580","13630","27932366","28062501","130135","2024-09"
"000230","일동홀딩스","91353008100","8090","11292090","11540400","248310","2024-09"
"013360","일성건설","69313921040","1283","54024880","54024880","0","2024-09"
"003120","일성아이에스","108369200700","15900","6815673","13300000","6484327","2024-09"
"333430","일승","86979724965","2835","30680679","30726747","46068","2024-09"
"068330","일신바이오","50512230696","1212","41676758","44216140","2539382","2024-09"
"003200","일신방직","168915423300","7930","21300810","23280000","1979190","2024-09"
"007110","일신석재","132171320070","1707","77429010","77456610","27600","2024-09"
"007570","일양약품","227356223600","12650","17972824","19085664","1112840","2024-09"
"178780","일월지엠엘","124101377000","8650","14346980","14349195","2215","2024-09"
"008500","일정실업","16353579280","13840","1181617","1200000","18383","2024-09"
"019540","일지테크","53975619710","4085","13213126","13513500","300374","2024-09"
"081000","일진다이아","173643129900","12230","14198130","14202975","4845","2024-09"
"020760","일진디스플","46305816300","900","51450907","51513741","62834","2024-09"
"103590","일진전기","1182396271200","24800","47677269","47685390","8121","2024-09"
"094820","일진파워","154707554340","10260","15078709","15078709","0","2024-09"
"271940","일진하이솔루스","735342097500","20250","36313190","36313190","0","2024-09"
"015860","일진홀딩스","183252364945","3985","45985537","49347483","3361946","2024-09"
"226320","잇츠한불","211400220000","12000","17616685","21929315","4312630","2024-09"
"049550","잉크테크","75190072295","3835","19606277","19606277","0","2024-09"
"389020","자람테크놀로지","194716336500","31750","6132798","6197730","64932","2024-09"
"254120","자비스","57554606580","1874","30712170","30754270","42100","2024-09"
"043910","자연과환경","68033672400","600","113389454","113391457","2003","2024-09"
"234920","자이글","42021880730","3130","13425521","13530910","105389","2024-09"
"289220","자이언트스텝","149321778750","6750","22121745","22121745","0","2024-09"
"317400","자이에스앤디","151306704400","3970","38112520","38782520","670000","2024-09"
"033240","자화전자","331480094400","15720","21086520","22155870","1069350","2024-09"
"174880","장원테크","11454988050","2650","4322637","4381265","58628","2024-09"
"049630","재영솔루텍","59980070721","717","83654213","83654213","0","2024-09"
"417840","저스템","55390519360","7810","7092256","7249175","156919","2024-09"
"000950","전방","21786666400","19120","1139470","1680000","540530","2024-09"
"079900","전진건설로봇","360884622000","24850","14522520","15360574","838054","2024-09"
"110020","전진바이오팜","19883982590","2195","9058762","9058762","0","2024-09"
"208140","정다운","85142434780","2605","32684236","32684246","10","2024-09"
"040420","정상제이엘에스","98147534940","6570","14938742","15677552","738810","2024-09"
"045510","정원엔시스","26506123794","842","31479957","32209292","729335","2024-09"
"217190","제너셈","71468768100","8150","8769174","8769174","0","2024-09"
"095700","제넥신","357015472300","7850","45479678","45540494","60816","2024-09"
"072520","제넨바이오","28838655818","389","74135362","74163194","27832","2024-09"
"122310","제노레이","80889492000","6000","13481582","14553844","1072262","2024-09"
"361390","제노코","117012308400","15600","7500789","7500789","0","2024-09"
"187420","제노포커스","107131008525","4525","23675361","23675361","0","2024-09"
"225220","제놀루션","52091632125","2885","18056025","19190021","1133996","2024-09"
"123330","제닉","176055435000","22500","7824686","7968680","143994","2024-09"
"381620","제닉스","120028968000","27450","4372640","4372640","0","2024-09"
"159580","제로투세븐","87342292960","4360","20032636","20032636","0","2024-09"
"147830","제룡산업","116827071900","6100","19151979","20000000","848021","2024-09"
"033100","제룡전기","859338881500","53500","16062409","16062409","0","2024-09"
"079370","제우스","394276048850","12850","30682961","31016990","334029","2024-09"
"054950","제이브이엠","227479868000","19750","11517968","12089892","571924","2024-09"
"023440","제이스코홀딩스","98477641780","1678","58687510","58687510","0","2024-09"
"090470","제이스텍","105662724090","6090","17350201","17476594","126393","2024-09"
"287410","제이시스메디칼","960860460300","12900","74485307","75692193","1206886","2024-06"
"137950","제이씨케미칼","99933600530","4630","21583931","22267814","683883","2024-09"
"033320","제이씨현시스템","80668630770","4270","18891951","19114432","222481","2024-09"
"417500","제이아이테크","101919494400","3225","31602944","32784744","1181800","2024-09"
"204270","제이앤티씨","1195587609950","20950","57068621","57848466","779845","2024-09"
"194370","제이에스코퍼레이션","223352754300","16770","13318590","13335601","17011","2024-09"
"026040","제이에스티나","25784134200","1800","14324519","16503790","2179271","2024-09"
"452160","제이엔비","54526671990","5670","9616697","9617527","830","2024-09"
"126880","제이엔케이글로벌","84331967720","3640","23168123","23204903","36780","2024-09"
"322510","제이엘케이","189396638200","9020","20997410","21329410","332000","2024-09"
"033050","제이엠아이","30024486304","943","31839328","32579342","740014","2024-09"
"094970","제이엠티","54147314160","3240","16712134","16748240","36106","2024-09"
"418550","제이오","557492011050","18850","29575173","31772273","2197100","2024-09"
"025620","제이준코스메틱","22371790000","5000","4474358","4484846","10488","2024-09"
"420570","제이투케이바이오","77194194560","13510","5713856","5732807","18951","2024-09"
"089790","제이티","41994256400","4595","9139120","10315513","1176393","2024-09"
"030000","제일기획","1856439029250","18330","101278725","115041225","13762500","2024-09"
"052670","제일바이오","56184286080","2080","27011676","29129064","2117388","2024-09"
"271980","제일약품","206624111060","14180","14571517","14704872","133355","2024-09"
"412540","제일엠앤에스","208272723150","10110","20600665","20600665","0","2024-09"
"001560","제일연마","58939960000","8660","6806000","9900000","3094000","2024-09"
"199820","제일일렉트릭","200424400000","9020","22220000","22220000","0","2024-09"
"038010","제일테크노스","57629880000","6930","8316000","9000000","684000","2024-09"
"002620","제일파마홀딩스","132480208750","8630","15351125","15973355","622230","2024-09"
"276730","제주맥주","36387021025","3065","11871785","11886605","14820","2024-09"
"080220","제주반도체","404870910080","12020","33683104","34442833","759729","2024-09"
"006220","제주은행","264098522280","8220","32128774","32128774","0","2024-09"
"089590","제주항공","770259821160","9560","80571111","80640985","69874","2024-09"
"216080","제테마","345924161830","19370","17858759","17858759","0","2024-09"
"229000","젠큐릭스","34756331400","2280","15244005","15244005","0","2024-09"
"082270","젬백스","520997297080","13130","39679916","39994174","314258","2024-09"
"044060","조광ILI","70075958688","732","95732184","95732184","0","2024-09"
"004910","조광페인트","61816730320","6040","10234558","12800000","2565442","2024-09"
"004700","조광피혁","189370795900","53300","3552923","6649138","3096215","2024-09"
"001550","조비","52852809040","10180","5191828","5192239","411","2024-09"
"462520","조선내화","217668591580","18370","11849134","11855168","6034","2024-09"
"120030","조선선재","90950131500","93900","968585","1257651","289066","2024-09"
"034940","조아제약","40893371640","1320","30979827","30979827","0","2024-09"
"067000","조이시티","111775610154","1599","69903446","69903446","0","2024-09"
"018470","조일알미늄","210461920302","1662","126631721","126631721","0","2024-09"
"002600","조흥","103860000000","173100","600000","600000","0","2024-09"
"185750","종근당","1278019337900","101300","12616183","13174420","558237","2024-09"
"063160","종근당바이오","140440550400","25600","5485959","5485962","3","2024-09"
"001630","종근당홀딩스","261354634200","54900","4760558","5009861","249303","2024-09"
"033340","좋은사람들","62920912142","649","96950558","96950558","0","2024-09"
"036930","주성엔지니어링","1410959381850","29850","47268321","47268321","0","2024-09"
"109070","주성코퍼레이션","216476814300","4100","52799223","52810230","11007","2024-09"
"044380","주연테크","23534929535","365","64479259","66403852","1924593","2024-09"
"072020","중앙백신","101124028800","10550","9585216","9658687","73471","2024-09"
"000440","중앙에너비스","86016399000","19400","4433835","6227130","1793295","2024-09"
"051980","중앙첨단소재","1105061030000","11080","99734750","99961003","226253","2024-09"
"228760","지노믹트리","401114672640","16720","23990112","24362333","372221","2024-09"
"314130","지놈앤컴퍼니","111649925065","3605","30970853","30970853","0","2024-09"
"013890","지누스","492454940900","24700","19937447","20260832","323385","2024-09"
"389030","지니너스","50294582260","1508","33351845","33351845","0","2024-09"
"043610","지니뮤직","137152433680","2360","58115438","58115438","0","2024-09"
"263860","지니언스","83594360610","9690","8626869","9444600","817731","2024-09"
"303030","지니틱스","41882770144","1172","35736152","35745668","9516","2024-09"
"036180","지더블유바이텍","53929030348","577","93464524","93464524","0","2024-09"
"208350","지란지교시큐리티","25156822020","3215","7824828","8838549","1013721","2024-09"
"144510","지씨셀","501906509400","33400","15027141","15800344","773203","2024-09"
"358570","지아이이노베이션","614627572900","13900","44217811","44217811","0","2024-09"
"382480","지아이텍","90637595280","2320","39067929","39357140","289211","2024-09"
"382800","지앤비에스 에코","102484572840","3240","31631041","31631041","0","2024-09"
"051160","지어소프트","136407872700","9390","14526930","15474430","947500","2024-09"
"053050","지에스이","109304791065","3645","29987597","29987597","0","2024-09"
"119850","지엔씨에너지","73530688710","4930","14914947","16448909","1533962","2024-09"
"065060","지엔코","33976397070","315","107861578","108008044","146466","2024-09"
"204840","지엘팜텍","81861423090","1065","76865186","76865206","20","2024-09"
"013870","지엠비코리아","73332916600","3845","19072280","19072280","0","2024-09"
"071320","지역난방공사","530885412400","45850","11578744","11578744","0","2024-09"
"270520","지오릿에너지","156885296568","988","158790786","158790786","0","2024-09"
"311320","지오엘리먼트","84391406400","6690","12614560","12614560","0","2024-09"
"388050","지투파워","160062310980","8580","18655281","18709437","54156","2024-09"
"088790","진도","21945372672","1763","12447744","12447744","0","2024-09"
"018120","진로발효","117399133360","17740","6617764","6621120","3356","2024-09"
"109820","진매트릭스","65981558715","3305","19964163","20393640","429477","2024-09"
"086060","진바이오텍","29964842760","3480","8610587","8610587","0","2024-09"
"036890","진성티이씨","175072909920","8760","19985492","22482268","2496776","2024-09"
"363250","진시스템","67231184160","9910","6784176","7006491","222315","2024-09"
"003780","진양산업","87620000000","6740","13000000","13000000","0","2024-09"
"007370","진양제약","64243694160","5660","11350476","12574867","1224391","2024-09"
"010640","진양폴리","70000000000","7000","10000000","10000000","0","2024-09"
"100250","진양홀딩스","177467552100","3175","55895292","55895292","0","2024-09"
"051630","진양화학","42897000000","2715","15800000","15800000","0","2024-09"
"272450","진에어","578207373480","11220","51533634","52200000","666366","2024-09"
"285800","진영","47800284220","2735","17477252","17477270","18","2024-09"
"011000","진원생명과학","205960293180","2580","79829571","80039035","209464","2024-09"
"002780","진흥기업","108333142430","745","145413614","145471745","58131","2024-09"
"085660","차바이오텍","948898364550","16850","56314443","56314443","0","2024-09"
"261780","차백신연구소","105287135900","3925","26824748","26824748","0","2024-09"
"351870","차이커뮤니케이션","87591053800","7870","11129740","11131089","1349","2024-09"
"009310","참엔지니어링","31817444308","377","84396404","84867419","471015","2024-09"
"094850","참좋은여행","62643751560","4680","13385417","14000000","614583","2024-09"
"004650","창해에탄올","70789984830","9330","7587351","9190885","1603534","2024-09"
"278280","천보","542178000000","54600","9930000","10000000","70000","2024-09"
"000650","천일고속","58081097800","40700","1427054","1429220","2166","2024-09"
"362320","청담글로벌","139254869120","6920","20123536","20551290","427754","2024-09"
"012600","청호ICT","116119947330","2490","46634517","46634517","0","2024-09"
"066360","체리부로","34141834680","712","47952015","47952015","0","2024-09"
"033250","체시스","46528000000","1454","32000000","32000000","0","2024-09"
"047820","초록뱀미디어","131865872400","5400","24419606","24453930","34324","2024-09"
"094360","칩스앤미디어","274284222000","13560","20227450","20823124","595674","2024-09"
"016920","카스","28579932997","1163","24574319","26493538","1919219","2024-09"
"284620","카이노스메드","147089550320","5290","27805208","28180793","375585","2024-09"
"035720","카카오","16392074550300","37350","438877498","443530908","4653410","2024-09"
"293490","카카오게임즈","1437459979690","17570","81813317","82667326","854009","2024-09"
"323410","카카오뱅크","10529131796300","22100","476431303","476963637","532334","2024-09"
"377300","카카오페이","3230783664000","24000","134615986","134615986","0","2024-09"
"140430","카티스","60190173300","3505","17172660","19102219","1929559","2024-09"
"042000","카페24","595991865850","24650","24178169","24253054","74885","2024-09"
"006380","카프로","618528628380","3660","168996893","168999996","3103","2024-09"
"313760","캐리","45517935120","6220","7317996","7417913","99917","2024-09"
"317530","캐리소프트","30145805140","4390","6866926","6971196","104270","2024-09"
"071850","캐스텍코리아","52767540150","2175","24260938","24529188","268250","2024-09"
"050110","캠시스","78585340773","1073","73238901","73824118","585217","2024-09"
"452300","캡스톤파트너스","38694563100","2745","14096380","14096380","0","2024-09"
"451760","컨텍","130740198780","8870","14739594","14940476","200882","2024-09"
"078340","컴투스","489993975900","42900","11421771","12737755","1315984","2024-09"
"063080","컴투스홀딩스","156300315000","23700","6594950","6595192","242","2024-09"
"307930","컴퍼니케이","79767100000","5110","15610000","15610000","0","2024-09"
"079190","케스피온","22222830260","590","37665814","38355514","689700","2024-09"
"263700","케어랩스","57520937735","2965","19399979","19414200","14221","2024-09"
"214370","케어젠","805954606450","16450","48994201","53715000","4720799","2024-09"
"221980","케이디켐","46923358930","12530","3744881","4034800","289919","2024-09"
"038530","케이바이오","31299643911","271","115496841","115714347","217506","2024-09"
"001620","케이비아이동국실업","63214441608","568","111293031","111293031","0","2024-09"
"424140","케이비제21호스팩","16692150000","2165","7710000","7710000","0","2024-09"
"192250","케이사인","65517422949","957","68461257","70671257","2210000","2024-09"
"431190","케이쓰리아이","42073804040","5620","7486442","7486442","0","2024-09"
"029460","케이씨","216092884200","18600","11617897","13554044","1936147","2024-09"
"115500","케이씨에스","88800000000","7400","12000000","12000000","0","2024-09"
"281820","케이씨텍","679004660400","33900","20029636","20861556","831920","2024-09"
"089150","케이씨티","39702250000","2315","17150000","17150000","0","2024-09"
"025880","케이씨피드","43724826720","2770","15785136","16715858","930722","2024-09"
"093320","케이아이엔엑스","339062273700","70100","4836837","4880000","43163","2024-09"
"093640","케이알엠","137179987200","4210","32584320","32584320","0","2024-09"
"073010","케이에스피","155068554780","3870","40069394","40191250","121856","2024-09"
"105330","케이엔더블유","59831419310","3770","15870403","16060028","189625","2024-09"
"053080","케이엔솔","201245442880","15530","12958496","12999807","41311","2024-09"
"199430","케이엔알시스템","79442982030","7310","10867713","10867713","0","2024-09"
"432470","케이엔에스","134455618000","15500","8674556","8674556","0","2024-09"
"272110","케이엔제이","124724054100","15580","8005395","8005395","0","2024-09"
"039420","케이엘넷","55781875260","2610","21372366","24154730","2782364","2024-09"
"083550","케이엠","36560358120","3170","11533236","12374226","840990","2024-09"
"032500","케이엠더블유","310204678570","7790","39820883","39820883","0","2024-09"
"225430","케이엠제약","19158376557","687","27887011","27887050","39","2024-09"
"102370","케이옥션","116238422100","4490","25888290","27229210","1340920","2024-09"
"068100","케이웨더","34410064710","3535","9734106","9939614","205508","2024-09"
"381970","케이카","620585100240","12880","48182073","48182073","0","2024-09"
"036030","케이티알파","198772616755","4055","49019141","49019283","142","2024-09"
"064820","케이프","135044363520","4840","27901728","30901728","3000000","2024-09"
"256940","케이피에스","111179541940","5930","18748658","18748658","0","2024-09"
"024880","케이피에프","77885303650","4025","19350386","20682798","1332412","2024-09"
"042040","케이피엠테크","55648348008","319","174446232","174460917","14685","2024-09"
"054410","케이피티유","22762614900","3975","5726444","5726444","0","2024-09"
"258610","케일럼","41013031626","1546","26528481","26787133","258652","2024-09"
"274090","켄코아에어로스페이스","105113659640","8140","12913226","12913226","0","2024-09"
"089010","켐트로닉스","285439003650","19150","14905431","15334346","428915","2024-09"
"220260","켐트로스","123761640720","4660","26558292","26558307","15","2024-09"
"052400","코나아이","206657693600","14150","14604784","14899999","295215","2024-09"
"402030","코난테크놀로지","166066876000","14500","11452888","11452888","0","2024-09"
"391710","코닉오토메이션","83415940680","2010","41500468","41503222","2754","2024-09"
"046070","코다코","145807623880","10280","14183621","14219097","35476","2024-09"
"047770","코데즈컴바인","54207935924","1436","37749259","37842602","93343","2024-09"
"080530","코디","61233987804","1419","43152916","43300427","147511","2024-09"
"104540","코렌텍","80166589800","6270","12785740","12785740","0","2024-09"
"027050","코리아나","77724000000","2540","30600000","40000000","9400000","2024-09"
"007810","코리아써키트","233373019880","9880","23620751","23620751","0","2024-09"
"190650","코리아에셋투자증권","36347720000","5690","6388000","6388000","0","2024-09"
"123410","코리아에프티","140875758540","5060","27841059","27841064","5","2024-09"
"003690","코리안리","1378424043360","9360","147267526","165367526","18100000","2024-09"
"036690","코맥스","45885746130","2885","15904938","15904938","0","2024-09"
"049430","코메론","98378851500","10950","8984370","9048000","63630","2024-09"
"183300","코미코","493064583000","47850","10304380","10460684","156304","2024-09"
"041960","코미팜","297570742700","4295","69283060","70622233","1339173","2024-09"
"089890","코세스","143169346080","8730","16399696","16584962","185266","2024-09"
"360350","코셈","41178502200","7260","5671970","5671970","0","2024-09"
"082660","코스나인","47827116000","480","99639825","99640869","1044","2024-09"
"192820","코스맥스","1671216012600","147300","11345662","11349509","3847","2024-09"
"044820","코스맥스비티아이","82649357350","8650","9554839","9603921","49082","2024-09"
"222040","코스맥스엔비티","78108376800","3800","20554836","20628000","73164","2024-09"
"241710","코스메카코리아","821292000000","76900","10680000","10680000","0","2024-09"
"005070","코스모신소재","3337646889200","102700","32498996","32510756","11760","2024-09"
"005420","코스모화학","820997282600","21400","38364359","38408228","43869","2024-09"
"355150","코스텍시스","55058388390","7290","7552591","7797350","244759","2024-09"
"071950","코아스","32084520000","9750","3290720","3290720","0","2024-09"
"166480","코아스템켐온","321553702800","13200","24360129","32870376","8510247","2024-09"
"045970","코아시아","109378200330","4410","24802313","26314876","1512563","2024-09"
"196450","코아시아씨엠","36699699510","810","45308271","45319582","11311","2024-09"
"384470","코어라인소프트","98290860300","7660","12831705","12832064","359","2024-09"
"029960","코엔텍","356582484800","7340","48580720","50000000","1419280","2024-09"
"002020","코오롱","181820534400","14400","12626426","12626426","0","2024-09"
"138490","코오롱ENP","214320000000","5640","38000000","38000000","0","2024-09"
"003070","코오롱글로벌","172552740450","9150","18858223","18932713","74490","2024-09"
"450140","코오롱모빌리티그룹","143821856290","2345","61331282","62777250","1445968","2024-09"
"102940","코오롱생명과학","233808143340","18820","12423387","12423387","0","2024-09"
"120110","코오롱인더","870758946150","31650","27512131","27519091","6960","2024-09"
"021240","코웨이","4494320812500","62500","71909133","73799619","1890486","2024-09"
"033290","코웰패션","120816798720","2280","52989824","56156301","3166477","2024-09"
"056360","코위버","47307705480","5110","9257868","9796800","538932","2024-09"
"282880","코윈테크","150079533060","13740","10922819","11141807","218988","2024-09"
"121850","코이즈","27178837320","895","30367416","30614175","246759","2024-09"
"448710","코츠테크놀로지","97643018000","22000","4438319","5166069","727750","2024-09"
"126730","코칩","96793826340","11820","8188987","8503460","314473","2024-09"
"015710","코콤","85147416810","5130","16597937","17530500","932563","2024-09"
"052330","코텍","102715993290","8170","12572337","15574552","3002215","2024-09"
"322780","코퍼스코리아","37780224000","1024","36894750","37932613","1037863","2024-09"
"036420","콘텐트리중앙","178245516810","9330","19104557","19262308","157751","2024-09"
"200130","콜마비앤에이치","414042204240","14220","29116892","29415558","298666","2024-09"
"024720","콜마홀딩스","240073813000","7000","34296259","34296259","0","2024-09"
"031820","콤텍시스템","67062512164","554","121051466","121051466","0","2024-09"
"294570","쿠콘","136038425220","13340","10197783","10254685","56902","2024-09"
"192400","쿠쿠홀딩스","744327320750","23950","31078385","35562185","4483800","2024-09"
"284740","쿠쿠홈시스","504503550000","22500","22422380","22437330","14950","2024-09"
"317690","퀀타매트릭스","119896229750","7250","16537411","16537411","0","2024-09"
"078940","퀀타피아","151577916950","2855","53092090","53094278","2188","2024-09"
"227100","퀀텀온","20823855392","1328","15680614","15680614","0","2024-09"
"432720","퀄리타스반도체","134655222000","9750","13810792","13810792","0","2024-09"
"365270","큐라클","77971700160","5620","13873968","13873968","0","2024-09"
"348080","큐라티스","40423777590","959","42152010","42152010","0","2024-09"
"060280","큐렉소","274481133200","6680","41089990","41089990","0","2024-09"
"372320","큐로셀","424805032400","30100","14113124","14113124","0","2024-09"
"051780","큐로홀딩스","18056654294","133","135764318","136422450","658132","2024-09"
"115180","큐리언트","151104479760","4680","32287282","32292671","5389","2024-09"
"445680","큐리옥스바이오시스템즈","391150733400","24300","16096738","16096738","0","2024-09"
"182360","큐브엔터","180694562980","13010","13888898","14571557","682659","2024-09"
"405100","큐알티","163669143000","13880","11791725","12289301","497576","2024-09"
"066310","큐에스아이","60613166100","6780","8939995","9271621","331626","2024-09"
"016600","큐캐피탈","47469445984","272","174520022","178247112","3727090","2024-09"
"355390","크라우드웍스","45507888580","10780","4221511","4224606","3095","2024-09"
"264900","크라운제과","101656789740","8460","12016169","12523850","507681","2024-09"
"005740","크라운해태홀딩스","84570481800","5880","14382735","14847347","464612","2024-09"
"259960","크래프톤","15636706104000","344000","45455541","47900115","2444574","2024-09"
"096240","크레버스","133113878460","15780","8435607","11138180","2702573","2024-09"
"040350","크레오에스지","115275001080","760","151677633","152074086","396453","2024-09"
"110790","크리스에프앤씨","132456693180","6540","20253317","23430960","3177643","2024-09"
"045520","크린앤사이언스","31563720000","5160","6117000","6500000","383000","2024-09"
"036170","클라우드에어","52015347004","863","60272708","61365626","1092918","2024-09"
"214150","클래시스","3386642570300","51700","65505659","65505659","0","2024-09"
"466100","클로봇","218598731780","9130","23942906","23942906",,"자료 없음"
"352770","클리노믹스","22876045920","595","38447136","38886113","438977","2024-09"
"237880","클리오","380284319100","21700","17524623","18071353","546730","2024-09"
"139670","키네마스터","38332569150","2715","14118810","14118810","0","2024-09"
"020120","키다리스튜디오","135465966760","3655","37063192","37063766","574","2024-09"
"413600","키움제6호스팩","9415350000","2745","3430000","3430000","0","2024-09"
"433530","키움제7호스팩","9379925000","2285","4105000","4105000","0","2024-09"
"446840","키움제8호스팩","13729800000","2335","5880000","5880000","0","2024-09"
"039490","키움증권","3238428646200","134200","24131361","25526706","1395345","2024-09"
"054780","키이스트","86852032925","4445","19539265","19547793","8528","2024-09"
"219130","타이거일렉","118961223600","18840","6314290","6314290","0","2024-09"
"360070","탑머티리얼","283839074800","35450","8006744","8076743","69999","2024-09"
"065130","탑엔지니어링","60043808520","3870","15515196","17189982","1674786","2024-09"
"134580","탑코미디어","43161824900","1994","21645850","22025767","379917","2024-09"
"014580","태경비케이","124951443000","4530","27583100","27583100","0","2024-09"
"015890","태경산업","151112637500","5170","29228750","29228750","0","2024-09"
"006890","태경케미컬","122406109200","10800","11333899","11600000","266101","2024-09"
"023160","태광","318167076600","12300","25867242","26500000","632758","2024-09"
"003240","태광산업","544535257000","647000","841631","1113400","271769","2024-09"
"011280","태림포장","140776002445","2045","68839121","70805940","1966819","2024-09"
"323280","태성","768166717500","29750","25820730","25820730","0","2024-09"
"053620","태양","49915664370","6270","7961031","8600000","638969","2024-09"
"004100","태양금속","123112646800","3380","36423860","36700000","276140","2024-09"
"009410","태영건설","1330097939940","4620","287899987","287905337","5350","2024-09"
"044490","태웅","276502005420","13820","20007381","20007381","0","2024-09"
"124560","태웅로직스","102345772720","2830","36164584","38416584","2252000","2024-09"
"001420","태원물산","27645813390","3770","7333107","7600000","266893","2024-09"
"191420","테고사이언스","130587091460","16310","8006566","8108834","102268","2024-09"
"073640","테라사이언스","59577565530","654","91097195","95587404","4490209","2024-09"
"066700","테라젠이텍스","108658261705","3395","32005379","32474435","469056","2024-09"
"095610","테스","284518685720","16220","17541226","19768226","2227000","2024-09"
"055490","테이팩스","81370229000","17060","4769650","4769650","0","2024-09"
"064520","테크엘","47037323810","2105","22345522","22351062","5540","2024-09"
"089030","테크윙","1486803718400","41600","35740474","37353645","1613171","2024-09"
"054450","텔레칩스","184959038880","12530","14761296","15144233","382937","2024-09"
"078000","텔코웨어","51381829850","9950","5164003","9240077","4076074","2024-09"
"200230","텔콘RF제약","68903384655","573","120250235","120250235","0","2024-09"
"214420","토니모리","175684484850","7350","23902651","24054799","152148","2024-09"
"393210","토마토시스템","98742521100","6420","15380455","15614544","234089","2024-09"
"215480","토박스코리아","23969262600","2675","8960472","9400000","439528","2024-09"
"051360","토비스","325319287800","21300","15273206","16167058","893852","2024-09"
"045340","토탈소프트","44330647200","5180","8558040","8558040","0","2024-09"
"108230","톱텍","190558125240","5230","36435588","38023245","1587657","2024-09"
"079970","투비소프트","9537289020","1140","8366043","9290500","924457","2024-09"
"199800","툴젠","459976591200","57900","7944328","7946828","2500","2024-09"
"417790","트루엔","95681093740","9140","10468391","10999650","531259","2024-09"
"290090","트윔","60002520770","8570","7001461","7432268","430807","2024-09"
"026150","특수건설","110190958680","6280","17546331","17546331","0","2024-09"
"464280","티디에스팜","77264985000","14610","5288500","5530000","241500","2024-09"
"322180","티라유텍","96804123500","5860","16519475","16519475","0","2024-09"
"117730","티로보틱스","127356608400","7140","17837060","17837060","0","2024-09"
"033830","티비씨","80166231200","848","94535650","100000000","5464350","2024-09"
"057680","티사이언티픽","80653303132","1132","71248501","71248501","0","2024-09"
"204610","티쓰리","80004100995","1365","58611063","63851720","5240657","2024-09"
"064760","티씨케이","951512500000","81500","11675000","11675000","0","2024-09"
"246710","티앤알바이오팹","152120605680","7060","21546828","21546828","0","2024-09"
"340570","티앤엘","541631938100","67100","8072011","8128000","55989","2024-09"
"043220","티에스넥스젠","73529893305","517","142224165","142224165","0","2024-09"
"277880","티에스아이","124190725120","6160","20160832","20160832","0","2024-09"
"131290","티에스이","561925592000","52100","10785520","11061429","275909","2024-09"
"019180","티에이치엔","57150000000","3175","18000000","18000000","0","2024-09"
"425420","티에프이","170230550000","15050","11311000","11381000","70000","2024-09"
"131100","티엔엔터테인먼트","42710270299","1523","28043513","28048252","4739","2024-09"
"356860","티엘비","134471388800","13760","9772630","9832630","60000","2024-09"
"062860","티엘아이","42843237000","5800","7386765","9872720","2485955","2024-09"
"363280","티와이홀딩스","125332761900","3540","35404735","50429268","15024533","2024-09"
"321550","티움바이오","136113328390","5230","26025493","26025493","0","2024-09"
"091810","티웨이항공","753107547500","3500","215173585","215378976","205391","2024-09"
"004870","티웨이홀딩스","96455448804","858","112418938","112419447","509","2024-09"
"425040","티이엠씨","187627934910","8870","21153093","21316062","162969","2024-09"
"241790","티이엠씨씨엔에스","53423903500","5500","9713437","10002634","289197","2024-09"
"104480","티케이케미칼","128071666506","1409","90895434","90895434","0","2024-09"
"081150","티플랙스","76809492330","3165","24268402","24268402","0","2024-09"
"130740","티피씨글로벌","22350377778","1982","11276679","11276679","0","2024-09"
"084730","팅크웨어","109088950860","10410","10479246","11109424","630178","2024-09"
"440110","파두","1095911201000","22250","49254436","49334436","80000","2024-09"
"034230","파라다이스","893829363750","10350","86360325","91771623","5411298","2024-09"
"033540","파라텍","49060230201","1311","37421991","37751063","329072","2024-09"
"388870","파로스아이바이오","115344181040","8920","12930962","12930962","0","2024-09"
"043200","파루","22400904352","536","41792732","41804315","11583","2024-09"
"214450","파마리서치","2428518924000","234000","10378286","10498238","119952","2024-09"
"208340","파멥신","233760977175","2915","80192445","80201108","8663","2024-09"
"005690","파미셀","300620110140","5010","60004014","60016964","12950","2024-09"
"177830","파버나인","36886518700","3100","11898877","14288753","2389876","2024-09"
"037070","파세코","114041176350","5710","19972185","20000000","27815","2024-09"
"150900","파수","54542576825","4825","11304161","11685422","381261","2024-09"
"037030","파워넷","53480318745","2445","21873341","21878974","5633","2024-09"
"047310","파워로직스","183419882550","5010","36610755","36610755","0","2024-09"
"368770","파이버프로","145652772375","4455","32694225","32854225","160000","2024-09"
"170790","파이오링크","53440872000","8000","6680109","6856330","176221","2024-09"
"049120","파인디앤씨","55051167760","1180","46653532","46653532","0","2024-09"
"038950","파인디지털","29523430800","3600","8200953","10210765","2009812","2024-09"
"441270","파인엠텍","203350141500","5500","36972753","36987901","15148","2024-09"
"106240","파인테크닉스","16728942548","1054","15871862","15923057","51195","2024-09"
"131760","파인텍","33702908408","776","43431583","43431583","0","2024-09"
"065690","파커스","14277176487","1071","13330697","14049331","718634","2024-09"
"140860","파크시스템스","1422294510000","205000","6938022","6983609","45587","2024-09"
"091700","파트론","357228500950","7030","50814865","58918214","8103349","2024-09"
"032800","판타지오","37249153971","163","228522417","229785294","1262877","2024-09"
"318010","팜스빌","42891054900","5550","7728118","7929338","201220","2024-09"
"036580","팜스코","74239932320","2120","35018836","36727943","1709107","2024-09"
"027710","팜스토리","142898121212","1292","110602261","111416600","814339","2024-09"
"004720","팜젠사이언스","86693019700","4780","18136615","18178525","41910","2024-09"
"225590","패션플랫폼","22508449278","879","25606882","26636713","1029831","2024-09"
"054300","팬스타엔터프라이즈","33080106332","494","66963778","66985895","22117","2024-09"
"068050","팬엔터테인먼트","57599521770","2130","27042029","27694076","652047","2024-09"
"028670","팬오션","1873666139560","3505","534569512","534569512","0","2024-09"
"222110","팬젠","56459932320","4920","11475596","11475596","0","2024-09"
"271830","팸텍","64424991745","2245","28697101","29490202","793101","2024-09"
"010820","퍼스텍","170081929500","3500","48594837","48771938","177101","2024-09"
"016800","퍼시스","377645774400","42200","8948952","11500000","2551048","2024-09"
"263750","펄어비스","2380002137500","38750","61419410","64247855","2828445","2024-09"
"251970","펌텍코리아","460600039900","37150","12398386","12400000","1614","2024-09"
"001020","페이퍼코리아","143404714492","806","177921482","177983313","61831","2024-09"
"168360","펨트론","153701410480","7220","21288284","21288284","0","2024-09"
"087010","펩트론","1811338232000","88000","20583389","20657350","73961","2024-09"
"090080","평화산업","54517943187","993","54902259","54902259","0","2024-09"
"010770","평화홀딩스","40289090800","2800","14388961","14625466","236505","2024-09"
"064800","포니링크","167267235320","1327","126049160","127807298","1758138","2024-09"
"119500","포메탈","34001555840","2870","11847232","11847232","0","2024-09"
"389140","포바이포","62131542740","5630","11035798","11112735","76937","2024-09"
"105760","포스뱅크","61489902500","6500","9459985","9459985","0","2024-09"
"022100","포스코DX","4076434635150","26850","151822519","152034729","212210","2024-09"
"058430","포스코스틸리온","221651830000","37000","5990590","6000000","9410","2024-09"
"009520","포스코엠텍","667065735180","16020","41639559","41642703","3144","2024-09"
"047050","포스코인터내셔널","9033557811000","53000","170444487","175922788","5478301","2024-09"
"003670","포스코퓨처엠","17693957824000","228500","77435264","77463220","27956","2024-09"
"189690","포시에스","61185986565","2245","27254337","27321969","67632","2024-09"
"318020","포인트모바일","50102755440","4020","12463372","12662272","198900","2024-09"
"256630","포인트엔지니어링","73024603376","1283","56917072","57997072","1080000","2024-09"
"331380","포커스에이치엔에스","82328413240","3695","22281032","22725452","444420","2024-09"
"472850","폰드그룹","200806417170","6210","32335977","32343933","7956","2024-09"
"039980","폴라리스AI","175802486155","2465","71319467","72152777","833310","2024-09"
"041910","폴라리스AI파마","87271609500","6570","13283350","13501607","218257","2024-09"
"234100","폴라리스세원","69104780510","1270","54413213","54413213","0","2024-09"
"041020","폴라리스오피스","266801968410","5370","49683793","49725498","41705","2024-09"
"114630","폴라리스우노","39060294574","514","75992791","77757548","1764757","2024-09"
"290720","푸드나무","41590371330","3330","12489601","13403058","913457","2024-09"
"005670","푸드웰","49026936400","5200","9428257","10000000","571743","2024-09"
"094940","푸른기술","50353977310","6370","7904863","8361386","456523","2024-09"
"057880","푸른소나무","215672327790","8790","24536101","24580368","44267","2024-09"
"007330","푸른저축은행","103002274800","8790","11718120","15082800","3364680","2024-09"
"017810","풀무원","379323922950","10290","36863355","38120542","1257187","2024-09"
"093380","풍강","25504670520","2660","9588222","9879313","291091","2024-08"
"023900","풍국주정","127260000000","10100","12600000","12600000","0","2024-09"
"103140","풍산","1862833759600","68200","27314278","28024278","710000","2024-09"
"005810","풍산홀딩스","386505321600","27600","14003816","14417292","413476","2024-09"
"371950","풍원정밀","213140143440","10130","21040488","21040488","0","2024-09"
"370090","퓨런티어","127227456500","15550","8181830","8181830","0","2024-09"
"445180","퓨릿","107825878840","6430","16769188","16769188","0","2024-09"
"151910","퓨처코어","121645902080","640","190071722","190071722","0","2024-09"
"220100","퓨쳐켐","514858422400","23300","22096928","22102155","5227","2024-09"
"035200","프럼파스트","23489009700","2775","8464508","9730590","1266082","2024-09"
"334970","프레스티지바이오로직스","547342693590","7070","77417637","77417637","0","2024-09"
"321260","프로이천","59767152360","2120","28192053","28192084","31","2024-09"
"053610","프로텍","295200000000","32800","9000000","11000000","2000000","2024-09"
"303360","프로티아","36313746300","2820","12877215","12877215","0","2024-09"
"377220","프롬바이오","62706650000","2215","28310000","28310000","0","2024-09"
"335810","프리시젼바이오","40012042070","3445","11614526","11614526","0","2024-09"
"053160","프리엠스","73427670800","13700","5359684","6000000","640316","2024-09"
"405000","플라즈맵","45321554872","1738","26076844","26076844","0","2024-09"
"041590","플래스크","103917099150","789","131707350","131707350","0","2024-09"
"367000","플래티어","37516885370","4630","8102999","8388207","285208","2024-09"
"075130","플랜티넷","31295181420","2010","15569742","16622320","1052578","2024-09"
"009810","플레이그램","55739183795","367","151877885","151887500","9615","2024-09"
"237820","플레이디","83248138600","6490","12827140","12827140","0","2024-09"
"023770","플레이위드","36426137100","4155","8766820","8766820","0","2024-09"
"019570","플루토스","22769232976","392","58084778","58090042","5264","2024-09"
"300080","플리토","84706689650","15410","5496865","5501817","4952","2024-09"
"033790","피노","172541280000","7600","22702800","22822800","120000","2024-09"
"032580","피델릭스","47684731680","1440","33114397","33132064","17667","2024-09"
"051380","피씨디렉트","40949998610","2770","14783393","15340072","556679","2024-09"
"241820","피씨엘","52189674894","882","59171967","59171967","0","2024-09"
"237750","피앤씨테크","28779938000","4430","6496600","6496600","0","2024-09"
"460940","피앤에스미캐닉스","73065944600","11290","6471740","6471740","0","2024-09"
"319660","피에스케이","588024294200","20300","28966714","28966714","0","2024-09"
"031980","피에스케이홀딩스","1088900947500","50500","21562395","21562395","0","2024-09"
"002230","피에스텍","60163576200","3640","16528455","19370673","2842218","2024-09"
"043370","피에이치에이","196308790650","10050","19533213","21000000","1466787","2024-09"
"239890","피엔에이치테크","69947715200","7040","9935755","9935755","0","2024-09"
"347740","피엔케이피부임상연구센타","70038343175","2425","28881791","30010576","1128785","2024-09"
"137400","피엔티","1206536738400","51900","23247336","23743086","495750","2024-09"
"257370","피엔티엠에스","55406021990","4510","12285149","12504861","219712","2024-09"
"147760","피엠티","48797595660","4510","10819866","10819866","0","2024-09"
"128660","피제이메탈","79742831335","3215","24803369","24803369","0","2024-09"
"006140","피제이전자","77149350000","5190","14865000","15000000","135000","2024-09"
"376180","피코그램","58592463930","3185","18396378","18491378","95000","2024-09"
"304840","피플바이오","114201685740","5430","21031618","21089464","57846","2024-09"
"087600","픽셀플러스","45814172670","7070","6480081","8166558","1686477","2024-09"
"291810","핀텔","22715424000","2000","11357712","11357712","0","2024-09"
"378340","필에너지","358241394060","16830","21285882","21285882","0","2024-09"
"161580","필옵틱스","472853826000","20700","22843180","22843180","0","2024-09"
"347770","핌스","52342626180","2290","22857042","22857042","0","2024-09"
"163730","핑거","114190295670","12430","9186669","9360608","173939","2024-09"
"417180","핑거스토리","41197433550","2450","16815279","16816209","930","2024-09"
"446750","하나26호스팩","13024800000","2160","6030000","6030000","0","2024-09"
"448370","하나27호스팩","11970600000","2130","5620000","5620000","0","2024-09"
"454750","하나28호스팩","14908140000","2070","7202000","7202000","0","2024-09"
"454640","하나29호스팩","11612150000","2150","5401000","5401000","0","2024-09"
"469880","하나30호스팩","14938725000","2045","7305000","7305000","0","2024-09"
"469900","하나31호스팩","11546300000","2060","5605000","5605000","0","2024-09"
"475240","하나32호스팩","6992000000","2185","3200000","3200000","0","2024-09"
"475250","하나33호스팩","7881000000","2130","3700000","3700000","0","2024-09"
"406760","하나금융21호스팩","15449850000","2085","7410000","7410000","0","2024-09"
"418170","하나금융22호스팩","13973250000","2325","6010000","6010000","0","2024-09"
"435620","하나금융25호스팩","44740800000","10400","4302000","4302000","0","2024-09"
"086790","하나금융지주","17389351141200","62600","277785162","287240880","9455718","2024-09"
"299030","하나기술","225056716500","28150","7994910","7994910","0","2024-09"
"067310","하나마이크론","710702325760","10810","65744896","65744896","0","2024-09"
"166090","하나머티리얼즈","555406689000","28500","19487954","19777674","289720","2024-09"
"293480","하나제약","191678304880","11080","17299486","17772946","473460","2024-09"
"039130","하나투어","743516736000","48000","15489932","16039185","549253","2024-09"
"136480","하림","305819084160","2880","106187182","106209702","22520","2024-09"
"003380","하림지주","514511647490","5290","97261181","112005621","14744440","2024-09"
"450330","하스","62374631640","7960","7836009","7836009","0","2024-09"
"101670","하이드로리튬","75411900560","1510","49941656","51691656","1750000","2024-09"
"365590","하이딥","135056685816","936","144291331","144447309","155978","2024-09"
"149980","하이로닉","113626130000","6800","16709725","18594363","1884638","2024-09"
"013030","하이록코리아","271708196750","22450","12102815","12856050","753235","2024-09"
"352820","하이브","7980853253100","192300","41502097","41652097","150000","2024-09"
"126700","하이비젼시스템","219321204130","17230","12729031","14942112","2213081","2024-09"
"106080","하이소닉","85909600140","5460","15734359","15735465","1106","2024-09"
"071090","하이스틸","64183692180","3180","20183551","20191471","7920","2024-09"
"450050","하이제8호스팩","10504330000","2095","5014000","5014000","0","2024-09"
"160190","하이젠알앤엠","206650080000","7410","27888000","30888000","3000000","2024-09"
"221840","하이즈항공","34072422142","1822","18700561","18700561","0","2024-09"
"106190","하이텍팜","160233251860","15070","10632598","10633173","575","2024-09"
"019490","하이트론","84234051825","2805","30029965","30044269","14304","2024-09"
"000080","하이트진로","1441637967000","21000","68649427","70133611","1484184","2024-09"
"000140","하이트진로홀딩스","207895295790","9730","21366423","23206765","1840342","2024-09"
"065650","하이퍼코퍼레이션","130689671850","1227","106511550","106681728","170178","2024-09"
"066130","하츠","62304969090","5190","12004811","12800000","795189","2024-09"
"004590","한국가구","55575000000","3705","15000000","15000000","0","2024-09"
"036460","한국가스공사","3438652099600","39400","87275434","92313000","5037566","2024-09"
"039340","한국경제TV","112706397400","5300","21265358","23000000","1734642","2024-09"
"005430","한국공항","171565637100","56100","3058211","3166355","108144","2024-09"
"071050","한국금융지주","4118877865300","78100","52738513","55725992","2987479","2024-09"
"034950","한국기업평가","378727947900","84900","4460871","4540514","79643","2024-09"
"010040","한국내화","81328149090","2295","35437102","41067062","5629960","2024-09"
"025540","한국단자","748869000000","72600","10315000","10415000","100000","2024-09"
"222980","한국맥널티","41328448880","3805","10861616","11031483","169867","2024-09"
"010100","한국무브넥스","110382772500","3625","30450420","30450420","0","2024-09"
"256840","한국비엔씨","324911903280","4890","66444152","67912443","1468291","2024-09"
"219750","한국비티비","63245329550","967","65403650","65426885","23235","2024-09"
"004090","한국석유","199371091220","15820","12602471","12694120","91649","2024-09"
"025550","한국선재","63603234000","2875","22122864","23300000","1177136","2024-09"
"002200","한국수출포장","97565257125","2625","37167717","40000000","2832283","2024-09"
"002960","한국쉘석유","419900000000","323000","1300000","1300000","0","2024-09"
"017890","한국알콜","185636948860","9020","20580593","21605760","1025167","2024-09"
"000240","한국앤컴퍼니","1548641654400","16350","94718144","94935240","217096","2024-09"
"080720","한국유니온제약","15410411825","2725","5655197","7912828","2257631","2024-09"
"123890","한국자산신탁","357923635875","2925","122367055","123977752","1610697","2024-09"
"015760","한국전력","14733075567150","22950","641964077","641964077","0","2024-09"
"063570","한국전자금융","154988180480","5110","30330368","34147728","3817360","2024-09"
"041460","한국전자인증","66151175625","3495","18927375","19000000","72625","2024-09"
"006200","한국전자홀딩스","32453356380","740","43855887","46803136","2947249","2024-09"
"101680","한국정밀기계","20166645600","2400","8402769","8404000","1231","2024-09"
"039740","한국정보공학","21529395945","2685","8018397","8018397","0","2024-09"
"053300","한국정보인증","162235359850","3950","41072243","42441361","1369118","2024-09"
"025770","한국정보통신","292092184380","8180","35708091","37444271","1736180","2024-09"
"458610","한국제12호스팩","9306000000","2200","4230000","4230000","0","2024-09"
"464440","한국제13호스팩","9352800000","2165","4320000","4320000","0","2024-09"
"477530","한국제14호스팩","10942750000","2275","4810000","4810000","0","2024-09"
"479880","한국제15호스팩","14049150000","2045","6870000","6870000","0","2024-09"
"027970","한국제지","181974239040","957","190150720","190178237","27517","2024-09"
"023350","한국종합기술","46037323875","4425","10403915","10950000","546085","2024-09"
"025890","한국주강","22144351992","1987","11144616","11309259","164643","2024-09"
"000970","한국주철관","137670208000","6400","21510970","22800500","1289530","2024-09"
"104700","한국철강","289415980920","8440","34290993","42450000","8159007","2024-09"
"062970","한국첨단소재","19095371415","1935","9868409","9868409","0","2024-09"
"017960","한국카본","524168994900","10650","49217746","51908452","2690706","2024-09"
"023760","한국캐피탈","175447462575","561","312740575","315609576","2869001","2024-09"
"054040","한국컴퓨터","71965959520","5320","13527436","16071290","2543854","2024-09"
"161890","한국콜마","1628750313000","69000","23605077","23605077","0","2024-09"
"021650","한국큐빅","39975218940","2460","16250089","16350563","100474","2024-09"
"161390","한국타이어앤테크놀로지","4300103543250","35250","121988753","123875069","1886316","2024-09"
"034830","한국토지신탁","224280559143","1041","215447223","252489230","37042007","2024-09"
"007280","한국특강","94078192117","1547","60813311","60813311","0","2024-09"
"032300","한국파마","230131391100","21100","10906701","10906701","0","2024-09"
"037230","한국팩키지","59362251384","1992","29800327","29800327","0","2024-09"
"047810","한국항공우주","5848506420000","60000","97475107","97475107","0","2024-09"
"123690","한국화장품","105881997890","6590","16067071","16068000","929","2024-09"
"003350","한국화장품제조","271875525000","75000","3625007","4532000","906993","2024-09"
"030520","한글과컴퓨터","450335761050","18710","24069255","24179744","110489","2024-09"
"052600","한네트","45850070500","3965","11563700","11563700","0","2024-09"
"011500","한농화성","273457077600","17880","15294020","15637042","343022","2024-09"
"002390","한독","193377638650","14050","13763533","13763533","0","2024-09"
"256150","한독크린텍","52548068250","6750","7784899","8395000","610101","2024-09"
"092460","한라IMS","102638310400","6280","16343680","17109680","766000","2024-09"
"053690","한미글로벌","150640655500","14810","10171550","10957550","786000","2024-09"
"042700","한미반도체","9213637512600","96300","95676402","96993634","1317232","2024-09"
"008930","한미사이언스","3527884082600","52100","67713706","68391550","677844","2024-09"
"128940","한미약품","4184470620000","330000","12680214","12810991","130777","2024-09"
"452190","한빛레이저","95191253790","4110","23160889","23162757","1868","2024-09"
"047080","한빛소프트","34130747750","1375","24822362","24822362","0","2024-09"
"009240","한샘","859896679600","51800","16600322","23533928","6933606","2024-09"
"452280","한선엔지니어링","146391525000","8610","17002500","17002500","0","2024-09"
"020000","한섬","336114956100","15650","21476994","23398500","1921506","2024-09"
"003680","한성기업","28974522150","5130","5648055","6209515","561460","2024-09"
"066980","한성크린텍","104383822500","2010","51932250","51935125","2875","2024-09"
"105630","한세실업","594287040510","15090","39382839","40000000","617161","2024-09"
"069640","한세엠케이","44228548780","1612","27437065","30106502","2669437","2024-09"
"016450","한세예스24홀딩스","200721448970","5110","39280127","40000000","719873","2024-09"
"010420","한솔PNS","21394704528","1044","20493012","20493012","0","2024-09"
"009180","한솔로지스틱스","63393754840","2260","28050334","28057025","6691","2024-09"
"114810","한솔아이원스","183764257950","6650","27633723","29113174","1479451","2024-09"
"070590","한솔인티큐브","15247323216","1116","13662476","13879521","217045","2024-09"
"213500","한솔제지","223264790520","9390","23776868","23800576","23708","2024-09"
"014680","한솔케미칼","1388561387500","122500","11335195","11335195","0","2024-09"
"004710","한솔테크닉스","135880761025","4325","31417517","32109878","692361","2024-09"
"004150","한솔홀딩스","93950957510","2290","41026619","42008577","981958","2024-09"
"025750","한솔홈데코","56073343704","696","80565149","80565149","0","2024-09"
"226440","한송네오텍","100580954580","1530","65739186","65739186","0","2024-09"
"042520","한스바이오메드","106752967380","8220","12986979","13526367","539388","2024-09"
"004960","한신공영","78565066580","6790","11570702","11570702","0","2024-09"
"011700","한신기계","117739989640","3640","32346151","32446151","100000","2024-09"
"430690","한싹","51153452280","4695","10895304","10895327","23","2024-09"
"078350","한양디지텍","173600001900","11700","14837607","15244382","406775","2024-09"
"045100","한양이엔지","284220535260","16930","16787982","18000000","1212018","2024-09"
"001750","한양증권","157451965580","12370","12728534","12728534","0","2024-09"
"018880","한온시스템","2083975219150","3905","533668430","533800000","131570","2024-09"
"009420","한올바이오파마","2271820544000","44800","50710280","52240638","1530358","2024-09"
"214870","한울BnC","64715071880","6920","9351889","9359221","7332","2024-09"
"320000","한울반도체","76485978905","2735","27965623","27965627","4","2024-09"
"091440","한울소재과학","71243589300","5070","14051990","14606671","554681","2024-09"
"014130","한익스프레스","41182000000","3490","11800000","12000000","200000","2024-09"
"024740","한일단조","116810492480","3740","31232752","31532546","299794","2024-09"
"005860","한일사료","160964053225","4085","39403685","39403685","0","2024-09"
"300720","한일시멘트","968968944600","13990","69261540","69261540","0","2024-09"
"002220","한일철강","48488296340","1991","24353740","26697460","2343720","2024-09"
"006390","한일현대시멘트","266915150320","13810","19327672","19327672","0","2024-09"
"003300","한일홀딩스","431331901560","13990","30831444","30832884","1440","2024-09"
"007770","한일화학","40716000000","11600","3510000","3510000","0","2024-09"
"051600","한전KPS","2040750000000","45350","45000000","45000000","0","2024-09"
"052690","한전기술","2708697556000","71200","38043505","38220000","176495","2024-09"
"130660","한전산업","435862000000","13370","32600000","32600000","0","2024-09"
"198940","한주라이트메탈","38257325884","983","38918948","38922978","4030","2024-09"
"058450","한주에이알티","32271464490","2235","14439134","14452469","13335","2024-09"
"107640","한중엔시에스","355273156200","39700","8948946","8948946","0","2024-09"
"002320","한진","274915313000","19000","14469227","14947628","478401","2024-09"
"003480","한진중공업홀딩스","89226103680","3420","26089504","29529812","3440308","2024-09"
"180640","한진칼","5763402569100","86900","66322239","66762279","440040","2024-09"
"005110","한창","22551214950","1254","17983425","18606407","622982","2024-09"
"079170","한창산업","42909730100","8300","5169847","5200000","30153","2024-09"
"009460","한창제지","43079924892","722","59667486","59667486","0","2024-09"
"372910","한컴라이프케어","113465064600","4100","27674406","27674406","0","2024-09"
"054920","한컴위드","62942890890","2530","24878613","28217081","3338468","2024-09"
"457370","한켐","117196083400","14600","8027129","8027134","5","2024-09"
"002680","한탑","21556675305","695","31016799","32316799","1300000","2024-09"
"000880","한화","1945997697600","28050","69376032","74958735","5582703","2024-09"
"452260","한화갤러리아","249003739265","1285","193777229","193859610","82381","2024-09"
"088350","한화생명","2201573432500","2930","751390250","868530000","117139750","2024-09"
"000370","한화손해보험","531853959600","4600","115620426","116738915","1118489","2024-09"
"009830","한화솔루션","3640987998500","21500","169348279","171892536","2544257","2024-09"
"272210","한화시스템","3579051015540","19140","186993261","188919389","1926128","2024-09"
"012450","한화에어로스페이스","17072688774000","375500","45466548","45581161","114613","2024-09"
"082740","한화엔진","1185476852350","14210","83425535","83447142","21607","2024-09"
"042660","한화오션","8441242501850","27550","306397187","306413394","16207","2024-09"
"489790","한화인더스트리얼솔루션즈","2264470512900","44950","50377542","50488390","110848","2024-09"
"003530","한화투자증권","777418860380","3635","213870388","214547775","677387","2024-09"
"430460","한화플러스제3호스팩","12728000000","2150","5920000","5920000","0","2024-09"
"455310","한화플러스제4호스팩","10879000000","2150","5060000","5060000","0","2024-09"
"195870","해성디에스","446250000000","26250","17000000","17000000","0","2024-09"
"034810","해성산업","199141286400","6720","29634120","32556857","2922737","2024-09"
"059270","해성에어로보틱스","62054250430","5570","11140799","11140799","0","2024-09"
"076610","해성옵틱스","29107201865","1145","25421137","25453198","32061","2024-09"
"101530","해태제과식품","154067616220","5810","26517662","29116822","2599160","2024-09"
"220180","핸디소프트","60552960000","3120","19408000","19408000","0","2024-09"
"143210","핸즈코퍼레이션","41332394715","1923","21493705","21875747","382042","2024-09"
"214180","헥토이노베이션","153224016440","12380","12376738","13257185","880447","2024-09"
"234340","헥토파이낸셜","133790259400","16100","8309954","9453000","1143046","2024-09"
"084990","헬릭스미스","168071141200","3650","46046888","46092797","45909","2024-09"
"187660","현대ADM","75198662595","3555","21152929","21836250","683321","2024-09"
"000720","현대건설","3145800361250","28250","111355765","111355765","0","2024-09"
"170030","현대공업","79187449440","5280","14997623","15340000","342377","2024-09"
"453340","현대그린푸드","394020809400","11640","33850585","33880914","30329","2024-09"
"086280","현대글로비스","9112500000000","121500","75000000","75000000","0","2024-09"
"064350","현대로템","6963278293400","63800","109142293","109142293","0","2024-09"
"079430","현대리바트","159304479840","7920","20114202","20535282","421080","2024-09"
"012330","현대모비스","22367147785500","248500","90008643","92995094","2986451","2024-09"
"319400","현대무벡스","362034914580","3105","116597396","117741058","1143662","2024-09"
"048410","현대바이오","683300080320","17160","39819352","39821608","2256","2024-09"
"052260","현대바이오랜드","152700000000","5090","30000000","30000000","0","2024-09"
"069960","현대백화점","1007524074600","46100","21855186","23402441","1547255","2024-09"
"004560","현대비앤지스틸","211103354000","14000","15078811","15078811","0","2024-09"
"016790","현대사료","187340898626","994","188471729","188471729","0","2024-09"
"004310","현대약품","101145151260","3870","26135698","32000000","5864302","2024-08"
"041440","현대에버다임","168425761280","9440","17841712","17915944","74232","2024-09"
"039010","현대에이치티","47779350000","6150","7769000","8625000","856000","2024-09"
"017800","현대엘리베이","1686106395400","46700","36105062","39092385","2987323","2024-09"
"307950","현대오토에버","3784390008000","138000","27423116","27423982","866","2024-09"
"011210","현대위아","1131112639350","42450","26645763","27195083","549320","2024-09"
"090850","현대이지웰","130130058280","5480","23746361","23746361","0","2024-09"
"004020","현대제철","3328107196700","25300","131545739","133445785","1900046","2024-09"
"005440","현대지에프홀딩스","702348876005","4505","155904301","155904301","0","2024-09"
"005380","현대차","44945811760500","220500","203835881","209416191","5580310","2024-09"
"001500","현대차증권","281290424940","8870","31712562","31712562","0","2024-09"
"011760","현대코퍼레이션","231811643800","19300","12010966","13228966","1218000","2024-09"
"227840","현대코퍼레이션홀딩스","92804294520","10520","8821701","9100836","279135","2024-09"
"126560","현대퓨처넷","432351918375","3925","110153355","110202945","49590","2024-09"
"001450","현대해상","2395562975000","30550","78414500","89400000","10985500","2024-09"
"057050","현대홈쇼핑","540333800000","47200","11447750","12000000","552250","2024-09"
"460930","현대힘스","351646097740","9940","35376871","35376871","0","2024-09"
"092300","현우산업","51141761255","2795","18297589","18672816","375227","2024-09"
"138360","협진","38508605962","797","48316946","48348248","31302","2024-09"
"011080","형지I&C","16011611716","628","25496197","25503364","7167","2024-09"
"093240","형지엘리트","45643162724","1348","33859913","34164255","304342","2024-09"
"003010","혜인","54064064690","5030","10748323","12712747","1964424","2024-09"
"111110","호전실업","76698574960","8330","9207512","9749984","542472","2024-09"
"008770","호텔신라","1606998139300","43300","37113121","39248121","2135000","2024-09"
"060560","홈센타홀딩스","99901786296","787","126940008","127669525","729517","2024-09"
"064240","홈캐스트","91055974250","2650","34360745","35038012","677267","2024-09"
"039610","화성밸브","99002904000","9510","10410400","10410400","0","2024-09"
"378850","화승알앤에이","71880125010","3785","18990786","18993623","2837","2024-09"
"241590","화승엔터프라이즈","566509730600","9350","60589276","60589276","0","2024-09"
"006060","화승인더","206777255740","4180","49468243","55320000","5851757","2024-09"
"013520","화승코퍼레이션","83082207782","1871","44405242","50051252","5646010","2024-09"
"010690","화신","310303578130","8930","34748441","34920410","171969","2024-09"
"126640","화신정공","47009975310","1341","35055910","36373887","1317977","2024-09"
"133820","화인베스틸","25739808530","835","30826118","30826118","0","2024-09"
"127980","화인써키트","79562340480","6720","11839634","11840684","1050","2024-09"
"061250","화일약품","101743894980","1365","74537652","76877652","2340000","2024-09"
"010660","화천기계","63140000000","2870","22000000","22000000","0","2024-09"
"000850","화천기공","59730000000","27150","2200000","2200000","0","2024-09"
"016580","환인제약","202441348200","13260","15267070","18600070","3333000","2024-09"
"032560","황금에스티","90720095880","5340","16988782","17000000","11218","2024-09"
"004800","효성","824213373200","49300","16718324","16740407","22083","2024-09"
"094280","효성ITX","137427644250","12450","11038365","11558200","519835","2024-09"
"097870","효성오앤비","48839100000","6190","7890000","8490000","600000","2024-09"
"298040","효성중공업","3771255105000","405000","9311741","9324548","12807","2024-09"
"298020","효성티앤씨","1286075620000","298000","4315690","4327682","11992","2024-09"
"298000","효성화학","150990226000","39950","3779480","3791811","12331","2024-09"
"093370","후성","654256939600","6100","107255236","107255330","94","2024-09"
"081660","휠라홀딩스","2348139033900","39450","59521902","60095839","573937","2024-09"
"290270","휴네시온","33942543540","3660","9273919","9607672","333753","2024-09"
"005870","휴니드","110221925800","8420","13090490","14116015","1025525","2024-09"
"353190","휴럼","31502007200","800","39377509","39378420","911","2024-09"
"192410","휴림네트웍스","37471228300","2635","14220580","14235530","14950","2024-09"
"090710","휴림로봇","133244912128","1216","109576408","109623165","46757","2024-09"
"078590","휴림에이텍","30984289534","577","53698942","54210339","511397","2024-09"
"205470","휴마시스","228570756800","2020","113153840","129375009","16221169","2024-09"
"115160","휴맥스","74341333252","1724","43121423","43970124","848701","2024-09"
"028080","휴맥스홀딩스","32317451680","2960","10918058","12577506","1659448","2024-09"
"175140","휴먼테크놀로지","95097590640","4420","21515292","21515292","0","2024-09"
"200670","휴메딕스","318023981150","30850","10308719","11229930","921211","2024-09"
"079980","휴비스","85731383600","2605","32910320","34500000","1589680","2024-09"
"065510","휴비츠","95181581250","8750","10877895","12159371","1281476","2024-09"
"215090","휴센텍","149904424845","1505","99604269","99649272","45003","2024-09"
"005010","휴스틸","224752300000","4000","56188075","56188075","0","2024-09"
"263920","휴엠앤씨","49633675608","1012","49045134","49045134","0","2024-09"
"243070","휴온스","324794305000","27500","11810702","11979665","168963","2024-09"
"084110","휴온스글로벌","440361886600","36200","12164693","12621492","456799","2024-09"
"145020","휴젤","3008287217000","273500","10999222","12604033","1604811","2024-09"
"024060","흥구석유","235561235400","16200","14540817","15000000","459183","2024-09"
"010240","흥국","53969643000","4875","11070696","12322696","1252000","2024-09"
"189980","흥국에프엔비","70808642010","1830","38693247","40137827","1444580","2024-09"
"000540","흥국화재","218103779775","3395","64242645","64242645","0","2024-09"
"003280","흥아해운","456503199800","1900","240264842","240424899","160057","2024-09"
"037440","희림","60787063800","4815","12624520","13922475","1297955","2024-09"
"238490","힘스","47729742000","4300","11099940","11312236","212296","2024-09"